"Read","Counts","Read Position Start","Read Position End","Read Size (rs)","Mean Read Size (mrs)","mrs/rs"
"SL2.50ch00:10000363-10002183","689","10000363","10002183","1820","1549.65308533","1.17445641043"
"SL2.50ch00:10005133-10011081","2406","10005133","10011081","5948","1549.65308533","3.83827842265"
"SL2.50ch00:10007543-10011086","1771","10007543","10011086","3543","1549.65308533","2.28631816601"
"SL2.50ch00:10028416-10029802","287","10028416","10029802","1386","1549.65308533","0.894393727941"
"SL2.50ch00:10040285-10041207","187","10040285","10041207","922","1549.65308533","0.594971873854"
"SL2.50ch00:10065547-10066847","389","10065547","10066847","1300","1549.65308533","0.83889743602"
"SL2.50ch00:10066085-10066757","286","10066085","10066757","672","1549.65308533","0.43364544385"
"SL2.50ch00:10068678-10069836","271","10068678","10069836","1158","1549.65308533","0.747264023777"
"SL2.50ch00:10073255-10074181","430","10073255","10074181","926","1549.65308533","0.597553096734"
"SL2.50ch00:10073370-10074157","428","10073370","10074157","787","1549.65308533","0.507855601652"
"SL2.50ch00:10083573-10085215","276","10083573","10085215","1642","1549.65308533","1.05959199226"
"SL2.50ch00:10103462-10104050","198","10103462","10104050","588","1549.65308533","0.379439763369"
"SL2.50ch00:10103592-10104363","242","10103592","10104363","771","1549.65308533","0.497530710132"
"SL2.50ch00:10105958-10106333","92","10105958","10106333","375","1549.65308533","0.241989645006"
"SL2.50ch00:10110853-10111334","96","10110853","10111334","481","1549.65308533","0.310392051327"
"SL2.50ch00:10117330-10118340","368","10117330","10118340","1010","1549.65308533","0.651758777215"
"SL2.50ch00:10120640-10122337","543","10120640","10122337","1697","1549.65308533","1.09508380687"
"SL2.50ch00:10120685-10122305","533","10120685","10122305","1620","1549.65308533","1.04539526642"
"SL2.50ch00:10152857-10156261","851","10152857","10156261","3404","1549.65308533","2.19662067093"
"SL2.50ch00:10157394-10158622","355","10157394","10158622","1228","1549.65308533","0.792435424178"
"SL2.50ch00:10272195-10272892","227","10272195","10272892","697","1549.65308533","0.44977808685"
"SL2.50ch00:10272212-10272758","198","10272212","10272758","546","1549.65308533","0.352336923128"
"SL2.50ch00:10279897-10280460","169","10279897","10280460","563","1549.65308533","0.363307120368"
"SL2.50ch00:10282428-10283039","161","10282428","10283039","611","1549.65308533","0.394281794929"
"SL2.50ch00:10289429-10289804","118","10289429","10289804","375","1549.65308533","0.241989645006"
"SL2.50ch00:10290747-10292202","322","10290747","10292202","1455","1549.65308533","0.938919822622"
"SL2.50ch00:10291757-10292211","158","10291757","10292211","454","1549.65308533","0.292968796887"
"SL2.50ch00:10297670-10298318","335","10297670","10298318","648","1549.65308533","0.41815810657"
"SL2.50ch00:10297803-10298602","382","10297803","10298602","799","1549.65308533","0.515599270292"
"SL2.50ch00:10299758-10300798","269","10299758","10300798","1040","1549.65308533","0.671117948816"
"SL2.50ch00:10302537-10303498","219","10302537","10303498","961","1549.65308533","0.620138796934"
"SL2.50ch00:10307200-10307668","117","10307200","10307668","468","1549.65308533","0.302003076967"
"SL2.50ch00:10310433-10311167","152","10310433","10311167","734","1549.65308533","0.473654398491"
"SL2.50ch00:10312860-10313224","128","10312860","10313224","364","1549.65308533","0.234891282085"
"SL2.50ch00:10312893-10313507","200","10312893","10313507","614","1549.65308533","0.396217712089"
"SL2.50ch00:10399117-10400684","975","10399117","10400684","1567","1549.65308533","1.01119406326"
"SL2.50ch00:10399133-10400855","966","10399133","10400855","1722","1549.65308533","1.11121644987"
"SL2.50ch00:10401967-10403619","991","10401967","10403619","1652","1549.65308533","1.06604504946"
"SL2.50ch00:10402027-10403625","978","10402027","10403625","1598","1549.65308533","1.03119854058"
"SL2.50ch00:10405076-10406218","332","10405076","10406218","1142","1549.65308533","0.736939132257"
"SL2.50ch00:10410690-10412088","757","10410690","10412088","1398","1549.65308533","0.902137396581"
"SL2.50ch00:10410836-10412161","723","10410836","10412161","1325","1549.65308533","0.85503007902"
"SL2.50ch00:10413868-10414445","167","10413868","10414445","577","1549.65308533","0.372341400449"
"SL2.50ch00:10413964-10414425","156","10413964","10414425","461","1549.65308533","0.297485936927"
"SL2.50ch00:10421276-10421986","229","10421276","10421986","710","1549.65308533","0.458167061211"
"SL2.50ch00:10423987-10424619","170","10423987","10424619","632","1549.65308533","0.40783321505"
"SL2.50ch00:10428514-10429841","721","10428514","10429841","1327","1549.65308533","0.85632069046"
"SL2.50ch00:10428580-10429842","717","10428580","10429842","1262","1549.65308533","0.814375818659"
"SL2.50ch00:10431271-10432050","195","10431271","10432050","779","1549.65308533","0.502693155892"
"SL2.50ch00:10438285-10439172","231","10438285","10439172","887","1549.65308533","0.572386173653"
"SL2.50ch00:10438299-10439275","231","10438299","10439275","976","1549.65308533","0.629818382735"
"SL2.50ch00:10477104-10477596","92","10477104","10477596","492","1549.65308533","0.317490414247"
"SL2.50ch00:10479070-10480453","382","10479070","10480453","1383","1549.65308533","0.892457810781"
"SL2.50ch00:10479107-10484403","1306","10479107","10484403","5296","1549.65308533","3.4175390932"
"SL2.50ch00:10483585-10484268","252","10483585","10484268","683","1549.65308533","0.44074380677"
"SL2.50ch00:10485639-10487172","919","10485639","10487172","1533","1549.65308533","0.989253668783"
"SL2.50ch00:10485719-10487540","972","10485719","10487540","1821","1549.65308533","1.17510171615"
"SL2.50ch00:10489375-10489963","105","10489375","10489963","588","1549.65308533","0.379439763369"
"SL2.50ch00:10489689-10497666","1894","10489689","10497666","7977","1549.65308533","5.14760372856"
"SL2.50ch00:10508238-10508709","140","10508238","10508709","471","1549.65308533","0.303938994127"
"SL2.50ch00:10508251-10508728","140","10508251","10508728","477","1549.65308533","0.307810828447"
"SL2.50ch00:10574808-10576025","668","10574808","10576025","1217","1549.65308533","0.785337061258"
"SL2.50ch00:10574831-10576116","668","10574831","10576116","1285","1549.65308533","0.829217850219"
"SL2.50ch00:10577299-10578748","294","10577299","10578748","1449","1549.65308533","0.935047988302"
"SL2.50ch00:10577320-10578111","212","10577320","10578111","791","1549.65308533","0.510436824532"
"SL2.50ch00:10583343-10583980","138","10583343","10583980","637","1549.65308533","0.41105974365"
"SL2.50ch00:10588089-10588760","189","10588089","10588760","671","1549.65308533","0.43300013813"
"SL2.50ch00:10591312-10591687","73","10591312","10591687","375","1549.65308533","0.241989645006"
"SL2.50ch00:10600386-10601998","404","10600386","10601998","1612","1549.65308533","1.04023282066"
"SL2.50ch00:10601298-10602118","184","10601298","10602118","820","1549.65308533","0.529150690412"
"SL2.50ch00:10604587-10606328","1600","10604587","10606328","1741","1549.65308533","1.12347725855"
"SL2.50ch00:10604618-10606322","1598","10604618","10606322","1704","1549.65308533","1.09960094691"
"SL2.50ch00:10607799-10610148","1730","10607799","10610148","2349","1549.65308533","1.51582313632"
"SL2.50ch00:10607825-10610081","1730","10607825","10610081","2256","1549.65308533","1.45580970435"
"SL2.50ch00:10617034-10618103","1433","10617034","10618103","1069","1549.65308533","0.689831814696"
"SL2.50ch00:10617063-10618124","1429","10617063","10618124","1061","1549.65308533","0.684669368936"
"SL2.50ch00:10627454-10628374","1378","10627454","10628374","920","1549.65308533","0.593681262414"
"SL2.50ch00:10627488-10628370","1322","10627488","10628370","882","1549.65308533","0.569159645053"
"SL2.50ch00:10630268-10631004","549","10630268","10631004","736","1549.65308533","0.474945009931"
"SL2.50ch00:10630273-10630919","549","10630273","10630919","646","1549.65308533","0.41686749513"
"SL2.50ch00:10632670-10636807","2966","10632670","10636807","4137","1549.65308533","2.6696297637"
"SL2.50ch00:10632690-10636727","2964","10632690","10636727","4037","1549.65308533","2.6050991917"
"SL2.50ch00:10638561-10640200","2840","10638561","10640200","1639","1549.65308533","1.0576560751"
"SL2.50ch00:10638613-10640277","2821","10638613","10640277","1664","1549.65308533","1.07378871811"
"SL2.50ch00:10642031-10643876","2062","10642031","10643876","1845","1549.65308533","1.19058905343"
"SL2.50ch00:10642060-10643975","2062","10642060","10643975","1915","1549.65308533","1.23576045383"
"SL2.50ch00:10644553-10646100","893","10644553","10646100","1547","1549.65308533","0.998287948863"
"SL2.50ch00:10644582-10645685","845","10644582","10645685","1103","1549.65308533","0.711772209177"
"SL2.50ch00:10651659-10652255","381","10651659","10652255","596","1549.65308533","0.384602209129"
"SL2.50ch00:10651669-10652308","381","10651669","10652308","639","1549.65308533","0.41235035509"
"SL2.50ch00:10653404-10654598","593","10653404","10654598","1194","1549.65308533","0.770495029698"
"SL2.50ch00:10653567-10654616","586","10653567","10654616","1049","1549.65308533","0.676925700296"
"SL2.50ch00:10656054-10657819","630","10656054","10657819","1765","1549.65308533","1.13896459583"
"SL2.50ch00:10656073-10657764","630","10656073","10657764","1691","1549.65308533","1.09121197255"
"SL2.50ch00:10659590-10661157","340","10659590","10661157","1567","1549.65308533","1.01119406326"
"SL2.50ch00:10663998-10664883","2924","10663998","10664883","885","1549.65308533","0.571095562213"
"SL2.50ch00:10664310-10664854","2911","10664310","10664854","544","1549.65308533","0.351046311688"
"SL2.50ch00:10665513-10666162","4782","10665513","10666162","649","1549.65308533","0.41880341229"
"SL2.50ch00:10665525-10666271","4782","10665525","10666271","746","1549.65308533","0.481398067131"
"SL2.50ch00:10667182-10669646","17912","10667182","10669646","2464","1549.65308533","1.59003329412"
"SL2.50ch00:10667219-10669649","17912","10667219","10669649","2430","1549.65308533","1.56809289964"
"SL2.50ch00:10672269-10673004","3751","10672269","10673004","735","1549.65308533","0.474299704211"
"SL2.50ch00:10672295-10673041","3751","10672295","10673041","746","1549.65308533","0.481398067131"
"SL2.50ch00:10675322-10676638","4106","10675322","10676638","1316","1549.65308533","0.84922232754"
"SL2.50ch00:10675715-10676647","4005","10675715","10676647","932","1549.65308533","0.601424931054"
"SL2.50ch00:10680494-10686454","48690","10680494","10686454","5960","1549.65308533","3.84602209129"
"SL2.50ch00:10680581-10686405","48474","10680581","10686405","5824","1549.65308533","3.75826051337"
"SL2.50ch00:10687232-10692825","43798","10687232","10692825","5593","1549.65308533","3.60919489204"
"SL2.50ch00:10687260-10692761","43728","10687260","10692761","5501","1549.65308533","3.5498267658"
"SL2.50ch00:10721753-10722752","370","10721753","10722752","999","1549.65308533","0.644660414295"
"SL2.50ch00:10729271-10730740","1288","10729271","10730740","1469","1549.65308533","0.947954102702"
"SL2.50ch00:10729357-10730676","1285","10729357","10730676","1319","1549.65308533","0.8511582447"
"SL2.50ch00:10731556-10732670","1099","10731556","10732670","1114","1549.65308533","0.718870572097"
"SL2.50ch00:10731625-10733902","1366","10731625","10733902","2277","1549.65308533","1.46936112447"
"SL2.50ch00:10734439-10737127","527","10734439","10737127","2688","1549.65308533","1.7345817754"
"SL2.50ch00:10743514-10745178","748","10743514","10745178","1664","1549.65308533","1.07378871811"
"SL2.50ch00:10743717-10745260","733","10743717","10745260","1543","1549.65308533","0.995706725983"
"SL2.50ch00:10746690-10748940","689","10746690","10748940","2250","1549.65308533","1.45193787003"
"SL2.50ch00:10746880-10748766","620","10746880","10748766","1886","1549.65308533","1.21704658795"
"SL2.50ch00:10776577-10777822","445","10776577","10777822","1245","1549.65308533","0.803405621419"
"SL2.50ch00:10776623-10777730","445","10776623","10777730","1107","1549.65308533","0.714353432057"
"SL2.50ch00:10778513-10781161","613","10778513","10781161","2648","1549.65308533","1.7087695466"
"SL2.50ch00:10782742-10784037","417","10782742","10784037","1295","1549.65308533","0.835670907419"
"SL2.50ch00:10783585-10783949","222","10783585","10783949","364","1549.65308533","0.234891282085"
"SL2.50ch00:10788579-10789335","344","10788579","10789335","756","1549.65308533","0.487851124331"
"SL2.50ch00:10788604-10789234","334","10788604","10789234","630","1549.65308533","0.406542603609"
"SL2.50ch00:10793398-10793864","154","10793398","10793864","466","1549.65308533","0.300712465527"
"SL2.50ch00:10793503-10794068","182","10793503","10794068","565","1549.65308533","0.364597731809"
"SL2.50ch00:10798377-10803492","1412","10798377","10803492","5115","1549.65308533","3.30073875788"
"SL2.50ch00:10799510-10800069","187","10799510","10800069","559","1549.65308533","0.360725897488"
"SL2.50ch00:10802221-10803440","460","10802221","10803440","1219","1549.65308533","0.786627672698"
"SL2.50ch00:10830671-10832340","1533","10830671","10832340","1669","1549.65308533","1.07701524671"
"SL2.50ch00:10830783-10832339","1533","10830783","10832339","1556","1549.65308533","1.00409570034"
"SL2.50ch00:10834926-10835824","892","10834926","10835824","898","1549.65308533","0.579484536574"
"SL2.50ch00:10834966-10835770","856","10834966","10835770","804","1549.65308533","0.518825798892"
"SL2.50ch00:10842034-10842622","240","10842034","10842622","588","1549.65308533","0.379439763369"
"SL2.50ch00:10842053-10842619","240","10842053","10842619","566","1549.65308533","0.365243037529"
"SL2.50ch00:10843882-10845225","446","10843882","10845225","1343","1549.65308533","0.86664558198"
"SL2.50ch00:10843914-10845152","446","10843914","10845152","1238","1549.65308533","0.798888481379"
"SL2.50ch00:10846196-10847084","723","10846196","10847084","888","1549.65308533","0.573031479373"
"SL2.50ch00:10846198-10847139","723","10846198","10847139","941","1549.65308533","0.607232682534"
"SL2.50ch00:10848766-10850022","684","10848766","10850022","1256","1549.65308533","0.810503984339"
"SL2.50ch00:10848846-10850034","654","10848846","10850034","1188","1549.65308533","0.766623195378"
"SL2.50ch00:10854412-10857486","1055","10854412","10857486","3074","1549.65308533","1.98366978333"
"SL2.50ch00:10855515-10857404","817","10855515","10857404","1889","1549.65308533","1.21898250511"
"SL2.50ch00:10910102-10911481","992","10910102","10911481","1379","1549.65308533","0.889876587901"
"SL2.50ch00:10910254-10911483","966","10910254","10911483","1229","1549.65308533","0.793080729898"
"SL2.50ch00:10913428-10914869","484","10913428","10914869","1441","1549.65308533","0.929885542542"
"SL2.50ch00:10914214-10915006","381","10914214","10915006","792","1549.65308533","0.511082130252"
"SL2.50ch00:10917300-10919792","2895","10917300","10919792","2492","1549.65308533","1.60810185428"
"SL2.50ch00:10917329-10919689","2894","10917329","10919689","2360","1549.65308533","1.52292149924"
"SL2.50ch00:10926668-10929216","1387","10926668","10929216","2548","1549.65308533","1.6442389746"
"SL2.50ch00:10927570-10928982","1170","10927570","10928982","1412","1549.65308533","0.911171676661"
"SL2.50ch00:10931044-10933170","962","10931044","10933170","2126","1549.65308533","1.37191996075"
"SL2.50ch00:10931687-10933075","844","10931687","10933075","1388","1549.65308533","0.895684339381"
"SL2.50ch00:10935727-10937883","558","10935727","10937883","2156","1549.65308533","1.39127913235"
"SL2.50ch00:10938577-10943962","1627","10938577","10943962","5385","1549.65308533","3.47497130228"
"SL2.50ch00:10945239-10960714","4027","10945239","10960714","15475","1549.65308533","9.98610601723"
"SL2.50ch00:10953617-10953981","102","10953617","10953981","364","1549.65308533","0.234891282085"
"SL2.50ch00:10955011-10955564","133","10955011","10955564","553","1549.65308533","0.356854063168"
"SL2.50ch00:10960146-10960643","229","10960146","10960643","497","1549.65308533","0.320716942847"
"SL2.50ch00:10963562-10964175","176","10963562","10964175","613","1549.65308533","0.395572406369"
"SL2.50ch00:10963742-10964106","146","10963742","10964106","364","1549.65308533","0.234891282085"
"SL2.50ch00:10971080-10972214","343","10971080","10972214","1134","1549.65308533","0.731776686497"
"SL2.50ch00:10984444-10986807","839","10984444","10986807","2363","1549.65308533","1.5248574164"
"SL2.50ch00:10985090-10986751","748","10985090","10986751","1661","1549.65308533","1.07185280095"
"SL2.50ch00:10990771-10995810","1563","10990771","10995810","5039","1549.65308533","3.25169552316"
"SL2.50ch00:10990802-10992391","610","10990802","10992391","1589","1549.65308533","1.0253907891"
"SL2.50ch00:10992925-10994493","373","10992925","10994493","1568","1549.65308533","1.01183936898"
"SL2.50ch00:10995147-10995695","303","10995147","10995695","548","1549.65308533","0.353627534568"
"SL2.50ch00:10998547-11000247","678","10998547","11000247","1700","1549.65308533","1.09701972403"
"SL2.50ch00:10998634-11000359","678","10998634","11000359","1725","1549.65308533","1.11315236703"
"SL2.50ch00:11004863-11006838","972","11004863","11006838","1975","1549.65308533","1.27447879703"
"SL2.50ch00:11004911-11007134","1055","11004911","11007134","2223","1549.65308533","1.43451461559"
"SL2.50ch00:11012419-11012887","131","11012419","11012887","468","1549.65308533","0.302003076967"
"SL2.50ch00:11016290-11017393","182","11016290","11017393","1103","1549.65308533","0.711772209177"
"SL2.50ch00:11028979-11029941","200","11028979","11029941","962","1549.65308533","0.620784102654"
"SL2.50ch00:11031485-11032090","120","11031485","11032090","605","1549.65308533","0.390409960609"
"SL2.50ch00:11049670-11050591","224","11049670","11050591","921","1549.65308533","0.594326568134"
"SL2.50ch00:11055017-11077585","148148","11055017","11077585","22568","1549.65308533","14.5632594893"
"SL2.50ch00:11055336-11077495","147979","11055336","11077495","22159","1549.65308533","14.2993294498"
"SL2.50ch00:11141723-11142946","413","11141723","11142946","1223","1549.65308533","0.789208895578"
"SL2.50ch00:11141791-11146360","1246","11141791","11146360","4569","1549.65308533","2.94840183475"
"SL2.50ch00:11147045-11148514","543","11147045","11148514","1469","1549.65308533","0.947954102702"
"SL2.50ch00:11147397-11148370","470","11147397","11148370","973","1549.65308533","0.627882465575"
"SL2.50ch00:11154592-11157099","514","11154592","11157099","2507","1549.65308533","1.61778144008"
"SL2.50ch00:11160641-11161016","66","11160641","11161016","375","1549.65308533","0.241989645006"
"SL2.50ch00:11182279-11182999","233","11182279","11182999","720","1549.65308533","0.464620118411"
"SL2.50ch00:11182380-11182970","233","11182380","11182970","590","1549.65308533","0.380730374809"
"SL2.50ch00:11184514-11185940","420","11184514","11185940","1426","1549.65308533","0.920205956741"
"SL2.50ch00:11184589-11186007","420","11184589","11186007","1418","1549.65308533","0.915043510981"
"SL2.50ch00:11239893-11240848","325","11239893","11240848","955","1549.65308533","0.616266962614"
"SL2.50ch00:11239935-11240870","325","11239935","11240870","935","1549.65308533","0.603360848214"
"SL2.50ch00:11242536-11243721","398","11242536","11243721","1185","1549.65308533","0.764687278218"
"SL2.50ch00:11243071-11243435","130","11243071","11243435","364","1549.65308533","0.234891282085"
"SL2.50ch00:11244921-11246560","608","11244921","11246560","1639","1549.65308533","1.0576560751"
"SL2.50ch00:11245036-11246641","597","11245036","11246641","1605","1549.65308533","1.03571568062"
"SL2.50ch00:11251474-11254488","1027","11251474","11254488","3014","1549.65308533","1.94495144013"
"SL2.50ch00:11252925-11254491","629","11252925","11254491","1566","1549.65308533","1.01054875754"
"SL2.50ch00:11256104-11258743","637","11256104","11258743","2639","1549.65308533","1.70296179512"
"SL2.50ch00:11295429-11296112","158","11295429","11296112","683","1549.65308533","0.44074380677"
"SL2.50ch00:11297140-11297876","175","11297140","11297876","736","1549.65308533","0.474945009931"
"SL2.50ch00:11301387-11302198","247","11301387","11302198","811","1549.65308533","0.523342938932"
"SL2.50ch00:11302688-11304930","441","11302688","11304930","2242","1549.65308533","1.44677542427"
"SL2.50ch00:11307746-11308433","201","11307746","11308433","687","1549.65308533","0.44332502965"
"SL2.50ch00:11310302-11313701","2079","11310302","11313701","3399","1549.65308533","2.19339414233"
"SL2.50ch00:11310930-11313689","1991","11310930","11313689","2759","1549.65308533","1.78039848152"
"SL2.50ch00:11314457-11315839","1267","11314457","11315839","1382","1549.65308533","0.891812505061"
"SL2.50ch00:11314480-11315945","1265","11314480","11315945","1465","1549.65308533","0.945372879822"
"SL2.50ch00:11317021-11318848","689","11317021","11318848","1827","1549.65308533","1.17897355047"
"SL2.50ch00:11317113-11318869","675","11317113","11318869","1756","1549.65308533","1.13315684435"
"SL2.50ch00:11321897-11325977","1162","11321897","11325977","4080","1549.65308533","2.63284733766"
"SL2.50ch00:11323617-11325874","688","11323617","11325874","2257","1549.65308533","1.45645501007"
"SL2.50ch00:11327058-11336556","2300","11327058","11336556","9498","1549.65308533","6.1291137287"
"SL2.50ch00:11337168-11343493","1769","11337168","11343493","6325","1549.65308533","4.0815586791"
"SL2.50ch00:11341758-11343010","389","11341758","11343010","1252","1549.65308533","0.807922761459"
"SL2.50ch00:11343876-11345462","360","11343876","11345462","1586","1549.65308533","1.02345487194"
"SL2.50ch00:11362944-11363871","520","11362944","11363871","927","1549.65308533","0.598198402454"
"SL2.50ch00:11362979-11363782","520","11362979","11363782","803","1549.65308533","0.518180493172"
"SL2.50ch00:11369292-11373961","1396","11369292","11373961","4669","1549.65308533","3.01293240675"
"SL2.50ch00:11369319-11369683","127","11369319","11369683","364","1549.65308533","0.234891282085"
"SL2.50ch00:11372884-11373733","398","11372884","11373733","849","1549.65308533","0.547864556293"
"SL2.50ch00:11377836-11379479","730","11377836","11379479","1643","1549.65308533","1.06023729798"
"SL2.50ch00:11378002-11379404","703","11378002","11379404","1402","1549.65308533","0.904718619461"
"SL2.50ch00:11396294-11398139","898","11396294","11398139","1845","1549.65308533","1.19058905343"
"SL2.50ch00:11396295-11398007","898","11396295","11398007","1712","1549.65308533","1.10476339267"
"SL2.50ch00:11398925-11404518","2551","11398925","11404518","5593","1549.65308533","3.60919489204"
"SL2.50ch00:11399029-11404489","2540","11399029","11404489","5460","1549.65308533","3.52336923128"
"SL2.50ch00:11411123-11412587","896","11411123","11412587","1464","1549.65308533","0.944727574102"
"SL2.50ch00:11411231-11412588","869","11411231","11412588","1357","1549.65308533","0.87567986206"
"SL2.50ch00:11443795-11444573","200","11443795","11444573","778","1549.65308533","0.502047850172"
"SL2.50ch00:11443815-11444552","199","11443815","11444552","737","1549.65308533","0.475590315651"
"SL2.50ch00:11490669-11491521","316","11490669","11491521","852","1549.65308533","0.549800473453"
"SL2.50ch00:11490713-11491534","316","11490713","11491534","821","1549.65308533","0.529795996132"
"SL2.50ch00:11492659-11494444","484","11492659","11494444","1785","1549.65308533","1.15187071023"
"SL2.50ch00:11495655-11497053","608","11495655","11497053","1398","1549.65308533","0.902137396581"
"SL2.50ch00:11495673-11497057","608","11495673","11497057","1384","1549.65308533","0.893103116501"
"SL2.50ch00:11499356-11501348","853","11499356","11501348","1992","1549.65308533","1.28544899427"
"SL2.50ch00:11500559-11501218","480","11500559","11501218","659","1549.65308533","0.42525646949"
"SL2.50ch00:11501847-11503240","578","11501847","11503240","1393","1549.65308533","0.898910867981"
"SL2.50ch00:11501878-11503235","578","11501878","11503235","1357","1549.65308533","0.87567986206"
"SL2.50ch00:11504335-11505258","506","11504335","11505258","923","1549.65308533","0.595617179574"
"SL2.50ch00:11504344-11505143","506","11504344","11505143","799","1549.65308533","0.515599270292"
"SL2.50ch00:11510011-11512517","603","11510011","11512517","2506","1549.65308533","1.61713613436"
"SL2.50ch00:11510848-11512374","482","11510848","11512374","1526","1549.65308533","0.984736528743"
"SL2.50ch00:11516726-11517650","234","11516726","11517650","924","1549.65308533","0.596262485294"
"SL2.50ch00:11516891-11517652","214","11516891","11517652","761","1549.65308533","0.491077652931"
"SL2.50ch00:11534144-11548092","8361","11534144","11548092","13948","1549.65308533","9.00072418277"
"SL2.50ch00:11535447-11545025","6817","11535447","11545025","9578","1549.65308533","6.1807381863"
"SL2.50ch00:11545532-11547869","970","11545532","11547869","2337","1549.65308533","1.50807946768"
"SL2.50ch00:11565406-11566479","232","11565406","11566479","1073","1549.65308533","0.692413037576"
"SL2.50ch00:11569964-11571143","231","11569964","11571143","1179","1549.65308533","0.760815443898"
"SL2.50ch00:11573020-11573805","158","11573020","11573805","785","1549.65308533","0.506564990212"
"SL2.50ch00:11576933-11591013","4778","11576933","11591013","14080","1549.65308533","9.08590453781"
"SL2.50ch00:11577037-11582965","2787","11577037","11582965","5928","1549.65308533","3.82537230825"
"SL2.50ch00:11587988-11588972","245","11587988","11588972","984","1549.65308533","0.634980828495"
"SL2.50ch00:11650873-11651237","140","11650873","11651237","364","1549.65308533","0.234891282085"
"SL2.50ch00:11655357-11656971","2090","11655357","11656971","1614","1549.65308533","1.0415234321"
"SL2.50ch00:11655359-11656929","2090","11655359","11656929","1570","1549.65308533","1.01312998042"
"SL2.50ch00:11658380-11659404","559","11658380","11659404","1024","1549.65308533","0.660793057295"
"SL2.50ch00:11658447-11659399","559","11658447","11659399","952","1549.65308533","0.614331045454"
"SL2.50ch00:11685673-11686943","417","11685673","11686943","1270","1549.65308533","0.819538264419"
"SL2.50ch00:11685700-11686817","417","11685700","11686817","1117","1549.65308533","0.720806489257"
"SL2.50ch00:11687544-11689658","955","11687544","11689658","2114","1549.65308533","1.36417629211"
"SL2.50ch00:11687618-11689565","950","11687618","11689565","1947","1549.65308533","1.25641023687"
"SL2.50ch00:11690380-11693474","1037","11690380","11693474","3094","1549.65308533","1.99657589773"
"SL2.50ch00:11690522-11694248","1327","11690522","11694248","3726","1549.65308533","2.40440911278"
"SL2.50ch00:11695274-11695742","182","11695274","11695742","468","1549.65308533","0.302003076967"
"SL2.50ch00:11695276-11695733","182","11695276","11695733","457","1549.65308533","0.294904714047"
"SL2.50ch00:11697579-11698449","516","11697579","11698449","870","1549.65308533","0.561415976413"
"SL2.50ch00:11697607-11698431","498","11697607","11698431","824","1549.65308533","0.531731913292"
"SL2.50ch00:11736196-11738172","1823","11736196","11738172","1976","1549.65308533","1.27512410275"
"SL2.50ch00:11736294-11738166","1823","11736294","11738166","1872","1549.65308533","1.20801230787"
"SL2.50ch00:11740279-11741152","179","11740279","11741152","873","1549.65308533","0.563351893573"
"SL2.50ch00:11773891-11775716","9610","11773891","11775716","1825","1549.65308533","1.17768293903"
"SL2.50ch00:11773930-11775744","9536","11773930","11775744","1814","1549.65308533","1.17058457611"
"SL2.50ch00:11777392-11778541","7029","11777392","11778541","1149","1549.65308533","0.741456272297"
"SL2.50ch00:11777422-11778524","7023","11777422","11778524","1102","1549.65308533","0.711126903457"
"SL2.50ch00:11780867-11786256","25026","11780867","11786256","5389","1549.65308533","3.47755252516"
"SL2.50ch00:11780940-11782127","5884","11780940","11782127","1187","1549.65308533","0.765977889658"
"SL2.50ch00:11782630-11786168","19009","11782630","11786168","3538","1549.65308533","2.28309163741"
"SL2.50ch00:11789557-11790432","301","11789557","11790432","875","1549.65308533","0.564642505013"
"SL2.50ch00:11796774-11810562","92012","11796774","11810562","13788","1549.65308533","8.89747526757"
"SL2.50ch00:11798123-11810441","91634","11798123","11810441","12318","1549.65308533","7.94887585915"
"SL2.50ch00:11811283-11817977","1306","11811283","11817977","6694","1549.65308533","4.31967648978"
"SL2.50ch00:11818480-11818844","58","11818480","11818844","364","1549.65308533","0.234891282085"
"SL2.50ch00:11818814-11820433","424","11818814","11820433","1619","1549.65308533","1.0447499607"
"SL2.50ch00:11851604-11851979","149","11851604","11851979","375","1549.65308533","0.241989645006"
"SL2.50ch00:11855458-11855833","93","11855458","11855833","375","1549.65308533","0.241989645006"
"SL2.50ch00:11857566-11868424","3098","11857566","11868424","10858","1549.65308533","7.00672950792"
"SL2.50ch00:11858692-11861776","1111","11858692","11861776","3084","1549.65308533","1.99012284053"
"SL2.50ch00:11863372-11864721","468","11863372","11864721","1349","1549.65308533","0.8705174163"
"SL2.50ch00:11865558-11866953","433","11865558","11866953","1395","1549.65308533","0.900201479421"
"SL2.50ch00:11879807-11880392","123","11879807","11880392","585","1549.65308533","0.377503846209"
"SL2.50ch00:11901041-11902147","271","11901041","11902147","1106","1549.65308533","0.713708126337"
"SL2.50ch00:11919197-11920404","229","11919197","11920404","1207","1549.65308533","0.778884004058"
"SL2.50ch00:11934769-11935987","534","11934769","11935987","1218","1549.65308533","0.785982366978"
"SL2.50ch00:11934789-11936007","534","11934789","11936007","1218","1549.65308533","0.785982366978"
"SL2.50ch00:11944467-11945834","460","11944467","11945834","1367","1549.65308533","0.882132919261"
"SL2.50ch00:11944480-11945795","455","11944480","11945795","1315","1549.65308533","0.84857702182"
"SL2.50ch00:11966673-11976948","60879","11966673","11976948","10275","1549.65308533","6.63051627315"
"SL2.50ch00:11966820-11976997","60811","11966820","11976997","10177","1549.65308533","6.56727631259"
"SL2.50ch00:11986921-11988022","878","11986921","11988022","1101","1549.65308533","0.710481597737"
"SL2.50ch00:11986923-11987952","878","11986923","11987952","1029","1549.65308533","0.664019585895"
"SL2.50ch00:11990790-11991712","467","11990790","11991712","922","1549.65308533","0.594971873854"
"SL2.50ch00:11990836-11991745","467","11990836","11991745","909","1549.65308533","0.586582899494"
"SL2.50ch00:11993084-11994653","1679","11993084","11994653","1569","1549.65308533","1.0124846747"
"SL2.50ch00:11993130-11994588","1664","11993130","11994588","1458","1549.65308533","0.940855739782"
"SL2.50ch00:11996135-11996873","809","11996135","11996873","738","1549.65308533","0.476235621371"
"SL2.50ch00:11996143-11996976","815","11996143","11996976","833","1549.65308533","0.537539664773"
"SL2.50ch00:12006275-12016199","88907","12006275","12016199","9924","1549.65308533","6.40401396543"
"SL2.50ch00:12006317-12016238","88912","12006317","12016238","9921","1549.65308533","6.40207804827"
"SL2.50ch00:12039855-12043885","856","12039855","12043885","4030","1549.65308533","2.60058205166"
"SL2.50ch00:12088241-12089533","465","12088241","12089533","1292","1549.65308533","0.833734990259"
"SL2.50ch00:12090867-12091866","303","12090867","12091866","999","1549.65308533","0.644660414295"
"SL2.50ch00:12090963-12091779","292","12090963","12091779","816","1549.65308533","0.526569467532"
"SL2.50ch00:12127984-12128730","415","12127984","12128730","746","1549.65308533","0.481398067131"
"SL2.50ch00:12128092-12154010","117704","12128092","12154010","25918","1549.65308533","16.7250336514"
"SL2.50ch00:12129600-12133750","2388","12129600","12133750","4150","1549.65308533","2.67801873806"
"SL2.50ch00:12135231-12154116","114344","12135231","12154116","18885","1549.65308533","12.1865985225"
"SL2.50ch00:12212219-12214965","1161","12212219","12214965","2746","1549.65308533","1.77200950716"
"SL2.50ch00:12212252-12219919","3162","12212252","12219919","7667","1549.65308533","4.94755895536"
"SL2.50ch00:12215343-12219818","1886","12215343","12219818","4475","1549.65308533","2.88774309707"
"SL2.50ch00:12248404-12249285","174","12248404","12249285","881","1549.65308533","0.568514339333"
"SL2.50ch00:12265906-12282052","98972","12265906","12282052","16146","1549.65308533","10.4191061554"
"SL2.50ch00:12266633-12282037","98838","12266633","12282037","15404","1549.65308533","9.94028931111"
"SL2.50ch00:12300519-12302423","532","12300519","12302423","1904","1549.65308533","1.22866209091"
"SL2.50ch00:12312461-12319857","1882","12312461","12319857","7396","1549.65308533","4.77268110523"
"SL2.50ch00:12312668-12313411","218","12312668","12313411","743","1549.65308533","0.479462149971"
"SL2.50ch00:12322111-12324059","432","12322111","12324059","1948","1549.65308533","1.25705554259"
"SL2.50ch00:12324604-12326161","452","12324604","12326161","1557","1549.65308533","1.00474100606"
"SL2.50ch00:12324677-12325941","398","12324677","12325941","1264","1549.65308533","0.815666430099"
"SL2.50ch00:12348984-12349814","342","12348984","12349814","830","1549.65308533","0.535603747612"
"SL2.50ch00:12355984-12356471","100","12355984","12356471","487","1549.65308533","0.314263885647"
"SL2.50ch00:12441988-12442941","210","12441988","12442941","953","1549.65308533","0.614976351174"
"SL2.50ch00:12492797-12501111","2763","12492797","12501111","8314","1549.65308533","5.36507175621"
"SL2.50ch00:12492857-12494014","587","12492857","12494014","1157","1549.65308533","0.746618718057"
"SL2.50ch00:12496623-12498995","904","12496623","12498995","2372","1549.65308533","1.53066516788"
"SL2.50ch00:12504566-12506165","328","12504566","12506165","1599","1549.65308533","1.0318438463"
"SL2.50ch00:12561348-12561723","114","12561348","12561723","375","1549.65308533","0.241989645006"
"SL2.50ch00:12569894-12572562","660","12569894","12572562","2668","1549.65308533","1.721675661"
"SL2.50ch00:12570971-12571733","248","12570971","12571733","762","1549.65308533","0.491722958651"
"SL2.50ch00:12643072-12645845","707","12643072","12645845","2773","1549.65308533","1.7894327616"
"SL2.50ch00:12646403-12647798","417","12646403","12647798","1395","1549.65308533","0.900201479421"
"SL2.50ch00:12704280-12705169","184","12704280","12705169","889","1549.65308533","0.573676785093"
"SL2.50ch00:12738178-12739382","228","12738178","12739382","1204","1549.65308533","0.776948086898"
"SL2.50ch00:12754371-12754746","202","12754371","12754746","375","1549.65308533","0.241989645006"
"SL2.50ch00:12754390-12754754","202","12754390","12754754","364","1549.65308533","0.234891282085"
"SL2.50ch00:12756464-12757481","652","12756464","12757481","1017","1549.65308533","0.656275917255"
"SL2.50ch00:12756615-12757494","642","12756615","12757494","879","1549.65308533","0.567223727893"
"SL2.50ch00:12758264-12760261","1809","12758264","12760261","1997","1549.65308533","1.28867552287"
"SL2.50ch00:12758317-12760287","1809","12758317","12760287","1970","1549.65308533","1.27125226843"
"SL2.50ch00:12772651-12779661","2404","12772651","12779661","7010","1549.65308533","4.52359309731"
"SL2.50ch00:12772728-12778904","2173","12772728","12778904","6176","1549.65308533","3.98540812681"
"SL2.50ch00:12781953-12784325","489","12781953","12784325","2372","1549.65308533","1.53066516788"
"SL2.50ch00:12942351-12943035","302","12942351","12943035","684","1549.65308533","0.44138911249"
"SL2.50ch00:12945526-12947720","894","12945526","12947720","2194","1549.65308533","1.41580074971"
"SL2.50ch00:12953394-12958782","22028","12953394","12958782","5388","1549.65308533","3.47690721944"
"SL2.50ch00:12953591-12958594","21950","12953591","12958594","5003","1549.65308533","3.22846451724"
"SL2.50ch00:12971641-12972651","245","12971641","12972651","1010","1549.65308533","0.651758777215"
"SL2.50ch00:12976046-12981524","1595","12976046","12981524","5478","1549.65308533","3.53498473424"
"SL2.50ch00:12976595-12980280","1133","12976595","12980280","3685","1549.65308533","2.37795157826"
"SL2.50ch00:13042994-13043992","331","13042994","13043992","998","1549.65308533","0.644015108575"
"SL2.50ch00:13048685-13050095","332","13048685","13050095","1410","1549.65308533","0.909881065221"
"SL2.50ch00:13050589-13050964","68","13050589","13050964","375","1549.65308533","0.241989645006"
"SL2.50ch00:13052260-13053886","420","13052260","13053886","1626","1549.65308533","1.04926710074"
"SL2.50ch00:13052284-13053828","417","13052284","13053828","1544","1549.65308533","0.996352031703"
"SL2.50ch00:13173739-13179206","2537","13173739","13179206","5467","1549.65308533","3.52788637132"
"SL2.50ch00:13173929-13179166","2537","13173929","13179166","5237","1549.65308533","3.37946605572"
"SL2.50ch00:13219018-13220754","360","13219018","13220754","1736","1549.65308533","1.12025072995"
"SL2.50ch00:13258573-13258948","71","13258573","13258948","375","1549.65308533","0.241989645006"
"SL2.50ch00:13287463-13288489","271","13287463","13288489","1026","1549.65308533","0.662083668735"
"SL2.50ch00:13301645-13302233","759","13301645","13302233","588","1549.65308533","0.379439763369"
"SL2.50ch00:13301745-13303148","957","13301745","13303148","1403","1549.65308533","0.905363925181"
"SL2.50ch00:13305430-13306986","473","13305430","13306986","1556","1549.65308533","1.00409570034"
"SL2.50ch00:13374936-13375835","3749","13374936","13375835","899","1549.65308533","0.580129842294"
"SL2.50ch00:13374951-13375859","3749","13374951","13375859","908","1549.65308533","0.585937593774"
"SL2.50ch00:13379464-13380319","5870","13379464","13380319","855","1549.65308533","0.551736390613"
"SL2.50ch00:13379473-13380272","5864","13379473","13380272","799","1549.65308533","0.515599270292"
"SL2.50ch00:13386849-13388170","440","13386849","13388170","1321","1549.65308533","0.85244885614"
"SL2.50ch00:13447403-13448475","235","13447403","13448475","1072","1549.65308533","0.691767731856"
"SL2.50ch00:13460469-13460993","104","13460469","13460993","524","1549.65308533","0.338140197288"
"SL2.50ch00:13492816-13494529","568","13492816","13494529","1713","1549.65308533","1.10540869839"
"SL2.50ch00:13493430-13494409","497","13493430","13494409","979","1549.65308533","0.631754299895"
"SL2.50ch00:13496795-13498327","638","13496795","13498327","1532","1549.65308533","0.988608363063"
"SL2.50ch00:13496828-13498172","626","13496828","13498172","1344","1549.65308533","0.8672908877"
"SL2.50ch00:13503303-13508274","12864","13503303","13508274","4971","1549.65308533","3.20781473419"
"SL2.50ch00:13503398-13507650","12704","13503398","13507650","4252","1549.65308533","2.7438399215"
"SL2.50ch00:13569888-13570416","122","13569888","13570416","528","1549.65308533","0.340721420168"
"SL2.50ch00:13603324-13608439","26148","13603324","13608439","5115","1549.65308533","3.30073875788"
"SL2.50ch00:13603335-13608262","26135","13603335","13608262","4927","1549.65308533","3.17942128251"
"SL2.50ch00:13689091-13689791","440","13689091","13689791","700","1549.65308533","0.451714004011"
"SL2.50ch00:13689138-13689838","446","13689138","13689838","700","1549.65308533","0.451714004011"
"SL2.50ch00:13690368-13691477","416","13690368","13691477","1109","1549.65308533","0.715644043497"
"SL2.50ch00:13690527-13691502","411","13690527","13691502","975","1549.65308533","0.629173077015"
"SL2.50ch00:13764405-13769492","23199","13764405","13769492","5087","1549.65308533","3.28267019772"
"SL2.50ch00:13764737-13769489","23173","13764737","13769489","4752","1549.65308533","3.06649278151"
"SL2.50ch00:14016578-14019015","756","14016578","14019015","2437","1549.65308533","1.57261003968"
"SL2.50ch00:14017919-14018803","428","14017919","14018803","884","1549.65308533","0.570450256493"
"SL2.50ch00:14094989-14095741","224","14094989","14095741","752","1549.65308533","0.485269901451"
"SL2.50ch00:14120406-14121408","474","14120406","14121408","1002","1549.65308533","0.646596331455"
"SL2.50ch00:14120464-14121414","465","14120464","14121414","950","1549.65308533","0.613040434014"
"SL2.50ch00:14123247-14124871","460","14123247","14124871","1624","1549.65308533","1.0479764893"
"SL2.50ch00:14123286-14124863","455","14123286","14124863","1577","1549.65308533","1.01764712046"
"SL2.50ch00:14257651-14258925","239","14257651","14258925","1274","1549.65308533","0.822119487299"
"SL2.50ch00:14287194-14287782","356","14287194","14287782","588","1549.65308533","0.379439763369"
"SL2.50ch00:14287299-14287967","381","14287299","14287967","668","1549.65308533","0.43106422097"
"SL2.50ch00:14290597-14291627","1079","14290597","14291627","1030","1549.65308533","0.664664891616"
"SL2.50ch00:14290600-14291614","1079","14290600","14291614","1014","1549.65308533","0.654340000095"
"SL2.50ch00:14292320-14292792","127","14292320","14292792","472","1549.65308533","0.304584299847"
"SL2.50ch00:14299681-14300277","119","14299681","14300277","596","1549.65308533","0.384602209129"
"SL2.50ch00:14314090-14314978","199","14314090","14314978","888","1549.65308533","0.573031479373"
"SL2.50ch00:14316774-14318231","412","14316774","14318231","1457","1549.65308533","0.940210434062"
"SL2.50ch00:14352785-14353252","128","14352785","14353252","467","1549.65308533","0.301357771247"
"SL2.50ch00:14409505-14410967","446","14409505","14410967","1462","1549.65308533","0.943436962662"
"SL2.50ch00:14409691-14410971","413","14409691","14410971","1280","1549.65308533","0.825991321619"
"SL2.50ch00:14437552-14441686","3164","14437552","14441686","4134","1549.65308533","2.66769384654"
"SL2.50ch00:14437561-14441702","3164","14437561","14441702","4141","1549.65308533","2.67221098658"
"SL2.50ch00:14505245-14506926","625","14505245","14506926","1681","1549.65308533","1.08475891535"
"SL2.50ch00:14505593-14506181","334","14505593","14506181","588","1549.65308533","0.379439763369"
"SL2.50ch00:14510838-14511426","227","14510838","14511426","588","1549.65308533","0.379439763369"
"SL2.50ch00:14510996-14511371","219","14510996","14511371","375","1549.65308533","0.241989645006"
"SL2.50ch00:14514668-14515895","321","14514668","14515895","1227","1549.65308533","0.791790118458"
"SL2.50ch00:14520230-14525038","1186","14520230","14525038","4808","1549.65308533","3.10262990183"
"SL2.50ch00:14545766-14550452","39890","14545766","14550452","4686","1549.65308533","3.02390260399"
"SL2.50ch00:14545956-14550551","39891","14545956","14550551","4595","1549.65308533","2.96517978347"
"SL2.50ch00:14558944-14559319","67","14558944","14559319","375","1549.65308533","0.241989645006"
"SL2.50ch00:14561327-14562517","227","14561327","14562517","1190","1549.65308533","0.767913806818"
"SL2.50ch00:14561795-14562366","103","14561795","14562366","571","1549.65308533","0.368469566129"
"SL2.50ch00:14571931-14572899","278","14571931","14572899","968","1549.65308533","0.624655936975"
"SL2.50ch00:14575076-14576030","332","14575076","14576030","954","1549.65308533","0.615621656894"
"SL2.50ch00:14635309-14636138","240","14635309","14636138","829","1549.65308533","0.534958441892"
"SL2.50ch00:14637586-14637961","67","14637586","14637961","375","1549.65308533","0.241989645006"
"SL2.50ch00:14644994-14645671","163","14644994","14645671","677","1549.65308533","0.43687197245"
"SL2.50ch00:14648440-14648944","154","14648440","14648944","504","1549.65308533","0.325234082888"
"SL2.50ch00:14656365-14657036","166","14656365","14657036","671","1549.65308533","0.43300013813"
"SL2.50ch00:14662175-14662732","126","14662175","14662732","557","1549.65308533","0.359435286048"
"SL2.50ch00:14665313-14665877","164","14665313","14665877","564","1549.65308533","0.363952426088"
"SL2.50ch00:14670464-14675744","15804","14670464","14675744","5280","1549.65308533","3.40721420168"
"SL2.50ch00:14670522-14675771","15804","14670522","14675771","5249","1549.65308533","3.38720972436"
"SL2.50ch00:14677192-14679137","2270","14677192","14679137","1945","1549.65308533","1.25511962543"
"SL2.50ch00:14677253-14679141","2262","14677253","14679141","1888","1549.65308533","1.21833719939"
"SL2.50ch00:14696361-14697794","477","14696361","14697794","1433","1549.65308533","0.924723096782"
"SL2.50ch00:14763890-14767757","899","14763890","14767757","3867","1549.65308533","2.4953972193"
"SL2.50ch00:14796359-14797237","453","14796359","14797237","878","1549.65308533","0.566578422173"
"SL2.50ch00:14796450-14797304","450","14796450","14797304","854","1549.65308533","0.551091084893"
"SL2.50ch00:14801789-14802153","161","14801789","14802153","364","1549.65308533","0.234891282085"
"SL2.50ch00:14801812-14802187","160","14801812","14802187","375","1549.65308533","0.241989645006"
"SL2.50ch00:14804036-14805741","1859","14804036","14805741","1705","1549.65308533","1.10024625263"
"SL2.50ch00:14804074-14805704","1859","14804074","14805704","1630","1549.65308533","1.05184832362"
"SL2.50ch00:14887886-14889159","360","14887886","14889159","1273","1549.65308533","0.821474181579"
"SL2.50ch00:14887931-14888410","165","14887931","14888410","479","1549.65308533","0.309101439887"
"SL2.50ch00:14959706-14961350","510","14959706","14961350","1644","1549.65308533","1.0608826037"
"SL2.50ch00:14959757-14960492","253","14959757","14960492","735","1549.65308533","0.474299704211"
"SL2.50ch00:14962603-14963717","604","14962603","14963717","1114","1549.65308533","0.718870572097"
"SL2.50ch00:14962621-14963717","604","14962621","14963717","1096","1549.65308533","0.707255069136"
"SL2.50ch00:14992372-14993724","290","14992372","14993724","1352","1549.65308533","0.87245333346"
"SL2.50ch00:14994688-14996344","395","14994688","14996344","1656","1549.65308533","1.06862627234"
"SL2.50ch00:14999679-15000674","354","14999679","15000674","995","1549.65308533","0.642079191415"
"SL2.50ch00:14999721-15000572","351","14999721","15000572","851","1549.65308533","0.549155167733"
"SL2.50ch00:15070855-15071640","200","15070855","15071640","785","1549.65308533","0.506564990212"
"SL2.50ch00:15134766-15135403","130","15134766","15135403","637","1549.65308533","0.41105974365"
"SL2.50ch00:15136958-15137695","163","15136958","15137695","737","1549.65308533","0.475590315651"
"SL2.50ch00:15138696-15139752","434","15138696","15139752","1056","1549.65308533","0.681442840336"
"SL2.50ch00:15138812-15139746","412","15138812","15139746","934","1549.65308533","0.602715542494"
"SL2.50ch00:15142584-15146512","1552","15142584","15146512","3928","1549.65308533","2.53476086822"
"SL2.50ch00:15144909-15146408","772","15144909","15146408","1499","1549.65308533","0.967313274303"
"SL2.50ch00:15154024-15154480","350","15154024","15154480","456","1549.65308533","0.294259408327"
"SL2.50ch00:15290061-15291623","381","15290061","15291623","1562","1549.65308533","1.00796753466"
"SL2.50ch00:15290103-15291416","340","15290103","15291416","1313","1549.65308533","0.84728641038"
"SL2.50ch00:15292978-15293623","159","15292978","15293623","645","1549.65308533","0.41622218941"
"SL2.50ch00:15313988-15314494","117","15313988","15314494","506","1549.65308533","0.326524694328"
"SL2.50ch00:15316587-15317171","157","15316587","15317171","584","1549.65308533","0.376858540489"
"SL2.50ch00:15321351-15322481","740","15321351","15322481","1130","1549.65308533","0.729195463617"
"SL2.50ch00:15321597-15322429","714","15321597","15322429","832","1549.65308533","0.536894359053"
"SL2.50ch00:15324295-15325261","698","15324295","15325261","966","1549.65308533","0.623365325535"
"SL2.50ch00:15324305-15325283","698","15324305","15325283","978","1549.65308533","0.631108994175"
"SL2.50ch00:15345089-15346312","357","15345089","15346312","1223","1549.65308533","0.789208895578"
"SL2.50ch00:15348054-15348898","766","15348054","15348898","844","1549.65308533","0.544638027693"
"SL2.50ch00:15348056-15348923","766","15348056","15348923","867","1549.65308533","0.559480059253"
"SL2.50ch00:15360589-15361715","466","15360589","15361715","1126","1549.65308533","0.726614240737"
"SL2.50ch00:15360738-15361653","466","15360738","15361653","915","1549.65308533","0.590454733814"
"SL2.50ch00:15363014-15364249","444","15363014","15364249","1235","1549.65308533","0.796952564219"
"SL2.50ch00:15363027-15364516","484","15363027","15364516","1489","1549.65308533","0.960860217102"
"SL2.50ch00:15385655-15387683","407","15385655","15387683","2028","1549.65308533","1.30868000019"
"SL2.50ch00:15450306-15451191","174","15450306","15451191","885","1549.65308533","0.571095562213"
"SL2.50ch00:15452872-15453851","415","15452872","15453851","979","1549.65308533","0.631754299895"
"SL2.50ch00:15452996-15453757","394","15452996","15453757","761","1549.65308533","0.491077652931"
"SL2.50ch00:15473228-15477148","2082","15473228","15477148","3920","1549.65308533","2.52959842246"
"SL2.50ch00:15473361-15477081","2082","15473361","15477081","3720","1549.65308533","2.40053727846"
"SL2.50ch00:15526084-15526576","99","15526084","15526576","492","1549.65308533","0.317490414247"
"SL2.50ch00:15534672-15536291","2992","15534672","15536291","1619","1549.65308533","1.0447499607"
"SL2.50ch00:15534724-15536198","2988","15534724","15536198","1474","1549.65308533","0.951180631302"
"SL2.50ch00:15538037-15542526","27203","15538037","15542526","4489","1549.65308533","2.89677737715"
"SL2.50ch00:15538082-15542586","27203","15538082","15542586","4504","1549.65308533","2.90645696295"
"SL2.50ch00:15813963-15814651","458","15813963","15814651","688","1549.65308533","0.44397033537"
"SL2.50ch00:15814048-15814636","458","15814048","15814636","588","1549.65308533","0.379439763369"
"SL2.50ch00:15816197-15816760","148","15816197","15816760","563","1549.65308533","0.363307120368"
"SL2.50ch00:15864409-15865185","207","15864409","15865185","776","1549.65308533","0.500757238732"
"SL2.50ch00:15877083-15880569","1611","15877083","15880569","3486","1549.65308533","2.24953573997"
"SL2.50ch00:15877180-15880658","1597","15877180","15880658","3478","1549.65308533","2.24437329421"
"SL2.50ch00:15884540-15887881","714","15884540","15887881","3341","1549.65308533","2.15596641057"
"SL2.50ch00:15902889-15903811","256","15902889","15903811","922","1549.65308533","0.594971873854"
"SL2.50ch00:15902896-15903585","229","15902896","15903585","689","1549.65308533","0.44461564109"
"SL2.50ch00:15905756-15906358","277","15905756","15906358","602","1549.65308533","0.388474043449"
"SL2.50ch00:15917581-15920900","848","15917581","15920900","3319","1549.65308533","2.14176968473"
"SL2.50ch00:15961446-15961917","173","15961446","15961917","471","1549.65308533","0.303938994127"
"SL2.50ch00:15963788-15964915","451","15963788","15964915","1127","1549.65308533","0.727259546457"
"SL2.50ch00:15964561-15964925","320","15964561","15964925","364","1549.65308533","0.234891282085"
"SL2.50ch00:15997704-16001211","1421","15997704","16001211","3507","1549.65308533","2.26308716009"
"SL2.50ch00:15997780-16000508","1189","15997780","16000508","2728","1549.65308533","1.7603940042"
"SL2.50ch00:16026787-16027412","380","16026787","16027412","625","1549.65308533","0.403316075009"
"SL2.50ch00:16026828-16030185","1694","16026828","16030185","3357","1549.65308533","2.16629130209"
"SL2.50ch00:16027853-16030031","1158","16027853","16030031","2178","1549.65308533","1.40547585819"
"SL2.50ch00:16051815-16055485","25059","16051815","16055485","3670","1549.65308533","2.36827199246"
"SL2.50ch00:16051965-16055610","25059","16051965","16055610","3645","1549.65308533","2.35213934945"
"SL2.50ch00:16145175-16146605","258","16145175","16146605","1430","1549.65308533","0.922787179622"
"SL2.50ch00:16180731-16184263","20174","16180731","16184263","3532","1549.65308533","2.27921980309"
"SL2.50ch00:16180773-16184261","20106","16180773","16184261","3488","1549.65308533","2.25082635141"
"SL2.50ch00:16195117-16198253","873","16195117","16198253","3136","1549.65308533","2.02367873797"
"SL2.50ch00:16195788-16198270","725","16195788","16198270","2482","1549.65308533","1.60164879708"
"SL2.50ch00:16209373-16210425","274","16209373","16210425","1052","1549.65308533","0.678861617456"
"SL2.50ch00:16243371-16243856","91","16243371","16243856","485","1549.65308533","0.312973274207"
"SL2.50ch00:16246786-16247374","157","16246786","16247374","588","1549.65308533","0.379439763369"
"SL2.50ch00:16246848-16247320","150","16246848","16247320","472","1549.65308533","0.304584299847"
"SL2.50ch00:16302660-16303035","79","16302660","16303035","375","1549.65308533","0.241989645006"
"SL2.50ch00:16310901-16312253","840","16310901","16312253","1352","1549.65308533","0.87245333346"
"SL2.50ch00:16310933-16312394","838","16310933","16312394","1461","1549.65308533","0.942791656942"
"SL2.50ch00:16313933-16314671","235","16313933","16314671","738","1549.65308533","0.476235621371"
"SL2.50ch00:16313979-16314448","232","16313979","16314448","469","1549.65308533","0.302648382687"
"SL2.50ch00:16384258-16388143","1268","16384258","16388143","3885","1549.65308533","2.50701272226"
"SL2.50ch00:16384411-16387091","1014","16384411","16387091","2680","1549.65308533","1.72941932964"
"SL2.50ch00:16390456-16390831","69","16390456","16390831","375","1549.65308533","0.241989645006"
"SL2.50ch00:16397852-16401510","17411","16397852","16401510","3658","1549.65308533","2.36052832382"
"SL2.50ch00:16397954-16401517","17408","16397954","16401517","3563","1549.65308533","2.29922428041"
"SL2.50ch00:16531803-16534845","1074","16531803","16534845","3042","1549.65308533","1.96302000029"
"SL2.50ch00:16548958-16549602","195","16548958","16549602","644","1549.65308533","0.41557688369"
"SL2.50ch00:16562327-16565754","1461","16562327","16565754","3427","1549.65308533","2.21146270249"
"SL2.50ch00:16562514-16565684","1452","16562514","16565684","3170","1549.65308533","2.04561913245"
"SL2.50ch00:16636709-16639944","9539","16636709","16639944","3235","1549.65308533","2.08756400425"
"SL2.50ch00:16636903-16639894","9504","16636903","16639894","2991","1549.65308533","1.93010940857"
"SL2.50ch00:16661189-16666628","1738","16661189","16666628","5439","1549.65308533","3.50981781116"
"SL2.50ch00:16663533-16666572","1286","16663533","16666572","3039","1549.65308533","1.96108408313"
"SL2.50ch00:16797300-16797965","163","16797300","16797965","665","1549.65308533","0.42912830381"
"SL2.50ch00:16879461-16880006","455","16879461","16880006","545","1549.65308533","0.351691617408"
"SL2.50ch00:16901241-16904600","2866","16901241","16904600","3359","1549.65308533","2.16758191353"
"SL2.50ch00:16901351-16902357","600","16901351","16902357","1006","1549.65308533","0.649177554335"
"SL2.50ch00:16903141-16904565","2139","16903141","16904565","1424","1549.65308533","0.918915345301"
"SL2.50ch00:16950123-16951238","657","16950123","16951238","1115","1549.65308533","0.719515877817"
"SL2.50ch00:16950305-16951243","642","16950305","16951243","938","1549.65308533","0.605296765374"
"SL2.50ch00:16952572-16953439","544","16952572","16953439","867","1549.65308533","0.559480059253"
"SL2.50ch00:16952575-16953370","544","16952575","16953370","795","1549.65308533","0.513018047412"
"SL2.50ch00:16962948-16963999","999","16962948","16963999","1051","1549.65308533","0.678216311736"
"SL2.50ch00:16963010-16963961","997","16963010","16963961","951","1549.65308533","0.613685739734"
"SL2.50ch00:16965752-16966488","526","16965752","16966488","736","1549.65308533","0.474945009931"
"SL2.50ch00:16965773-16966395","525","16965773","16966395","622","1549.65308533","0.401380157849"
"SL2.50ch00:17011555-17014738","1165","17011555","17014738","3183","1549.65308533","2.05400810681"
"SL2.50ch00:17011694-17014694","1165","17011694","17014694","3000","1549.65308533","1.93591716005"
"SL2.50ch00:17108285-17108956","159","17108285","17108956","671","1549.65308533","0.43300013813"
"SL2.50ch00:17155453-17158858","18909","17155453","17158858","3405","1549.65308533","2.19726597665"
"SL2.50ch00:17155687-17158917","18913","17155687","17158917","3230","1549.65308533","2.08433747565"
"SL2.50ch00:17231414-17234424","1171","17231414","17234424","3010","1549.65308533","1.94237021725"
"SL2.50ch00:17231417-17234424","1171","17231417","17234424","3007","1549.65308533","1.94043430009"
"SL2.50ch00:17297353-17300479","1122","17297353","17300479","3126","1549.65308533","2.01722568077"
"SL2.50ch00:17297413-17298001","184","17297413","17298001","588","1549.65308533","0.379439763369"
"SL2.50ch00:17299575-17300334","390","17299575","17300334","759","1549.65308533","0.489787041491"
"SL2.50ch00:17347262-17350306","1381","17347262","17350306","3044","1549.65308533","1.96431061173"
"SL2.50ch00:17347271-17350095","1373","17347271","17350095","2824","1549.65308533","1.82234335332"
"SL2.50ch00:17458431-17461337","1272","17458431","17461337","2906","1549.65308533","1.87525842236"
"SL2.50ch00:17458539-17461345","1238","17458539","17461345","2806","1549.65308533","1.81072785036"
"SL2.50ch00:17522838-17525278","7002","17522838","17525278","2440","1549.65308533","1.57454595684"
"SL2.50ch00:17522856-17525186","6983","17522856","17525186","2330","1549.65308533","1.50356232764"
"SL2.50ch00:17606934-17607298","100","17606934","17607298","364","1549.65308533","0.234891282085"
"SL2.50ch00:17634681-17637684","3488","17634681","17637684","3003","1549.65308533","1.93785307721"
"SL2.50ch00:17634719-17637657","3488","17634719","17637657","2938","1549.65308533","1.8959082054"
"SL2.50ch00:17652904-17654436","538","17652904","17654436","1532","1549.65308533","0.988608363063"
"SL2.50ch00:17676871-17678777","352","17676871","17678777","1906","1549.65308533","1.22995270235"
"SL2.50ch00:17745760-17747595","320","17745760","17747595","1835","1549.65308533","1.18413599623"
"SL2.50ch00:17755341-17755705","140","17755341","17755705","364","1549.65308533","0.234891282085"
"SL2.50ch00:17769299-17772197","1135","17769299","17772197","2898","1549.65308533","1.8700959766"
"SL2.50ch00:17769396-17771586","933","17769396","17771586","2190","1549.65308533","1.41321952683"
"SL2.50ch00:17839979-17843143","16335","17839979","17843143","3164","1549.65308533","2.04174729813"
"SL2.50ch00:17840185-17843265","16356","17840185","17843265","3080","1549.65308533","1.98754161765"
"SL2.50ch00:17905540-17907366","341","17905540","17907366","1826","1549.65308533","1.17832824475"
"SL2.50ch00:18009693-18011842","512","18009693","18011842","2149","1549.65308533","1.38676199231"
"SL2.50ch00:18038596-18041304","691","18038596","18041304","2708","1549.65308533","1.7474878898"
"SL2.50ch00:18038671-18039272","134","18038671","18039272","601","1549.65308533","0.387828737729"
"SL2.50ch00:18040204-18040706","182","18040204","18040706","502","1549.65308533","0.323943471448"
"SL2.50ch00:18047321-18054356","4654","18047321","18054356","7035","1549.65308533","4.53972574031"
"SL2.50ch00:18050052-18052395","3281","18050052","18052395","2343","1549.65308533","1.511951302"
"SL2.50ch00:18116521-18121684","2406","18116521","18121684","5163","1549.65308533","3.33171343244"
"SL2.50ch00:18116542-18121670","2406","18116542","18121670","5128","1549.65308533","3.30912773224"
"SL2.50ch00:18176789-18177963","660","18176789","18177963","1174","1549.65308533","0.757588915298"
"SL2.50ch00:18193929-18194470","112","18193929","18194470","541","1549.65308533","0.349110394528"
"SL2.50ch00:18228178-18230848","1201","18228178","18230848","2670","1549.65308533","1.72296627244"
"SL2.50ch00:18228196-18232576","1519","18228196","18232576","4380","1549.65308533","2.82643905367"
"SL2.50ch00:18254468-18256503","561","18254468","18256503","2035","1549.65308533","1.31319714023"
"SL2.50ch00:1830139-1830734","108","1830139","1830734","595","1549.65308533","0.383956903409"
"SL2.50ch00:18315727-18318694","8617","18315727","18318694","2967","1549.65308533","1.91462207128"
"SL2.50ch00:18315761-18318804","8614","18315761","18318804","3043","1549.65308533","1.96366530601"
"SL2.50ch00:18352239-18355419","20721","18352239","18355419","3180","1549.65308533","2.05207218965"
"SL2.50ch00:18352250-18355460","20725","18352250","18355460","3210","1549.65308533","2.07143136125"
"SL2.50ch00:1836924-1838142","238","1836924","1838142","1218","1549.65308533","0.785982366978"
"SL2.50ch00:18372252-18372987","158","18372252","18372987","735","1549.65308533","0.474299704211"
"SL2.50ch00:18430111-18430750","106","18430111","18430750","639","1549.65308533","0.41235035509"
"SL2.50ch00:18432591-18433350","343","18432591","18433350","759","1549.65308533","0.489787041491"
"SL2.50ch00:18432644-18433447","354","18432644","18433447","803","1549.65308533","0.518180493172"
"SL2.50ch00:18444937-18445406","167","18444937","18445406","469","1549.65308533","0.302648382687"
"SL2.50ch00:18489940-18491155","776","18489940","18491155","1215","1549.65308533","0.784046449818"
"SL2.50ch00:18489945-18491175","783","18489945","18491175","1230","1549.65308533","0.793726035619"
"SL2.50ch00:18581886-18583006","223","18581886","18583006","1120","1549.65308533","0.722742406417"
"SL2.50ch00:18649038-18651648","920","18649038","18651648","2610","1549.65308533","1.68424792924"
"SL2.50ch00:18649224-18651389","857","18649224","18651389","2165","1549.65308533","1.39708688383"
"SL2.50ch00:18776662-18779508","1657","18776662","18779508","2846","1549.65308533","1.83654007916"
"SL2.50ch00:18776724-18779463","1653","18776724","18779463","2739","1549.65308533","1.76749236712"
"SL2.50ch00:1883241-1883777","141","1883241","1883777","536","1549.65308533","0.345883865928"
"SL2.50ch00:18865873-18866449","146","18865873","18866449","576","1549.65308533","0.371696094729"
"SL2.50ch00:18867384-18867973","136","18867384","18867973","589","1549.65308533","0.380085069089"
"SL2.50ch00:18909152-18911104","500","18909152","18911104","1952","1549.65308533","1.25963676547"
"SL2.50ch00:19091706-19094308","1794","19091706","19094308","2602","1549.65308533","1.67908548348"
"SL2.50ch00:19091722-19094319","1794","19091722","19094319","2597","1549.65308533","1.67585895488"
"SL2.50ch00:19120479-19124133","13805","19120479","19124133","3654","1549.65308533","2.35794710093"
"SL2.50ch00:19120635-19123276","13674","19120635","19123276","2641","1549.65308533","1.70425240656"
"SL2.50ch00:19155843-19156218","84","19155843","19156218","375","1549.65308533","0.241989645006"
"SL2.50ch00:19180993-19181586","131","19180993","19181586","593","1549.65308533","0.382666291969"
"SL2.50ch00:19308008-19310424","1116","19308008","19310424","2416","1549.65308533","1.55905861956"
"SL2.50ch00:19308172-19311107","1185","19308172","19311107","2935","1549.65308533","1.89397228824"
"SL2.50ch00:19321130-19323261","478","19321130","19323261","2131","1549.65308533","1.37514648935"
"SL2.50ch00:19374797-19377125","917","19374797","19377125","2328","1549.65308533","1.5022717162"
"SL2.50ch00:19374958-19375968","479","19374958","19375968","1010","1549.65308533","0.651758777215"
"SL2.50ch00:19376532-19377030","238","19376532","19377030","498","1549.65308533","0.321362248567"
"SL2.50ch00:19408083-19410487","1282","19408083","19410487","2404","1549.65308533","1.55131495092"
"SL2.50ch00:19408084-19410495","1282","19408084","19410495","2411","1549.65308533","1.55583209096"
"SL2.50ch00:19415732-19418158","739","19415732","19418158","2426","1549.65308533","1.56551167676"
"SL2.50ch00:19612971-19615925","38263","19612971","19615925","2954","1549.65308533","1.90623309692"
"SL2.50ch00:19613012-19615919","38261","19613012","19615919","2907","1549.65308533","1.87590372808"
"SL2.50ch00:19656380-19656968","1921","19656380","19656968","588","1549.65308533","0.379439763369"
"SL2.50ch00:19703176-19705907","3272","19703176","19705907","2731","1549.65308533","1.76232992136"
"SL2.50ch00:19703245-19705875","3251","19703245","19705875","2630","1549.65308533","1.69715404364"
"SL2.50ch00:19810028-19812401","1721","19810028","19812401","2373","1549.65308533","1.5313104736"
"SL2.50ch00:19810081-19812489","1722","19810081","19812489","2408","1549.65308533","1.5538961738"
"SL2.50ch00:19862505-19864234","329","19862505","19864234","1729","1549.65308533","1.11573358991"
"SL2.50ch00:19915870-19918441","11403","19915870","19918441","2571","1549.65308533","1.65908100616"
"SL2.50ch00:19916074-19918377","11403","19916074","19918377","2303","1549.65308533","1.48613907319"
"SL2.50ch00:19964828-19967225","6707","19964828","19967225","2397","1549.65308533","1.54679781088"
"SL2.50ch00:19964876-19967243","6707","19964876","19967243","2367","1549.65308533","1.52743863928"
"SL2.50ch00:19980390-19980765","96","19980390","19980765","375","1549.65308533","0.241989645006"
"SL2.50ch00:19987604-19989029","586","19987604","19989029","1425","1549.65308533","0.919560651021"
"SL2.50ch00:19987750-19988835","544","19987750","19988835","1085","1549.65308533","0.700156706216"
"SL2.50ch00:20025559-20028106","1090","20025559","20028106","2547","1549.65308533","1.64359366888"
"SL2.50ch00:20025792-20028023","1083","20025792","20028023","2231","1549.65308533","1.43967706135"
"SL2.50ch00:20067026-20067390","161","20067026","20067390","364","1549.65308533","0.234891282085"
"SL2.50ch00:20087085-20087673","131","20087085","20087673","588","1549.65308533","0.379439763369"
"SL2.50ch00:20105409-20107747","724","20105409","20107747","2338","1549.65308533","1.5087247734"
"SL2.50ch00:20105570-20106896","475","20105570","20106896","1326","1549.65308533","0.85567538474"
"SL2.50ch00:20154072-20154447","80","20154072","20154447","375","1549.65308533","0.241989645006"
"SL2.50ch00:20160619-20163370","4766","20160619","20163370","2751","1549.65308533","1.77523603576"
"SL2.50ch00:20160753-20164220","4906","20160753","20164220","3467","1549.65308533","2.23727493129"
"SL2.50ch00:20274369-20275198","168","20274369","20275198","829","1549.65308533","0.534958441892"
"SL2.50ch00:20292054-20292795","621","20292054","20292795","741","1549.65308533","0.478171538531"
"SL2.50ch00:20292136-20292792","604","20292136","20292792","656","1549.65308533","0.42332055233"
"SL2.50ch00:20365242-20366498","583","20365242","20366498","1256","1549.65308533","0.810503984339"
"SL2.50ch00:20365252-20366596","583","20365252","20366596","1344","1549.65308533","0.8672908877"
"SL2.50ch00:20415259-20416048","154","20415259","20416048","789","1549.65308533","0.509146213092"
"SL2.50ch00:20426279-20428437","600","20426279","20428437","2158","1549.65308533","1.39256974379"
"SL2.50ch00:20470713-20471374","228","20470713","20471374","661","1549.65308533","0.42654708093"
"SL2.50ch00:20491724-20493665","1014","20491724","20493665","1941","1549.65308533","1.25253840255"
"SL2.50ch00:20491822-20493794","1016","20491822","20493794","1972","1549.65308533","1.27254287987"
"SL2.50ch00:20541255-20542338","244","20541255","20542338","1083","1549.65308533","0.698866094776"
"SL2.50ch00:20624146-20626211","444","20624146","20626211","2065","1549.65308533","1.33255631183"
"SL2.50ch00:20749100-20749464","2388","20749100","20749464","364","1549.65308533","0.234891282085"
"SL2.50ch00:20777928-20780073","749","20777928","20780073","2145","1549.65308533","1.38418076943"
"SL2.50ch00:20778343-20778895","273","20778343","20778895","552","1549.65308533","0.356208757448"
"SL2.50ch00:20831518-20832247","1344","20831518","20832247","729","1549.65308533","0.470427869891"
"SL2.50ch00:20864130-20866078","567","20864130","20866078","1948","1549.65308533","1.25705554259"
"SL2.50ch00:20865374-20866096","160","20865374","20866096","722","1549.65308533","0.465910729851"
"SL2.50ch00:20877605-20879666","469","20877605","20879666","2061","1549.65308533","1.32997508895"
"SL2.50ch00:20881998-20884358","4085","20881998","20884358","2360","1549.65308533","1.52292149924"
"SL2.50ch00:20882046-20884435","4086","20882046","20884435","2389","1549.65308533","1.54163536512"
"SL2.50ch00:20907076-20907657","228","20907076","20907657","581","1549.65308533","0.374922623329"
"SL2.50ch00:20997901-20998276","77","20997901","20998276","375","1549.65308533","0.241989645006"
"SL2.50ch00:21017370-21018552","289","21017370","21018552","1182","1549.65308533","0.762751361058"
"SL2.50ch00:21068452-21068922","105","21068452","21068922","470","1549.65308533","0.303293688407"
"SL2.50ch00:21112860-21114851","512","21112860","21114851","1991","1549.65308533","1.28480368855"
"SL2.50ch00:21113517-21114250","271","21113517","21114250","733","1549.65308533","0.473009092771"
"SL2.50ch00:21135383-21137048","374","21135383","21137048","1665","1549.65308533","1.07443402383"
"SL2.50ch00:21140175-21141383","264","21140175","21141383","1208","1549.65308533","0.779529309778"
"SL2.50ch00:21146047-21148307","5112","21146047","21148307","2260","1549.65308533","1.45839092723"
"SL2.50ch00:21146236-21148369","5101","21146236","21148369","2133","1549.65308533","1.37643710079"
"SL2.50ch00:2114778-2115273","104","2114778","2115273","495","1549.65308533","0.319426331407"
"SL2.50ch00:21175156-21176844","507","21175156","21176844","1688","1549.65308533","1.08927605539"
"SL2.50ch00:21176067-21176655","224","21176067","21176655","588","1549.65308533","0.379439763369"
"SL2.50ch00:21199214-21203355","1952","21199214","21203355","4141","1549.65308533","2.67221098658"
"SL2.50ch00:21199214-21203993","2070","21199214","21203993","4779","1549.65308533","3.08391603595"
"SL2.50ch00:21260908-21263725","697","21260908","21263725","2817","1549.65308533","1.81782621328"
"SL2.50ch00:21271895-21273771","492","21271895","21273771","1876","1549.65308533","1.21059353075"
"SL2.50ch00:21271907-21273675","473","21271907","21273675","1768","1549.65308533","1.14090051299"
"SL2.50ch00:21287473-21289324","406","21287473","21289324","1851","1549.65308533","1.19446088775"
"SL2.50ch00:21287671-21289263","386","21287671","21289263","1592","1549.65308533","1.02732670626"
"SL2.50ch00:21346188-21348062","382","21346188","21348062","1874","1549.65308533","1.20930291931"
"SL2.50ch00:21458881-21460878","2129","21458881","21460878","1997","1549.65308533","1.28867552287"
"SL2.50ch00:21458932-21459892","1632","21458932","21459892","960","1549.65308533","0.619493491214"
"SL2.50ch00:2151051-2151630","324","2151051","2151630","579","1549.65308533","0.373632011889"
"SL2.50ch00:2151057-2151741","334","2151057","2151741","684","1549.65308533","0.44138911249"
"SL2.50ch00:21534349-21536483","9849","21534349","21536483","2134","1549.65308533","1.37708240651"
"SL2.50ch00:21534363-21537085","9940","21534363","21537085","2722","1549.65308533","1.75652216988"
"SL2.50ch00:21544992-21546921","940","21544992","21546921","1929","1549.65308533","1.24479473391"
"SL2.50ch00:21545035-21546976","947","21545035","21546976","1941","1549.65308533","1.25253840255"
"SL2.50ch00:2157345-2158512","285","2157345","2158512","1167","1549.65308533","0.753071775258"
"SL2.50ch00:21609018-21609938","2552","21609018","21609938","920","1549.65308533","0.593681262414"
"SL2.50ch00:21609033-21609920","2549","21609033","21609920","887","1549.65308533","0.572386173653"
"SL2.50ch00:21610783-21611254","361","21610783","21611254","471","1549.65308533","0.303938994127"
"SL2.50ch00:2165440-2166114","192","2165440","2166114","674","1549.65308533","0.43493605529"
"SL2.50ch00:21668893-21669745","193","21668893","21669745","852","1549.65308533","0.549800473453"
"SL2.50ch00:21691897-21694243","13118","21691897","21694243","2346","1549.65308533","1.51388721916"
"SL2.50ch00:21692070-21694331","13114","21692070","21694331","2261","1549.65308533","1.45903623295"
"SL2.50ch00:21703372-21704047","219","21703372","21704047","675","1549.65308533","0.43558136101"
"SL2.50ch00:21747207-21748979","615","21747207","21748979","1772","1549.65308533","1.14348173587"
"SL2.50ch00:21747707-21748658","363","21747707","21748658","951","1549.65308533","0.613685739734"
"SL2.50ch00:21751352-21752240","211","21751352","21752240","888","1549.65308533","0.573031479373"
"SL2.50ch00:21751623-21752179","140","21751623","21752179","556","1549.65308533","0.358789980328"
"SL2.50ch00:21763905-21765944","809","21763905","21765944","2039","1549.65308533","1.31577836311"
"SL2.50ch00:21763957-21765853","809","21763957","21765853","1896","1549.65308533","1.22349964515"
"SL2.50ch00:21774521-21776451","670","21774521","21776451","1930","1549.65308533","1.24544003963"
"SL2.50ch00:21774689-21775210","277","21774689","21775210","521","1549.65308533","0.336204280128"
"SL2.50ch00:2348499-2348989","127","2348499","2348989","490","1549.65308533","0.316199802807"
"SL2.50ch00:2742385-2742760","85","2742385","2742760","375","1549.65308533","0.241989645006"
"SL2.50ch00:2919366-2920938","492","2919366","2920938","1572","1549.65308533","1.01442059186"
"SL2.50ch00:3916706-3917483","288","3916706","3917483","777","1549.65308533","0.501402544452"
"SL2.50ch00:4157735-4160963","6964","4157735","4160963","3228","1549.65308533","2.08304686421"
"SL2.50ch00:4157890-4160833","6964","4157890","4160833","2943","1549.65308533","1.899134734"
"SL2.50ch00:4161654-4164650","2545","4161654","4164650","2996","1549.65308533","1.93333593717"
"SL2.50ch00:4161731-4164605","2511","4161731","4164605","2874","1549.65308533","1.85460863932"
"SL2.50ch00:4167825-4177058","6507","4167825","4177058","9233","1549.65308533","5.9581077129"
"SL2.50ch00:4167826-4177090","6507","4167826","4177090","9264","1549.65308533","5.97811219022"
"SL2.50ch00:4276848-4277436","2533","4276848","4277436","588","1549.65308533","0.379439763369"
"SL2.50ch00:4773375-4774141","158","4773375","4774141","766","1549.65308533","0.494304181532"
"SL2.50ch00:5602034-5602409","74","5602034","5602409","375","1549.65308533","0.241989645006"
"SL2.50ch00:5616669-5620459","967","5616669","5620459","3790","1549.65308533","2.44570867886"
"SL2.50ch00:5618689-5619148","90","5618689","5619148","459","1549.65308533","0.296195325487"
"SL2.50ch00:5642165-5643281","276","5642165","5643281","1116","1549.65308533","0.720161183537"
"SL2.50ch00:5642739-5643198","167","5642739","5643198","459","1549.65308533","0.296195325487"
"SL2.50ch00:5655887-5656624","1089","5655887","5656624","737","1549.65308533","0.475590315651"
"SL2.50ch00:5659910-5662237","451","5659910","5662237","2327","1549.65308533","1.50162641048"
"SL2.50ch00:5662920-5664620","380","5662920","5664620","1700","1549.65308533","1.09701972403"
"SL2.50ch00:5670439-5671502","481","5670439","5671502","1063","1549.65308533","0.685959980376"
"SL2.50ch00:5688585-5688960","81","5688585","5688960","375","1549.65308533","0.241989645006"
"SL2.50ch00:5695677-5696236","109","5695677","5696236","559","1549.65308533","0.360725897488"
"SL2.50ch00:5702468-5702843","67","5702468","5702843","375","1549.65308533","0.241989645006"
"SL2.50ch00:5732107-5733246","221","5732107","5733246","1139","1549.65308533","0.735003215097"
"SL2.50ch00:6142753-6143436","132","6142753","6143436","683","1549.65308533","0.44074380677"
"SL2.50ch00:7117964-7119699","420","7117964","7119699","1735","1549.65308533","1.11960542423"
"SL2.50ch00:7130210-7132708","432","7130210","7132708","2498","1549.65308533","1.6119736886"
"SL2.50ch00:7367820-7369727","1194","7367820","7369727","1907","1549.65308533","1.23059800807"
"SL2.50ch00:7367826-7369734","1194","7367826","7369734","1908","1549.65308533","1.23124331379"
"SL2.50ch00:7371654-7372599","674","7371654","7372599","945","1549.65308533","0.609813905414"
"SL2.50ch00:7371735-7372618","628","7371735","7372618","883","1549.65308533","0.569804950773"
"SL2.50ch00:7382601-7383064","156","7382601","7383064","463","1549.65308533","0.298776548367"
"SL2.50ch00:7397012-7399682","483","7397012","7399682","2670","1549.65308533","1.72296627244"
"SL2.50ch00:7401785-7404433","578","7401785","7404433","2648","1549.65308533","1.7087695466"
"SL2.50ch00:7416709-7434427","8465","7416709","7434427","17718","1549.65308533","11.4335267472"
"SL2.50ch00:7416883-7433567","8236","7416883","7433567","16684","1549.65308533","10.7662806327"
"SL2.50ch00:7439145-7440035","414","7439145","7440035","890","1549.65308533","0.574322090813"
"SL2.50ch00:7439266-7439848","364","7439266","7439848","582","1549.65308533","0.375567929049"
"SL2.50ch00:7445572-7446525","343","7445572","7446525","953","1549.65308533","0.614976351174"
"SL2.50ch00:7445917-7446496","243","7445917","7446496","579","1549.65308533","0.373632011889"
"SL2.50ch00:7446992-7448000","293","7446992","7448000","1008","1549.65308533","0.650468165775"
"SL2.50ch00:7451059-7451912","379","7451059","7451912","853","1549.65308533","0.550445779173"
"SL2.50ch00:7451097-7452137","411","7451097","7452137","1040","1549.65308533","0.671117948816"
"SL2.50ch00:7460262-7460761","143","7460262","7460761","499","1549.65308533","0.322007554288"
"SL2.50ch00:7471507-7476253","1378","7471507","7476253","4746","1549.65308533","3.06262094719"
"SL2.50ch00:7471977-7472932","362","7471977","7472932","955","1549.65308533","0.616266962614"
"SL2.50ch00:7479522-7487142","1774","7479522","7487142","7620","1549.65308533","4.91722958651"
"SL2.50ch00:7483638-7484226","207","7483638","7484226","588","1549.65308533","0.379439763369"
"SL2.50ch00:7490725-7500229","2429","7490725","7500229","9504","1549.65308533","6.13298556302"
"SL2.50ch00:7492484-7493221","222","7492484","7493221","737","1549.65308533","0.475590315651"
"SL2.50ch00:7499061-7499982","258","7499061","7499982","921","1549.65308533","0.594326568134"
"SL2.50ch00:7500620-7506914","1519","7500620","7506914","6294","1549.65308533","4.06155420177"
"SL2.50ch00:7502390-7503573","323","7502390","7503573","1183","1549.65308533","0.763396666778"
"SL2.50ch00:7509669-7510801","189","7509669","7510801","1132","1549.65308533","0.730486075057"
"SL2.50ch00:7541050-7541518","102","7541050","7541518","468","1549.65308533","0.302003076967"
"SL2.50ch00:7579544-7579908","429","7579544","7579908","364","1549.65308533","0.234891282085"
"SL2.50ch00:7590284-7591139","158","7590284","7591139","855","1549.65308533","0.551736390613"
"SL2.50ch00:7606252-7607258","206","7606252","7607258","1006","1549.65308533","0.649177554335"
"SL2.50ch00:7616018-7616990","184","7616018","7616990","972","1549.65308533","0.627237159855"
"SL2.50ch00:7620526-7621681","204","7620526","7621681","1155","1549.65308533","0.745328106617"
"SL2.50ch00:7656885-7660433","825","7656885","7660433","3548","1549.65308533","2.28954469461"
"SL2.50ch00:7661081-7669795","2237","7661081","7669795","8714","1549.65308533","5.62319404421"
"SL2.50ch00:7672626-7673795","224","7672626","7673795","1169","1549.65308533","0.754362386698"
"SL2.50ch00:7691533-7692347","184","7691533","7692347","814","1549.65308533","0.525278856092"
"SL2.50ch00:7713420-7713893","104","7713420","7713893","473","1549.65308533","0.305229605567"
"SL2.50ch00:7719006-7719514","109","7719006","7719514","508","1549.65308533","0.327815305768"
"SL2.50ch00:7721239-7722046","333","7721239","7722046","807","1549.65308533","0.520761716052"
"SL2.50ch00:7721497-7721861","265","7721497","7721861","364","1549.65308533","0.234891282085"
"SL2.50ch00:7730321-7731140","178","7730321","7731140","819","1549.65308533","0.528505384692"
"SL2.50ch00:7739489-7740197","147","7739489","7740197","708","1549.65308533","0.456876449771"
"SL2.50ch00:7754040-7755275","225","7754040","7755275","1235","1549.65308533","0.796952564219"
"SL2.50ch00:7756901-7757369","89","7756901","7757369","468","1549.65308533","0.302003076967"
"SL2.50ch00:7766690-7769066","405","7766690","7769066","2376","1549.65308533","1.53324639076"
"SL2.50ch00:7785059-7785575","114","7785059","7785575","516","1549.65308533","0.332977751528"
"SL2.50ch00:7799454-7806901","3161","7799454","7806901","7447","1549.65308533","4.80559169695"
"SL2.50ch00:7801224-7805746","2004","7801224","7805746","4522","1549.65308533","2.91807246591"
"SL2.50ch00:7809268-7810269","284","7809268","7810269","1001","1549.65308533","0.645951025735"
"SL2.50ch00:7814168-7815414","353","7814168","7815414","1246","1549.65308533","0.804050927139"
"SL2.50ch00:7818064-7820606","1117","7818064","7820606","2542","1549.65308533","1.64036714028"
"SL2.50ch00:7818076-7820680","1122","7818076","7820680","2604","1549.65308533","1.68037609492"
"SL2.50ch00:7828668-7844046","4278","7828668","7844046","15378","1549.65308533","9.92351136239"
"SL2.50ch00:7828684-7829536","265","7828684","7829536","852","1549.65308533","0.549800473453"
"SL2.50ch00:7831231-7832155","182","7831231","7832155","924","1549.65308533","0.596262485294"
"SL2.50ch00:7833207-7836827","1162","7833207","7836827","3620","1549.65308533","2.33600670645"
"SL2.50ch00:7844567-7847469","787","7844567","7847469","2902","1549.65308533","1.87267719948"
"SL2.50ch00:7844631-7844995","107","7844631","7844995","364","1549.65308533","0.234891282085"
"SL2.50ch00:7846192-7847063","305","7846192","7847063","871","1549.65308533","0.562061282133"
"SL2.50ch00:7851428-7857297","1655","7851428","7857297","5869","1549.65308533","3.78729927077"
"SL2.50ch00:7859979-7865114","1387","7859979","7865114","5135","1549.65308533","3.31364487228"
"SL2.50ch00:7861407-7862650","409","7861407","7862650","1243","1549.65308533","0.802115009979"
"SL2.50ch00:7866622-7868388","628","7866622","7868388","1766","1549.65308533","1.13960990155"
"SL2.50ch00:7874772-7875536","159","7874772","7875536","764","1549.65308533","0.493013570091"
"SL2.50ch00:7892286-7892650","80","7892286","7892650","364","1549.65308533","0.234891282085"
"SL2.50ch00:7905436-7905913","102","7905436","7905913","477","1549.65308533","0.307810828447"
"SL2.50ch00:7908163-7909949","442","7908163","7909949","1786","1549.65308533","1.15251601595"
"SL2.50ch00:7908228-7910034","446","7908228","7910034","1806","1549.65308533","1.16542213035"
"SL2.50ch00:7919055-7921461","502","7919055","7921461","2406","1549.65308533","1.55260556236"
"SL2.50ch00:7929751-7930486","234","7929751","7930486","735","1549.65308533","0.474299704211"
"SL2.50ch00:7954819-7956468","314","7954819","7956468","1649","1549.65308533","1.0641091323"
"SL2.50ch00:7957368-7958191","177","7957368","7958191","823","1549.65308533","0.531086607572"
"SL2.50ch00:7973260-7973939","203","7973260","7973939","679","1549.65308533","0.43816258389"
"SL2.50ch00:7981859-7984915","911","7981859","7984915","3056","1549.65308533","1.97205428037"
"SL2.50ch00:7984263-7984851","135","7984263","7984851","588","1549.65308533","0.379439763369"
"SL2.50ch00:7992271-7995759","1518","7992271","7995759","3488","1549.65308533","2.25082635141"
"SL2.50ch00:7992331-7995875","1510","7992331","7995875","3544","1549.65308533","2.28696347173"
"SL2.50ch00:7996996-7999651","1045","7996996","7999651","2655","1549.65308533","1.71328668664"
"SL2.50ch00:7997016-7999653","1045","7997016","7999653","2637","1549.65308533","1.70167118368"
"SL2.50ch00:8003886-8008250","1503","8003886","8008250","4364","1549.65308533","2.81611416215"
"SL2.50ch00:8004099-8005628","607","8004099","8005628","1529","1549.65308533","0.986672445903"
"SL2.50ch00:8211804-8213494","352","8211804","8213494","1690","1549.65308533","1.09056666683"
"SL2.50ch00:8212688-8213334","142","8212688","8213334","646","1549.65308533","0.41686749513"
"SL2.50ch00:8214780-8216483","358","8214780","8216483","1703","1549.65308533","1.09895564119"
"SL2.50ch00:8217389-8218215","246","8217389","8218215","826","1549.65308533","0.533022524732"
"SL2.50ch00:8220196-8221074","199","8220196","8221074","878","1549.65308533","0.566578422173"
"SL2.50ch00:8226789-8228144","367","8226789","8228144","1355","1549.65308533","0.87438925062"
"SL2.50ch00:8233982-8234357","66","8233982","8234357","375","1549.65308533","0.241989645006"
"SL2.50ch00:8239256-8240215","416","8239256","8240215","959","1549.65308533","0.618848185494"
"SL2.50ch00:8239332-8240163","389","8239332","8240163","831","1549.65308533","0.536249053333"
"SL2.50ch00:8248125-8248879","160","8248125","8248879","754","1549.65308533","0.486560512891"
"SL2.50ch00:8250390-8251656","276","8250390","8251656","1266","1549.65308533","0.816957041539"
"SL2.50ch00:8261046-8261677","139","8261046","8261677","631","1549.65308533","0.407187909329"
"SL2.50ch00:8266511-8267478","180","8266511","8267478","967","1549.65308533","0.624010631255"
"SL2.50ch00:8273128-8273920","274","8273128","8273920","792","1549.65308533","0.511082130252"
"SL2.50ch00:8277960-8278553","179","8277960","8278553","593","1549.65308533","0.382666291969"
"SL2.50ch00:8286018-8286917","171","8286018","8286917","899","1549.65308533","0.580129842294"
"SL2.50ch00:8289257-8289934","222","8289257","8289934","677","1549.65308533","0.43687197245"
"SL2.50ch00:8298046-8298525","119","8298046","8298525","479","1549.65308533","0.309101439887"
"SL2.50ch00:8299213-8299793","112","8299213","8299793","580","1549.65308533","0.374277317609"
"SL2.50ch00:8301750-8302320","121","8301750","8302320","570","1549.65308533","0.367824260409"
"SL2.50ch00:8308284-8309413","391","8308284","8309413","1129","1549.65308533","0.728550157897"
"SL2.50ch00:8308778-8309366","283","8308778","8309366","588","1549.65308533","0.379439763369"
"SL2.50ch00:8331144-8331519","71","8331144","8331519","375","1549.65308533","0.241989645006"
"SL2.50ch00:8336537-8338456","425","8336537","8338456","1919","1549.65308533","1.23834167671"
"SL2.50ch00:8352242-8353431","1718","8352242","8353431","1189","1549.65308533","0.767268501098"
"SL2.50ch00:836408-837180","150","836408","837180","772","1549.65308533","0.498176015852"
"SL2.50ch00:8364149-8364752","158","8364149","8364752","603","1549.65308533","0.389119349169"
"SL2.50ch00:8365580-8366246","200","8365580","8366246","666","1549.65308533","0.42977360953"
"SL2.50ch00:8373200-8375003","537","8373200","8375003","1803","1549.65308533","1.16348621319"
"SL2.50ch00:8394451-8395726","326","8394451","8395726","1275","1549.65308533","0.822764793019"
"SL2.50ch00:8397545-8398231","157","8397545","8398231","686","1549.65308533","0.44267972393"
"SL2.50ch00:8404993-8412933","1991","8404993","8412933","7940","1549.65308533","5.12372741692"
"SL2.50ch00:8409387-8412444","930","8409387","8412444","3057","1549.65308533","1.97269958609"
"SL2.50ch00:8607635-8611922","1239","8607635","8611922","4287","1549.65308533","2.7664256217"
"SL2.50ch00:8609608-8611892","852","8609608","8611892","2284","1549.65308533","1.47387826451"
"SL2.50ch00:8613747-8616085","918","8613747","8616085","2338","1549.65308533","1.5087247734"
"SL2.50ch00:8613780-8619919","2051","8613780","8619919","6139","1549.65308533","3.96153181517"
"SL2.50ch00:8616895-8617909","513","8616895","8617909","1014","1549.65308533","0.654340000095"
"SL2.50ch00:8620542-8625317","1684","8620542","8625317","4775","1549.65308533","3.08133481307"
"SL2.50ch00:8620740-8625258","1653","8620740","8625258","4518","1549.65308533","2.91549124303"
"SL2.50ch00:8634193-8644031","3350","8634193","8644031","9838","1549.65308533","6.34851767351"
"SL2.50ch00:8642377-8643969","510","8642377","8643969","1592","1549.65308533","1.02732670626"
"SL2.50ch00:8657336-8658287","214","8657336","8658287","951","1549.65308533","0.613685739734"
"SL2.50ch00:8665300-8665958","176","8665300","8665958","658","1549.65308533","0.42461116377"
"SL2.50ch00:8678644-8679455","141","8678644","8679455","811","1549.65308533","0.523342938932"
"SL2.50ch00:8682052-8684502","489","8682052","8684502","2450","1549.65308533","1.58099901404"
"SL2.50ch00:8697189-8697564","76","8697189","8697564","375","1549.65308533","0.241989645006"
"SL2.50ch00:8718456-8719765","264","8718456","8719765","1309","1549.65308533","0.8447051875"
"SL2.50ch00:8733667-8734441","332","8733667","8734441","774","1549.65308533","0.499466627292"
"SL2.50ch00:8733739-8735102","472","8733739","8735102","1363","1549.65308533","0.879551696381"
"SL2.50ch00:8949347-8949856","122","8949347","8949856","509","1549.65308533","0.328460611488"
"SL2.50ch00:8965032-8967276","429","8965032","8967276","2244","1549.65308533","1.44806603571"
"SL2.50ch00:8968460-8969183","157","8968460","8969183","723","1549.65308533","0.466556035571"
"SL2.50ch00:8976506-8978957","614","8976506","8978957","2451","1549.65308533","1.58164431976"
"SL2.50ch00:8987330-8987898","139","8987330","8987898","568","1549.65308533","0.366533648969"
"SL2.50ch00:9004251-9006882","466","9004251","9006882","2631","1549.65308533","1.69779934936"
"SL2.50ch00:9007593-9008123","96","9007593","9008123","530","1549.65308533","0.342012031608"
"SL2.50ch00:9015108-9015777","301","9015108","9015777","669","1549.65308533","0.43170952669"
"SL2.50ch00:9015111-9015661","287","9015111","9015661","550","1549.65308533","0.354918146008"
"SL2.50ch00:9017736-9019183","382","9017736","9019183","1447","1549.65308533","0.933757376862"
"SL2.50ch00:9030365-9032047","522","9030365","9032047","1682","1549.65308533","1.08540422107"
"SL2.50ch00:9030368-9031823","464","9030368","9031823","1455","1549.65308533","0.938919822622"
"SL2.50ch00:9035254-9036052","199","9035254","9036052","798","1549.65308533","0.514953964572"
"SL2.50ch00:9035631-9035995","103","9035631","9035995","364","1549.65308533","0.234891282085"
"SL2.50ch00:9039219-9040022","143","9039219","9040022","803","1549.65308533","0.518180493172"
"SL2.50ch00:9046176-9047912","721","9046176","9047912","1736","1549.65308533","1.12025072995"
"SL2.50ch00:9046179-9047845","721","9046179","9047845","1666","1549.65308533","1.07507932955"
"SL2.50ch00:9049665-9051627","1235","9049665","9051627","1962","1549.65308533","1.26608982267"
"SL2.50ch00:9049694-9051665","1235","9049694","9051665","1971","1549.65308533","1.27189757415"
"SL2.50ch00:9055371-9056476","343","9055371","9056476","1105","1549.65308533","0.713062820617"
"SL2.50ch00:9055424-9056401","343","9055424","9056401","977","1549.65308533","0.630463688455"
"SL2.50ch00:9058089-9062385","2640","9058089","9062385","4296","1549.65308533","2.77223337318"
"SL2.50ch00:9058126-9062340","2640","9058126","9062340","4214","1549.65308533","2.71931830414"
"SL2.50ch00:9068612-9071657","1662","9068612","9071657","3045","1549.65308533","1.96495591745"
"SL2.50ch00:9068703-9071632","1659","9068703","9071632","2929","1549.65308533","1.89010045392"
"SL2.50ch00:9078187-9081426","1103","9078187","9081426","3239","1549.65308533","2.09014522713"
"SL2.50ch00:9078347-9081376","1054","9078347","9081376","3029","1549.65308533","1.95463102593"
"SL2.50ch00:9090034-9091297","538","9090034","9091297","1263","1549.65308533","0.815021124379"
"SL2.50ch00:9090083-9091282","533","9090083","9091282","1199","1549.65308533","0.773721558298"
"SL2.50ch00:9096292-9103662","1634","9096292","9103662","7370","1549.65308533","4.75590315651"
"SL2.50ch00:9099747-9101424","432","9099747","9101424","1677","1549.65308533","1.08217769247"
"SL2.50ch00:9109805-9110738","180","9109805","9110738","933","1549.65308533","0.602070236774"
"SL2.50ch00:9239207-9242470","780","9239207","9242470","3263","1549.65308533","2.10563256441"
"SL2.50ch00:9244498-9247637","749","9244498","9247637","3139","1549.65308533","2.02561465513"
"SL2.50ch00:9246260-9247191","215","9246260","9247191","931","1549.65308533","0.600779625334"
"SL2.50ch00:9254982-9256545","508","9254982","9256545","1563","1549.65308533","1.00861284038"
"SL2.50ch00:9255012-9256551","508","9255012","9256551","1539","1549.65308533","0.993125503103"
"SL2.50ch00:9259001-9260385","359","9259001","9260385","1384","1549.65308533","0.893103116501"
"SL2.50ch00:9259232-9260213","274","9259232","9260213","981","1549.65308533","0.633044911335"
"SL2.50ch00:9261165-9262649","397","9261165","9262649","1484","1549.65308533","0.957633688502"
"SL2.50ch00:9271885-9272489","118","9271885","9272489","604","1549.65308533","0.389764654889"
"SL2.50ch00:9278565-9279331","148","9278565","9279331","766","1549.65308533","0.494304181532"
"SL2.50ch00:9302677-9303951","229","9302677","9303951","1274","1549.65308533","0.822119487299"
"SL2.50ch00:930971-931346","89","930971","931346","375","1549.65308533","0.241989645006"
"SL2.50ch00:9316406-9316781","80","9316406","9316781","375","1549.65308533","0.241989645006"
"SL2.50ch00:9324487-9325533","187","9324487","9325533","1046","1549.65308533","0.674989783136"
"SL2.50ch00:9326434-9326903","102","9326434","9326903","469","1549.65308533","0.302648382687"
"SL2.50ch00:9337835-9338504","154","9337835","9338504","669","1549.65308533","0.43170952669"
"SL2.50ch00:9342636-9344852","537","9342636","9344852","2216","1549.65308533","1.42999747555"
"SL2.50ch00:9351642-9353215","308","9351642","9353215","1573","1549.65308533","1.01506589758"
"SL2.50ch00:9366834-9367623","241","9366834","9367623","789","1549.65308533","0.509146213092"
"SL2.50ch00:9369235-9370606","314","9369235","9370606","1371","1549.65308533","0.884714142141"
"SL2.50ch00:9405612-9406254","138","9405612","9406254","642","1549.65308533","0.41428627225"
"SL2.50ch00:9408014-9410178","551","9408014","9410178","2164","1549.65308533","1.39644157811"
"SL2.50ch00:9409232-9409736","123","9409232","9409736","504","1549.65308533","0.325234082888"
"SL2.50ch00:9413239-9417348","1202","9413239","9417348","4109","1549.65308533","2.65156120354"
"SL2.50ch00:9418288-9423072","1254","9418288","9423072","4784","1549.65308533","3.08714256455"
"SL2.50ch00:9422382-9422746","113","9422382","9422746","364","1549.65308533","0.234891282085"
"SL2.50ch00:9423714-9427876","1582","9423714","9427876","4162","1549.65308533","2.6857624067"
"SL2.50ch00:9426413-9427284","611","9426413","9427284","871","1549.65308533","0.562061282133"
"SL2.50ch00:9432720-9435921","826","9432720","9435921","3201","1549.65308533","2.06562360977"
"SL2.50ch00:9434865-9435427","196","9434865","9435427","562","1549.65308533","0.362661814648"
"SL2.50ch00:9441532-9442005","152","9441532","9442005","473","1549.65308533","0.305229605567"
"SL2.50ch00:9450055-9458167","2175","9450055","9458167","8112","1549.65308533","5.23472000076"
"SL2.50ch00:9450153-9450517","86","9450153","9450517","364","1549.65308533","0.234891282085"
"SL2.50ch00:9451563-9457228","1592","9451563","9457228","5665","1549.65308533","3.65565690389"
"SL2.50ch00:9459682-9461136","286","9459682","9461136","1454","1549.65308533","0.938274516902"
"SL2.50ch00:9469054-9469642","367","9469054","9469642","588","1549.65308533","0.379439763369"
"SL2.50ch00:9469103-9469726","367","9469103","9469726","623","1549.65308533","0.402025463569"
"SL2.50ch00:9472005-9474716","769","9472005","9474716","2711","1549.65308533","1.74942380696"
"SL2.50ch00:9472235-9473849","446","9472235","9473849","1614","1549.65308533","1.0415234321"
"SL2.50ch00:9477989-9485776","2755","9477989","9485776","7787","1549.65308533","5.02499564176"
"SL2.50ch00:9499005-9501565","575","9499005","9501565","2560","1549.65308533","1.65198264324"
"SL2.50ch00:9563160-9565723","532","9563160","9565723","2563","1549.65308533","1.6539185604"
"SL2.50ch00:9570571-9571357","260","9570571","9571357","786","1549.65308533","0.507210295932"
"SL2.50ch00:9571890-9574712","657","9571890","9574712","2822","1549.65308533","1.82105274188"
"SL2.50ch00:9571973-9572884","270","9571973","9572884","911","1549.65308533","0.587873510934"
"SL2.50ch00:9574071-9574659","205","9574071","9574659","588","1549.65308533","0.379439763369"
"SL2.50ch00:9588291-9589618","473","9588291","9589618","1327","1549.65308533","0.85632069046"
"SL2.50ch00:9588353-9589238","381","9588353","9589238","885","1549.65308533","0.571095562213"
"SL2.50ch00:9598709-9599994","284","9598709","9599994","1285","1549.65308533","0.829217850219"
"SL2.50ch00:9599541-9599905","130","9599541","9599905","364","1549.65308533","0.234891282085"
"SL2.50ch00:9600734-9601870","252","9600734","9601870","1136","1549.65308533","0.733067297937"
"SL2.50ch00:9607833-9610848","692","9607833","9610848","3015","1549.65308533","1.94559674585"
"SL2.50ch00:9619197-9619572","93","9619197","9619572","375","1549.65308533","0.241989645006"
"SL2.50ch00:9621331-9625049","1345","9621331","9625049","3718","1549.65308533","2.39924666702"
"SL2.50ch00:9622472-9625046","1059","9622472","9625046","2574","1549.65308533","1.66101692332"
"SL2.50ch00:9626040-9626838","276","9626040","9626838","798","1549.65308533","0.514953964572"
"SL2.50ch00:9626103-9628743","720","9626103","9628743","2640","1549.65308533","1.70360710084"
"SL2.50ch00:9627511-9628195","270","9627511","9628195","684","1549.65308533","0.44138911249"
"SL2.50ch00:9629777-9630365","173","9629777","9630365","588","1549.65308533","0.379439763369"
"SL2.50ch00:9629835-9630333","173","9629835","9630333","498","1549.65308533","0.321362248567"
"SL2.50ch00:9643147-9643651","130","9643147","9643651","504","1549.65308533","0.325234082888"
"SL2.50ch00:9715123-9716924","312","9715123","9716924","1801","1549.65308533","1.16219560175"
"SL2.50ch00:9722305-9729386","2644","9722305","9729386","7081","1549.65308533","4.56940980343"
"SL2.50ch00:9722319-9729229","2631","9722319","9729229","6910","1549.65308533","4.4590625253"
"SL2.50ch00:9745483-9746285","144","9745483","9746285","802","1549.65308533","0.517535187452"
"SL2.50ch00:9753018-9755103","611","9753018","9755103","2085","1549.65308533","1.34546242623"
"SL2.50ch00:9757217-9757907","250","9757217","9757907","690","1549.65308533","0.44526094681"
"SL2.50ch00:9757267-9760747","866","9757267","9760747","3480","1549.65308533","2.24566390565"
"SL2.50ch00:9771877-9772241","91","9771877","9772241","364","1549.65308533","0.234891282085"
"SL2.50ch00:9771946-9776178","1970","9771946","9776178","4232","1549.65308533","2.7309338071"
"SL2.50ch00:9773328-9776295","1739","9773328","9776295","2967","1549.65308533","1.91462207128"
"SL2.50ch00:9781174-9782758","363","9781174","9782758","1584","1549.65308533","1.0221642605"
"SL2.50ch00:9781870-9782364","95","9781870","9782364","494","1549.65308533","0.318781025687"
"SL2.50ch00:9784466-9784841","83","9784466","9784841","375","1549.65308533","0.241989645006"
"SL2.50ch00:9788268-9788856","285","9788268","9788856","588","1549.65308533","0.379439763369"
"SL2.50ch00:9788349-9788819","268","9788349","9788819","470","1549.65308533","0.303293688407"
"SL2.50ch00:9790507-9790871","111","9790507","9790871","364","1549.65308533","0.234891282085"
"SL2.50ch00:9790540-9791015","138","9790540","9791015","475","1549.65308533","0.306520217007"
"SL2.50ch00:9794301-9796006","3193","9794301","9796006","1705","1549.65308533","1.10024625263"
"SL2.50ch00:9794425-9795841","3164","9794425","9795841","1416","1549.65308533","0.913752899541"
"SL2.50ch00:9801994-9804879","793","9801994","9804879","2885","1549.65308533","1.86170700224"
"SL2.50ch00:9813087-9815757","619","9813087","9815757","2670","1549.65308533","1.72296627244"
"SL2.50ch00:9816688-9818251","255","9816688","9818251","1563","1549.65308533","1.00861284038"
"SL2.50ch00:9833349-9834217","8535","9833349","9834217","868","1549.65308533","0.560125364973"
"SL2.50ch00:9834858-9836657","921","9834858","9836657","1799","1549.65308533","1.16090499031"
"SL2.50ch00:9834961-9836717","902","9834961","9836717","1756","1549.65308533","1.13315684435"
"SL2.50ch00:9837927-9838984","411","9837927","9838984","1057","1549.65308533","0.682088146056"
"SL2.50ch00:9837984-9838918","401","9837984","9838918","934","1549.65308533","0.602715542494"
"SL2.50ch00:9862025-9862800","377","9862025","9862800","775","1549.65308533","0.500111933012"
"SL2.50ch00:9863958-9864322","220","9863958","9864322","364","1549.65308533","0.234891282085"
"SL2.50ch00:9864924-9865938","291","9864924","9865938","1014","1549.65308533","0.654340000095"
"SL2.50ch00:9865348-9866082","182","9865348","9866082","734","1549.65308533","0.473654398491"
"SL2.50ch00:9880979-9881624","116","9880979","9881624","645","1549.65308533","0.41622218941"
"SL2.50ch00:9954273-9959938","1460","9954273","9959938","5665","1549.65308533","3.65565690389"
"SL2.50ch00:9963859-9971474","2159","9963859","9971474","7615","1549.65308533","4.91400305791"
"SL2.50ch00:9964837-9965201","172","9964837","9965201","364","1549.65308533","0.234891282085"
"SL2.50ch00:9970188-9971043","269","9970188","9971043","855","1549.65308533","0.551736390613"
"SL2.50ch00:9972925-9982340","2527","9972925","9982340","9415","1549.65308533","6.07555335394"
"SL2.50ch00:9983544-9987670","1248","9983544","9987670","4126","1549.65308533","2.66253140078"
"SL2.50ch00:9990015-9993899","1145","9990015","9993899","3884","1549.65308533","2.50636741654"
"SL2.50ch00:9990885-9993962","866","9990885","9993962","3077","1549.65308533","1.98560570049"
"SL2.50ch00:9995340-9995715","79","9995340","9995715","375","1549.65308533","0.241989645006"
"SL2.50ch00:9998871-10002252","1066","9998871","10002252","3381","1549.65308533","2.18177863937"
"SL2.50ch01:11968793-11969168","82","11968793","11969168","375","1549.65308533","0.241989645006"
"SL2.50ch01:1333557-1333932","105","1333557","1333932","375","1549.65308533","0.241989645006"
"SL2.50ch01:13846783-13847447","187","13846783","13847447","664","1549.65308533","0.42848299809"
"SL2.50ch01:14004258-14005349","199","14004258","14005349","1091","1549.65308533","0.704028540536"
"SL2.50ch01:14800828-14801745","161","14800828","14801745","917","1549.65308533","0.591745345254"
"SL2.50ch01:14955717-14956237","112","14955717","14956237","520","1549.65308533","0.335558974408"
"SL2.50ch01:15605717-15606285","455","15605717","15606285","568","1549.65308533","0.366533648969"
"SL2.50ch01:15796659-15797469","148","15796659","15797469","810","1549.65308533","0.522697633212"
"SL2.50ch01:1839708-1903437","5456285","1839708","1903437","63729","1549.65308533","41.1246882308"
"SL2.50ch01:1839813-1903422","5456284","1839813","1903422","63609","1549.65308533","41.0472515444"
"SL2.50ch01:18586438-18586913","102","18586438","18586913","475","1549.65308533","0.306520217007"
"SL2.50ch01:18783900-18784595","129","18783900","18784595","695","1549.65308533","0.44848747541"
"SL2.50ch01:19716069-19718334","502","19716069","19718334","2265","1549.65308533","1.46161745583"
"SL2.50ch01:20285362-20286126","161","20285362","20286126","764","1549.65308533","0.493013570091"
"SL2.50ch01:20757843-20758451","125","20757843","20758451","608","1549.65308533","0.392345877769"
"SL2.50ch01:21238823-21239198","73","21238823","21239198","375","1549.65308533","0.241989645006"
"SL2.50ch01:21401232-21401847","185","21401232","21401847","615","1549.65308533","0.396863017809"
"SL2.50ch01:21722889-21724486","269","21722889","21724486","1597","1549.65308533","1.03055323486"
"SL2.50ch01:21754167-21754542","81","21754167","21754542","375","1549.65308533","0.241989645006"
"SL2.50ch01:22438896-22440095","228","22438896","22440095","1199","1549.65308533","0.773721558298"
"SL2.50ch01:22596190-22596778","248","22596190","22596778","588","1549.65308533","0.379439763369"
"SL2.50ch01:22848489-22848989","128","22848489","22848989","500","1549.65308533","0.322652860008"
"SL2.50ch01:23606727-23608043","274","23606727","23608043","1316","1549.65308533","0.84922232754"
"SL2.50ch01:23877807-23878380","125","23877807","23878380","573","1549.65308533","0.369760177569"
"SL2.50ch01:23892015-23893041","209","23892015","23893041","1026","1549.65308533","0.662083668735"
"SL2.50ch01:23933813-23939761","5467","23933813","23939761","5948","1549.65308533","3.83827842265"
"SL2.50ch01:23935049-23935413","1212","23935049","23935413","364","1549.65308533","0.234891282085"
"SL2.50ch01:23935811-23938319","3222","23935811","23938319","2508","1549.65308533","1.6184267458"
"SL2.50ch01:23940972-23943685","14814","23940972","23943685","2713","1549.65308533","1.7507144184"
"SL2.50ch01:23941056-23942951","14646","23941056","23942951","1895","1549.65308533","1.22285433943"
"SL2.50ch01:23946758-23950271","743","23946758","23950271","3513","1549.65308533","2.26695899441"
"SL2.50ch01:23951916-23953495","613","23951916","23953495","1579","1549.65308533","1.0189377319"
"SL2.50ch01:23965380-23966367","3936","23965380","23966367","987","1549.65308533","0.636916745655"
"SL2.50ch01:23965591-23966251","3896","23965591","23966251","660","1549.65308533","0.42590177521"
"SL2.50ch01:24228570-24229146","219","24228570","24229146","576","1549.65308533","0.371696094729"
"SL2.50ch01:24228743-24229107","164","24228743","24229107","364","1549.65308533","0.234891282085"
"SL2.50ch01:24233826-24236083","781","24233826","24236083","2257","1549.65308533","1.45645501007"
"SL2.50ch01:24234819-24235903","374","24234819","24235903","1084","1549.65308533","0.699511400496"
"SL2.50ch01:24272581-24273438","173","24272581","24273438","857","1549.65308533","0.553027002053"
"SL2.50ch01:24513175-24513796","116","24513175","24513796","621","1549.65308533","0.400734852129"
"SL2.50ch01:25132342-25132816","109","25132342","25132816","474","1549.65308533","0.305874911287"
"SL2.50ch01:25672237-25672612","70","25672237","25672612","375","1549.65308533","0.241989645006"
"SL2.50ch01:26210581-26211494","207","26210581","26211494","913","1549.65308533","0.589164122374"
"SL2.50ch01:26525089-26525905","167","26525089","26525905","816","1549.65308533","0.526569467532"
"SL2.50ch01:27417603-27417967","1037","27417603","27417967","364","1549.65308533","0.234891282085"
"SL2.50ch01:27884804-27885398","860","27884804","27885398","594","1549.65308533","0.383311597689"
"SL2.50ch01:27918114-27918598","90","27918114","27918598","484","1549.65308533","0.312327968487"
"SL2.50ch01:28028813-28030120","261","28028813","28030120","1307","1549.65308533","0.84341457606"
"SL2.50ch01:28492826-28493201","75","28492826","28493201","375","1549.65308533","0.241989645006"
"SL2.50ch01:28711042-28711946","166","28711042","28711946","904","1549.65308533","0.583356370894"
"SL2.50ch01:30279147-30279522","71","30279147","30279522","375","1549.65308533","0.241989645006"
"SL2.50ch01:30784789-30785164","80","30784789","30785164","375","1549.65308533","0.241989645006"
"SL2.50ch01:30948965-30949340","66","30948965","30949340","375","1549.65308533","0.241989645006"
"SL2.50ch01:31146127-31146596","121","31146127","31146596","469","1549.65308533","0.302648382687"
"SL2.50ch01:31224586-31224961","66","31224586","31224961","375","1549.65308533","0.241989645006"
"SL2.50ch01:32339044-32339563","104","32339044","32339563","519","1549.65308533","0.334913668688"
"SL2.50ch01:36643814-36645093","222","36643814","36645093","1279","1549.65308533","0.825346015899"
"SL2.50ch01:36888348-36897964","4530","36888348","36897964","9616","1549.65308533","6.20525980366"
"SL2.50ch01:36888474-36896791","4326","36888474","36896791","8317","1549.65308533","5.36700767337"
"SL2.50ch01:36942610-36944092","392","36942610","36944092","1482","1549.65308533","0.956343077062"
"SL2.50ch01:36950295-36952356","420","36950295","36952356","2061","1549.65308533","1.32997508895"
"SL2.50ch01:36984575-36988502","2172","36984575","36988502","3927","1549.65308533","2.5341155625"
"SL2.50ch01:36985905-36987635","1771","36985905","36987635","1730","1549.65308533","1.11637889563"
"SL2.50ch01:39121062-39124230","850","39121062","39124230","3168","1549.65308533","2.04432852101"
"SL2.50ch01:39121535-39123216","605","39121535","39123216","1681","1549.65308533","1.08475891535"
"SL2.50ch01:39132048-39134342","1548","39132048","39134342","2294","1549.65308533","1.48033132171"
"SL2.50ch01:39132554-39134128","1418","39132554","39134128","1574","1549.65308533","1.0157112033"
"SL2.50ch01:39135270-39136462","905","39135270","39136462","1192","1549.65308533","0.769204418258"
"SL2.50ch01:39135319-39138487","1429","39135319","39138487","3168","1549.65308533","2.04432852101"
"SL2.50ch01:39137294-39138299","342","39137294","39138299","1005","1549.65308533","0.648532248615"
"SL2.50ch01:39475355-39475730","69","39475355","39475730","375","1549.65308533","0.241989645006"
"SL2.50ch01:39769424-39770132","464","39769424","39770132","708","1549.65308533","0.456876449771"
"SL2.50ch01:39769424-39770267","478","39769424","39770267","843","1549.65308533","0.543992721973"
"SL2.50ch01:40219084-40219617","96","40219084","40219617","533","1549.65308533","0.343947948768"
"SL2.50ch01:40523400-40524312","196","40523400","40524312","912","1549.65308533","0.588518816654"
"SL2.50ch01:40714692-40715168","96","40714692","40715168","476","1549.65308533","0.307165522727"
"SL2.50ch01:41711237-41712006","267","41711237","41712006","769","1549.65308533","0.496240098692"
"SL2.50ch01:41729414-41731149","564","41729414","41731149","1735","1549.65308533","1.11960542423"
"SL2.50ch01:41729505-41731165","556","41729505","41731165","1660","1549.65308533","1.07120749522"
"SL2.50ch01:41733216-41734775","372","41733216","41734775","1559","1549.65308533","1.0060316175"
"SL2.50ch01:41734093-41734457","107","41734093","41734457","364","1549.65308533","0.234891282085"
"SL2.50ch01:41752923-41754182","307","41752923","41754182","1259","1549.65308533","0.812439901499"
"SL2.50ch01:41753509-41754097","160","41753509","41754097","588","1549.65308533","0.379439763369"
"SL2.50ch01:42324376-42325644","329","42324376","42325644","1268","1549.65308533","0.818247652979"
"SL2.50ch01:42379624-42380407","191","42379624","42380407","783","1549.65308533","0.505274378772"
"SL2.50ch01:43039393-43039981","1117","43039393","43039981","588","1549.65308533","0.379439763369"
"SL2.50ch01:43482173-43482803","143","43482173","43482803","630","1549.65308533","0.406542603609"
"SL2.50ch01:43544852-43546071","204","43544852","43546071","1219","1549.65308533","0.786627672698"
"SL2.50ch01:43647909-43648382","597","43647909","43648382","473","1549.65308533","0.305229605567"
"SL2.50ch01:44093707-44094177","97","44093707","44094177","470","1549.65308533","0.303293688407"
"SL2.50ch01:44352450-44352945","98","44352450","44352945","495","1549.65308533","0.319426331407"
"SL2.50ch01:44466800-44467490","180","44466800","44467490","690","1549.65308533","0.44526094681"
"SL2.50ch01:44528814-44530884","584","44528814","44530884","2070","1549.65308533","1.33578284043"
"SL2.50ch01:44528879-44529467","220","44528879","44529467","588","1549.65308533","0.379439763369"
"SL2.50ch01:44562367-44563066","145","44562367","44563066","699","1549.65308533","0.451068698291"
"SL2.50ch01:44575856-44577434","272","44575856","44577434","1578","1549.65308533","1.01829242618"
"SL2.50ch01:44630655-44631224","137","44630655","44631224","569","1549.65308533","0.367178954689"
"SL2.50ch01:44768402-44769003","118","44768402","44769003","601","1549.65308533","0.387828737729"
"SL2.50ch01:44787657-44789122","432","44787657","44789122","1465","1549.65308533","0.945372879822"
"SL2.50ch01:44799513-44802631","721","44799513","44802631","3118","1549.65308533","2.01206323501"
"SL2.50ch01:44830510-44831180","261","44830510","44831180","670","1549.65308533","0.43235483241"
"SL2.50ch01:44830568-44831831","387","44830568","44831831","1263","1549.65308533","0.815021124379"
"SL2.50ch01:44835507-44836244","177","44835507","44836244","737","1549.65308533","0.475590315651"
"SL2.50ch01:44835699-44836160","151","44835699","44836160","461","1549.65308533","0.297485936927"
"SL2.50ch01:44860994-44861698","155","44860994","44861698","704","1549.65308533","0.454295226891"
"SL2.50ch01:44881547-44882473","224","44881547","44882473","926","1549.65308533","0.597553096734"
"SL2.50ch01:44921478-44922958","381","44921478","44922958","1480","1549.65308533","0.955052465622"
"SL2.50ch01:44981262-44982025","269","44981262","44982025","763","1549.65308533","0.492368264371"
"SL2.50ch01:44983940-44984914","264","44983940","44984914","974","1549.65308533","0.628527771295"
"SL2.50ch01:45009193-45009837","7056","45009193","45009837","644","1549.65308533","0.41557688369"
"SL2.50ch01:45009262-45009850","7044","45009262","45009850","588","1549.65308533","0.379439763369"
"SL2.50ch01:45271114-45271901","182","45271114","45271901","787","1549.65308533","0.507855601652"
"SL2.50ch01:45275548-45276041","171","45275548","45276041","493","1549.65308533","0.318135719967"
"SL2.50ch01:45275571-45277585","550","45275571","45277585","2014","1549.65308533","1.29964572011"
"SL2.50ch01:45421617-45422175","128","45421617","45422175","558","1549.65308533","0.360080591768"
"SL2.50ch01:45785334-45785953","118","45785334","45785953","619","1549.65308533","0.399444240689"
"SL2.50ch01:46733824-46734188","1073","46733824","46734188","364","1549.65308533","0.234891282085"
"SL2.50ch01:47302941-47303609","122","47302941","47303609","668","1549.65308533","0.43106422097"
"SL2.50ch01:47843874-47844682","150","47843874","47844682","808","1549.65308533","0.521407021772"
"SL2.50ch01:51312742-51313340","164","51312742","51313340","598","1549.65308533","0.385892820569"
"SL2.50ch01:51977574-51978650","180","51977574","51978650","1076","1549.65308533","0.694348954736"
"SL2.50ch01:52231429-52231804","82","52231429","52231804","375","1549.65308533","0.241989645006"
"SL2.50ch01:5240388-5241007","303","5240388","5241007","619","1549.65308533","0.399444240689"
"SL2.50ch01:52675696-52676071","81","52675696","52676071","375","1549.65308533","0.241989645006"
"SL2.50ch01:53022792-53023167","83","53022792","53023167","375","1549.65308533","0.241989645006"
"SL2.50ch01:5319741-5323511","945","5319741","5323511","3770","1549.65308533","2.43280256446"
"SL2.50ch01:5320378-5320742","149","5320378","5320742","364","1549.65308533","0.234891282085"
"SL2.50ch01:53392280-53392868","8075","53392280","53392868","588","1549.65308533","0.379439763369"
"SL2.50ch01:53935855-53936602","161","53935855","53936602","747","1549.65308533","0.482043372851"
"SL2.50ch01:54049227-54049741","692","54049227","54049741","514","1549.65308533","0.331687140088"
"SL2.50ch01:54133256-54134212","194","54133256","54134212","956","1549.65308533","0.616912268334"
"SL2.50ch01:54528867-54529492","298","54528867","54529492","625","1549.65308533","0.403316075009"
"SL2.50ch01:55579367-55580337","1737","55579367","55580337","970","1549.65308533","0.625946548415"
"SL2.50ch01:55579446-55580280","1734","55579446","55580280","834","1549.65308533","0.538184970493"
"SL2.50ch01:56248997-56249783","1775","56248997","56249783","786","1549.65308533","0.507210295932"
"SL2.50ch01:56249094-56249682","1749","56249094","56249682","588","1549.65308533","0.379439763369"
"SL2.50ch01:56405661-56406036","76","56405661","56406036","375","1549.65308533","0.241989645006"
"SL2.50ch01:56566648-56567141","96","56566648","56567141","493","1549.65308533","0.318135719967"
"SL2.50ch01:57183282-57183646","608","57183282","57183646","364","1549.65308533","0.234891282085"
"SL2.50ch01:57530071-57530641","107","57530071","57530641","570","1549.65308533","0.367824260409"
"SL2.50ch01:57613255-57613833","117","57613255","57613833","578","1549.65308533","0.372986706169"
"SL2.50ch01:57705080-57705611","123","57705080","57705611","531","1549.65308533","0.342657337328"
"SL2.50ch01:59085623-59086899","199","59085623","59086899","1276","1549.65308533","0.823410098739"
"SL2.50ch01:59207040-59207799","364","59207040","59207799","759","1549.65308533","0.489787041491"
"SL2.50ch01:59207051-59207639","347","59207051","59207639","588","1549.65308533","0.379439763369"
"SL2.50ch01:59546577-59547710","194","59546577","59547710","1133","1549.65308533","0.731131380777"
"SL2.50ch01:59582778-59583153","77","59582778","59583153","375","1549.65308533","0.241989645006"
"SL2.50ch01:60202970-60203452","107","60202970","60203452","482","1549.65308533","0.311037357047"
"SL2.50ch01:60368274-60368881","119","60368274","60368881","607","1549.65308533","0.391700572049"
"SL2.50ch01:60369345-60370336","409","60369345","60370336","991","1549.65308533","0.639497968535"
"SL2.50ch01:60369402-60370290","405","60369402","60370290","888","1549.65308533","0.573031479373"
"SL2.50ch01:60876675-60878871","877","60876675","60878871","2196","1549.65308533","1.41709136115"
"SL2.50ch01:60877170-60878694","755","60877170","60878694","1524","1549.65308533","0.983445917303"
"SL2.50ch01:61418471-61419574","281","61418471","61419574","1103","1549.65308533","0.711772209177"
"SL2.50ch01:61861986-61862350","523","61861986","61862350","364","1549.65308533","0.234891282085"
"SL2.50ch01:63257005-63257380","80","63257005","63257380","375","1549.65308533","0.241989645006"
"SL2.50ch01:63798114-63798876","329","63798114","63798876","762","1549.65308533","0.491722958651"
"SL2.50ch01:63798220-63798677","287","63798220","63798677","457","1549.65308533","0.294904714047"
"SL2.50ch01:63800315-63800787","187","63800315","63800787","472","1549.65308533","0.304584299847"
"SL2.50ch01:63802614-63803443","221","63802614","63803443","829","1549.65308533","0.534958441892"
"SL2.50ch01:64254168-64255162","167","64254168","64255162","994","1549.65308533","0.641433885695"
"SL2.50ch01:64585552-64585927","178","64585552","64585927","375","1549.65308533","0.241989645006"
"SL2.50ch01:64639989-64640577","1965","64639989","64640577","588","1549.65308533","0.379439763369"
"SL2.50ch01:65152545-65152920","113","65152545","65152920","375","1549.65308533","0.241989645006"
"SL2.50ch01:65651673-65652479","8591","65651673","65652479","806","1549.65308533","0.520116410332"
"SL2.50ch01:65651796-65652475","8581","65651796","65652475","679","1549.65308533","0.43816258389"
"SL2.50ch01:65923481-65923856","80","65923481","65923856","375","1549.65308533","0.241989645006"
"SL2.50ch01:66009914-66010502","381","66009914","66010502","588","1549.65308533","0.379439763369"
"SL2.50ch01:66013118-66014447","444","66013118","66014447","1329","1549.65308533","0.8576113019"
"SL2.50ch01:66014831-66016152","378","66014831","66016152","1321","1549.65308533","0.85244885614"
"SL2.50ch01:66014919-66016122","372","66014919","66016122","1203","1549.65308533","0.776302781178"
"SL2.50ch01:66329302-66330038","720","66329302","66330038","736","1549.65308533","0.474945009931"
"SL2.50ch01:66433437-66434185","306","66433437","66434185","748","1549.65308533","0.482688678571"
"SL2.50ch01:66435134-66435509","76","66435134","66435509","375","1549.65308533","0.241989645006"
"SL2.50ch01:66780838-66781997","1731","66780838","66781997","1159","1549.65308533","0.747909329497"
"SL2.50ch01:68660527-68661179","126","68660527","68661179","652","1549.65308533","0.42073932945"
"SL2.50ch01:69305195-69305570","83","69305195","69305570","375","1549.65308533","0.241989645006"
"SL2.50ch01:69689869-69690457","79","69689869","69690457","588","1549.65308533","0.379439763369"
"SL2.50ch01:7029745-7030490","1055","7029745","7030490","745","1549.65308533","0.480752761411"
"SL2.50ch01:7029828-7030891","1136","7029828","7030891","1063","1549.65308533","0.685959980376"
"SL2.50ch01:7080086-7082148","843","7080086","7082148","2062","1549.65308533","1.33062039467"
"SL2.50ch01:7080716-7081913","650","7080716","7081913","1197","1549.65308533","0.772430946858"
"SL2.50ch01:71108669-71109044","100","71108669","71109044","375","1549.65308533","0.241989645006"
"SL2.50ch01:72633593-72634365","756","72633593","72634365","772","1549.65308533","0.498176015852"
"SL2.50ch01:72633686-72634298","743","72633686","72634298","612","1549.65308533","0.394927100649"
"SL2.50ch01:75968814-75971781","603","75968814","75971781","2967","1549.65308533","1.91462207128"
"SL2.50ch01:75984810-75985326","102","75984810","75985326","516","1549.65308533","0.332977751528"
"SL2.50ch01:76143234-76143822","321","76143234","76143822","588","1549.65308533","0.379439763369"
"SL2.50ch01:76143294-76143669","319","76143294","76143669","375","1549.65308533","0.241989645006"
"SL2.50ch01:76425822-76427320","335","76425822","76427320","1498","1549.65308533","0.966667968583"
"SL2.50ch01:76743964-76744328","295","76743964","76744328","364","1549.65308533","0.234891282085"
"SL2.50ch01:77468331-77468816","117","77468331","77468816","485","1549.65308533","0.312973274207"
"SL2.50ch01:77501311-77502448","362","77501311","77502448","1137","1549.65308533","0.733712603657"
"SL2.50ch01:77505244-77506629","428","77505244","77506629","1385","1549.65308533","0.893748422221"
"SL2.50ch01:77506003-77506591","285","77506003","77506591","588","1549.65308533","0.379439763369"
"SL2.50ch01:77533649-77534576","198","77533649","77534576","927","1549.65308533","0.598198402454"
"SL2.50ch01:7787425-7787910","108","7787425","7787910","485","1549.65308533","0.312973274207"
"SL2.50ch01:78119873-78120346","164","78119873","78120346","473","1549.65308533","0.305229605567"
"SL2.50ch01:78119936-78120300","158","78119936","78120300","364","1549.65308533","0.234891282085"
"SL2.50ch01:81032985-81033935","172","81032985","81033935","950","1549.65308533","0.613040434014"
"SL2.50ch01:82436120-82436576","640","82436120","82436576","456","1549.65308533","0.294259408327"
"SL2.50ch01:82806754-82807425","403","82806754","82807425","671","1549.65308533","0.43300013813"
"SL2.50ch01:84251027-84251694","166","84251027","84251694","667","1549.65308533","0.43041891525"
"SL2.50ch01:84341173-84342133","200","84341173","84342133","960","1549.65308533","0.619493491214"
"SL2.50ch01:84936612-84937325","271","84936612","84937325","713","1549.65308533","0.460102978371"
"SL2.50ch01:84936667-84937457","275","84936667","84937457","790","1549.65308533","0.509791518812"
"SL2.50ch01:8530445-8530913","134","8530445","8530913","468","1549.65308533","0.302003076967"
"SL2.50ch01:86035393-86035891","777","86035393","86035891","498","1549.65308533","0.321362248567"
"SL2.50ch01:86035431-86036019","783","86035431","86036019","588","1549.65308533","0.379439763369"
"SL2.50ch01:86711673-86712261","3907","86711673","86712261","588","1549.65308533","0.379439763369"
"SL2.50ch01:87072304-87072892","2576","87072304","87072892","588","1549.65308533","0.379439763369"
"SL2.50ch01:88104703-88105201","1624","88104703","88105201","498","1549.65308533","0.321362248567"
"SL2.50ch01:88104722-88105310","1632","88104722","88105310","588","1549.65308533","0.379439763369"
"SL2.50ch01:9006279-9006867","4475","9006279","9006867","588","1549.65308533","0.379439763369"
"SL2.50ch01:9006400-9006869","4468","9006400","9006869","469","1549.65308533","0.302648382687"
"SL2.50ch01:90133335-90133970","2107","90133335","90133970","635","1549.65308533","0.40976913221"
"SL2.50ch01:90133399-90133987","2107","90133399","90133987","588","1549.65308533","0.379439763369"
"SL2.50ch01:90236888-90237263","149","90236888","90237263","375","1549.65308533","0.241989645006"
"SL2.50ch01:91495599-91496187","6698","91495599","91496187","588","1549.65308533","0.379439763369"
"SL2.50ch01:91495694-91496165","6680","91495694","91496165","471","1549.65308533","0.303938994127"
"SL2.50ch01:92021047-92021422","416","92021047","92021422","375","1549.65308533","0.241989645006"
"SL2.50ch01:92021078-92021442","416","92021078","92021442","364","1549.65308533","0.234891282085"
"SL2.50ch01:93671108-93671702","1303","93671108","93671702","594","1549.65308533","0.383311597689"
"SL2.50ch01:95967350-95968207","170","95967350","95968207","857","1549.65308533","0.553027002053"
"SL2.50ch01:96015003-96015710","156","96015003","96015710","707","1549.65308533","0.456231144051"
"SL2.50ch01:96868547-96870464","1746","96868547","96870464","1917","1549.65308533","1.23705106527"
"SL2.50ch01:96868616-96871630","2051","96868616","96871630","3014","1549.65308533","1.94495144013"
"SL2.50ch01:96871136-96871759","283","96871136","96871759","623","1549.65308533","0.402025463569"
"SL2.50ch01:97436361-97437546","221","97436361","97437546","1185","1549.65308533","0.764687278218"
"SL2.50ch01:98472738-98473567","237","98472738","98473567","829","1549.65308533","0.534958441892"
"SL2.50ch01:98476541-98477971","292","98476541","98477971","1430","1549.65308533","0.922787179622"
"SL2.50ch01:98479579-98481098","536","98479579","98481098","1519","1549.65308533","0.980219388703"
"SL2.50ch01:98483991-98484676","148","98483991","98484676","685","1549.65308533","0.44203441821"
"SL2.50ch01:98485526-98487170","467","98485526","98487170","1644","1549.65308533","1.0608826037"
"SL2.50ch01:98486189-98487166","355","98486189","98487166","977","1549.65308533","0.630463688455"
"SL2.50ch01:98492162-98492745","121","98492162","98492745","583","1549.65308533","0.376213234769"
"SL2.50ch01:98497795-98499816","458","98497795","98499816","2021","1549.65308533","1.30416286015"
"SL2.50ch01:98502870-98505066","602","98502870","98505066","2196","1549.65308533","1.41709136115"
"SL2.50ch01:98503157-98504921","540","98503157","98504921","1764","1549.65308533","1.13831929011"
"SL2.50ch01:98506241-98507449","323","98506241","98507449","1208","1549.65308533","0.779529309778"
"SL2.50ch01:98530529-98530904","67","98530529","98530904","375","1549.65308533","0.241989645006"
"SL2.50ch01:98534700-98535064","137","98534700","98535064","364","1549.65308533","0.234891282085"
"SL2.50ch01:98534714-98535186","164","98534714","98535186","472","1549.65308533","0.304584299847"
"SL2.50ch02:12835422-12844334","2486","12835422","12844334","8912","1549.65308533","5.75096457677"
"SL2.50ch02:12836051-12837691","471","12836051","12837691","1640","1549.65308533","1.05830138082"
"SL2.50ch02:12840357-12841434","433","12840357","12841434","1077","1549.65308533","0.694994260456"
"SL2.50ch02:12845732-12848615","617","12845732","12848615","2883","1549.65308533","1.8604163908"
"SL2.50ch02:12849964-12857765","1795","12849964","12857765","7801","1549.65308533","5.03402992184"
"SL2.50ch02:12856096-12856684","107","12856096","12856684","588","1549.65308533","0.379439763369"
"SL2.50ch02:12859088-12865286","2106","12859088","12865286","6198","1549.65308533","3.99960485265"
"SL2.50ch02:12862282-12864955","1237","12862282","12864955","2673","1549.65308533","1.7249021896"
"SL2.50ch02:12867277-12867825","244","12867277","12867825","548","1549.65308533","0.353627534568"
"SL2.50ch02:12887677-12888620","305","12887677","12888620","943","1549.65308533","0.608523293974"
"SL2.50ch02:12893940-12895344","263","12893940","12895344","1404","1549.65308533","0.906009230901"
"SL2.50ch02:12916048-12916423","73","12916048","12916423","375","1549.65308533","0.241989645006"
"SL2.50ch02:12918386-12918857","111","12918386","12918857","471","1549.65308533","0.303938994127"
"SL2.50ch02:12971206-12972987","551","12971206","12972987","1781","1549.65308533","1.14928948735"
"SL2.50ch02:12984908-12985517","117","12984908","12985517","609","1549.65308533","0.392991183489"
"SL2.50ch02:12992985-12996740","815","12992985","12996740","3755","1549.65308533","2.42312297866"
"SL2.50ch02:13002347-13002904","72","13002347","13002904","557","1549.65308533","0.359435286048"
"SL2.50ch02:13002876-13017983","4277","13002876","13017983","15107","1549.65308533","9.74863351227"
"SL2.50ch02:13018370-13020320","365","13018370","13020320","1950","1549.65308533","1.25834615403"
"SL2.50ch02:13022290-13022759","144","13022290","13022759","469","1549.65308533","0.302648382687"
"SL2.50ch02:13324451-13325032","121","13324451","13325032","581","1549.65308533","0.374922623329"
"SL2.50ch02:13773308-13773989","134","13773308","13773989","681","1549.65308533","0.43945319533"
"SL2.50ch02:13775643-13776112","335","13775643","13776112","469","1549.65308533","0.302648382687"
"SL2.50ch02:13778190-13780818","4390","13778190","13780818","2628","1549.65308533","1.6958634322"
"SL2.50ch02:13779918-13780837","3611","13779918","13780837","919","1549.65308533","0.593035956694"
"SL2.50ch02:13782935-13786345","8267","13782935","13786345","3410","1549.65308533","2.20049250525"
"SL2.50ch02:13783301-13786246","8194","13783301","13786246","2945","1549.65308533","1.90042534544"
"SL2.50ch02:13787281-13788760","1930","13787281","13788760","1479","1549.65308533","0.954407159902"
"SL2.50ch02:13787392-13787756","1649","13787392","13787756","364","1549.65308533","0.234891282085"
"SL2.50ch02:13815682-13816263","128","13815682","13816263","581","1549.65308533","0.374922623329"
"SL2.50ch02:13826083-13828010","5476","13826083","13828010","1927","1549.65308533","1.24350412247"
"SL2.50ch02:13830876-13833335","9379","13830876","13833335","2459","1549.65308533","1.58680676552"
"SL2.50ch02:13831068-13833247","9330","13831068","13833247","2179","1549.65308533","1.40612116391"
"SL2.50ch02:13845192-13845567","77","13845192","13845567","375","1549.65308533","0.241989645006"
"SL2.50ch02:13856709-13857306","143","13856709","13857306","597","1549.65308533","0.385247514849"
"SL2.50ch02:13874382-13884371","3032","13874382","13884371","9989","1549.65308533","6.44595883723"
"SL2.50ch02:13875474-13876511","400","13875474","13876511","1037","1549.65308533","0.669182031656"
"SL2.50ch02:15517466-15518274","161","15517466","15518274","808","1549.65308533","0.521407021772"
"SL2.50ch02:16006591-16007127","108","16006591","16007127","536","1549.65308533","0.345883865928"
"SL2.50ch02:16075026-16075401","86","16075026","16075401","375","1549.65308533","0.241989645006"
"SL2.50ch02:16311701-16312340","126","16311701","16312340","639","1549.65308533","0.41235035509"
"SL2.50ch02:16345463-16346083","153","16345463","16346083","620","1549.65308533","0.400089546409"
"SL2.50ch02:17880715-17881079","613","17880715","17881079","364","1549.65308533","0.234891282085"
"SL2.50ch02:17882045-17882945","2141","17882045","17882945","900","1549.65308533","0.580775148014"
"SL2.50ch02:17882135-17883066","2147","17882135","17883066","931","1549.65308533","0.600779625334"
"SL2.50ch02:17922928-17923292","79","17922928","17923292","364","1549.65308533","0.234891282085"
"SL2.50ch02:18090629-18091004","85","18090629","18091004","375","1549.65308533","0.241989645006"
"SL2.50ch02:18224749-18225264","108","18224749","18225264","515","1549.65308533","0.332332445808"
"SL2.50ch02:18810320-18811397","174","18810320","18811397","1077","1549.65308533","0.694994260456"
"SL2.50ch02:19051109-19051566","240","19051109","19051566","457","1549.65308533","0.294904714047"
"SL2.50ch02:19051111-19052172","348","19051111","19052172","1061","1549.65308533","0.684669368936"
"SL2.50ch02:19905226-19906826","442","19905226","19906826","1600","1549.65308533","1.03248915202"
"SL2.50ch02:19905365-19906509","341","19905365","19906509","1144","1549.65308533","0.738229743697"
"SL2.50ch02:19910002-19910488","96","19910002","19910488","486","1549.65308533","0.313618579927"
"SL2.50ch02:20209340-20209704","58","20209340","20209704","364","1549.65308533","0.234891282085"
"SL2.50ch02:204024-204568","94","204024","204568","544","1549.65308533","0.351046311688"
"SL2.50ch02:21344067-21345092","175","21344067","21345092","1025","1549.65308533","0.661438363015"
"SL2.50ch02:21625130-21625719","110","21625130","21625719","589","1549.65308533","0.380085069089"
"SL2.50ch02:2190837-2191201","361","2190837","2191201","364","1549.65308533","0.234891282085"
"SL2.50ch02:22404773-22405361","2019","22404773","22405361","588","1549.65308533","0.379439763369"
"SL2.50ch02:22601520-22602086","151","22601520","22602086","566","1549.65308533","0.365243037529"
"SL2.50ch02:22880692-22881067","98","22880692","22881067","375","1549.65308533","0.241989645006"
"SL2.50ch02:22974418-22975445","228","22974418","22975445","1027","1549.65308533","0.662728974455"
"SL2.50ch02:23767749-23768837","1101","23767749","23768837","1088","1549.65308533","0.702092623376"
"SL2.50ch02:23767814-23768633","1085","23767814","23768633","819","1549.65308533","0.528505384692"
"SL2.50ch02:24225306-24226515","221","24225306","24226515","1209","1549.65308533","0.780174615498"
"SL2.50ch02:24431561-24431936","77","24431561","24431936","375","1549.65308533","0.241989645006"
"SL2.50ch02:24490615-24495350","12414","24490615","24495350","4735","1549.65308533","3.05552258427"
"SL2.50ch02:24490685-24496631","14537","24490685","24496631","5946","1549.65308533","3.83698781121"
"SL2.50ch02:24495838-24496615","2126","24495838","24496615","777","1549.65308533","0.501402544452"
"SL2.50ch02:24497761-24498495","562","24497761","24498495","734","1549.65308533","0.473654398491"
"SL2.50ch02:24497811-24498433","561","24497811","24498433","622","1549.65308533","0.401380157849"
"SL2.50ch02:24506973-24507709","552","24506973","24507709","736","1549.65308533","0.474945009931"
"SL2.50ch02:24507107-24507677","546","24507107","24507677","570","1549.65308533","0.367824260409"
"SL2.50ch02:24512869-24514609","4957","24512869","24514609","1740","1549.65308533","1.12283195283"
"SL2.50ch02:24512877-24514586","4957","24512877","24514586","1709","1549.65308533","1.10282747551"
"SL2.50ch02:24527189-24529521","9738","24527189","24529521","2332","1549.65308533","1.50485293908"
"SL2.50ch02:24531697-24533162","2011","24531697","24533162","1465","1549.65308533","0.945372879822"
"SL2.50ch02:24531704-24533070","2003","24531704","24533070","1366","1549.65308533","0.881487613541"
"SL2.50ch02:2472631-2473594","177","2472631","2473594","963","1549.65308533","0.621429408374"
"SL2.50ch02:24948187-24952494","975","24948187","24952494","4307","1549.65308533","2.7793317361"
"SL2.50ch02:24968218-24970878","570","24968218","24970878","2660","1549.65308533","1.71651321524"
"SL2.50ch02:24972522-24980040","1487","24972522","24980040","7518","1549.65308533","4.85140840307"
"SL2.50ch02:24978585-24979338","240","24978585","24979338","753","1549.65308533","0.485915207171"
"SL2.50ch02:25000960-25001756","228","25000960","25001756","796","1549.65308533","0.513663353132"
"SL2.50ch02:25007683-25009561","390","25007683","25009561","1878","1549.65308533","1.21188414219"
"SL2.50ch02:25019877-25021322","311","25019877","25021322","1445","1549.65308533","0.932466765422"
"SL2.50ch02:2908907-2909532","1823","2908907","2909532","625","1549.65308533","0.403316075009"
"SL2.50ch02:2908971-2909728","1863","2908971","2909728","757","1549.65308533","0.488496430051"
"SL2.50ch02:30278301-30278676","147","30278301","30278676","375","1549.65308533","0.241989645006"
"SL2.50ch02:30497672-30498260","1877","30497672","30498260","588","1549.65308533","0.379439763369"
"SL2.50ch02:3104901-3105509","105","3104901","3105509","608","1549.65308533","0.392345877769"
"SL2.50ch02:31141327-31141892","121","31141327","31141892","565","1549.65308533","0.364597731809"
"SL2.50ch02:32963098-32963473","285","32963098","32963473","375","1549.65308533","0.241989645006"
"SL2.50ch02:36474207-36479398","1776","36474207","36479398","5191","1549.65308533","3.3497819926"
"SL2.50ch02:36474561-36478606","1570","36474561","36478606","4045","1549.65308533","2.61026163746"
"SL2.50ch02:3680327-3680702","74","3680327","3680702","375","1549.65308533","0.241989645006"
"SL2.50ch02:37742973-37743561","2028","37742973","37743561","588","1549.65308533","0.379439763369"
"SL2.50ch02:3888235-3889008","148","3888235","3889008","773","1549.65308533","0.498821321572"
"SL2.50ch02:39017969-39018796","160","39017969","39018796","827","1549.65308533","0.533667830452"
"SL2.50ch02:41500716-41501214","523","41500716","41501214","498","1549.65308533","0.321362248567"
"SL2.50ch02:41741287-41746986","1790","41741287","41746986","5699","1549.65308533","3.67759729837"
"SL2.50ch02:41778656-41779031","96","41778656","41779031","375","1549.65308533","0.241989645006"
"SL2.50ch02:42082520-42083785","232","42082520","42083785","1265","1549.65308533","0.816311735819"
"SL2.50ch02:4424955-4425541","116","4424955","4425541","586","1549.65308533","0.378149151929"
"SL2.50ch02:44549031-44549818","17276","44549031","44549818","787","1549.65308533","0.507855601652"
"SL2.50ch02:44549155-44549889","17269","44549155","44549889","734","1549.65308533","0.473654398491"
"SL2.50ch02:44818452-44819197","23921","44818452","44819197","745","1549.65308533","0.480752761411"
"SL2.50ch02:44818489-44819236","23919","44818489","44819236","747","1549.65308533","0.482043372851"
"SL2.50ch02:45767419-45767794","86","45767419","45767794","375","1549.65308533","0.241989645006"
"SL2.50ch02:47579957-47580442","92","47579957","47580442","485","1549.65308533","0.312973274207"
"SL2.50ch02:48371617-48372130","377","48371617","48372130","513","1549.65308533","0.331041834368"
"SL2.50ch02:48732880-48734093","240","48732880","48734093","1213","1549.65308533","0.782755838378"
"SL2.50ch02:49308193-49308781","5855","49308193","49308781","588","1549.65308533","0.379439763369"
"SL2.50ch02:49904144-49904854","241","49904144","49904854","710","1549.65308533","0.458167061211"
"SL2.50ch02:52487679-52488250","184","52487679","52488250","571","1549.65308533","0.368469566129"
"SL2.50ch02:5257369-5258616","215","5257369","5258616","1247","1549.65308533","0.804696232859"
"SL2.50ch02:5752523-5752994","164","5752523","5752994","471","1549.65308533","0.303938994127"
"SL2.50ch02:6346335-6346803","192","6346335","6346803","468","1549.65308533","0.302003076967"
"SL2.50ch02:6347821-6348597","281","6347821","6348597","776","1549.65308533","0.500757238732"
"SL2.50ch02:7361323-7361843","116","7361323","7361843","520","1549.65308533","0.335558974408"
"SL2.50ch02:741592-742197","121","741592","742197","605","1549.65308533","0.390409960609"
"SL2.50ch02:7704925-7705300","82","7704925","7705300","375","1549.65308533","0.241989645006"
"SL2.50ch02:7741868-7742243","79","7741868","7742243","375","1549.65308533","0.241989645006"
"SL2.50ch02:7752404-7752779","86","7752404","7752779","375","1549.65308533","0.241989645006"
"SL2.50ch02:7957709-7958084","73","7957709","7958084","375","1549.65308533","0.241989645006"
"SL2.50ch02:9251179-9251769","2791","9251179","9251769","590","1549.65308533","0.380730374809"
"SL2.50ch02:9406540-9419289","5074","9406540","9419289","12749","1549.65308533","8.22700262447"
"SL2.50ch02:9407440-9416934","4215","9407440","9416934","9494","1549.65308533","6.12653250582"
"SL2.50ch02:9423918-9427366","1478","9423918","9427366","3448","1549.65308533","2.22501412261"
"SL2.50ch02:9425046-9427137","897","9425046","9427137","2091","1549.65308533","1.34933426055"
"SL2.50ch02:9446878-9450512","686","9446878","9450512","3634","1549.65308533","2.34504098653"
"SL2.50ch02:9459090-9460766","390","9459090","9460766","1676","1549.65308533","1.08153238675"
"SL2.50ch02:9470431-9471176","140","9470431","9471176","745","1549.65308533","0.480752761411"
"SL2.50ch02:9477116-9477890","153","9477116","9477890","774","1549.65308533","0.499466627292"
"SL2.50ch02:9503321-9504323","177","9503321","9504323","1002","1549.65308533","0.646596331455"
"SL2.50ch02:9534345-9535131","194","9534345","9535131","786","1549.65308533","0.507210295932"
"SL2.50ch02:9536410-9537326","196","9536410","9537326","916","1549.65308533","0.591100039534"
"SL2.50ch02:9548043-9549156","204","9548043","9549156","1113","1549.65308533","0.718225266377"
"SL2.50ch02:9565411-9566675","289","9565411","9566675","1264","1549.65308533","0.815666430099"
"SL2.50ch02:9639480-9639855","79","9639480","9639855","375","1549.65308533","0.241989645006"
"SL2.50ch02:9655132-9656369","217","9655132","9656369","1237","1549.65308533","0.798243175659"
"SL2.50ch02:9671401-9671960","110","9671401","9671960","559","1549.65308533","0.360725897488"
"SL2.50ch02:9676056-9676756","161","9676056","9676756","700","1549.65308533","0.451714004011"
"SL2.50ch02:9683072-9683701","173","9683072","9683701","629","1549.65308533","0.405897297889"
"SL2.50ch02:9689807-9690988","202","9689807","9690988","1181","1549.65308533","0.762106055338"
"SL2.50ch02:9717024-9717746","150","9717024","9717746","722","1549.65308533","0.465910729851"
"SL2.50ch03:11058702-11059077","82","11058702","11059077","375","1549.65308533","0.241989645006"
"SL2.50ch03:11213472-11214074","122","11213472","11214074","602","1549.65308533","0.388474043449"
"SL2.50ch03:11743641-11748395","1218","11743641","11748395","4754","1549.65308533","3.06778339295"
"SL2.50ch03:12265197-12265680","92","12265197","12265680","483","1549.65308533","0.311682662767"
"SL2.50ch03:12965029-12965619","137","12965029","12965619","590","1549.65308533","0.380730374809"
"SL2.50ch03:13255889-13257488","305","13255889","13257488","1599","1549.65308533","1.0318438463"
"SL2.50ch03:13269637-13270807","221","13269637","13270807","1170","1549.65308533","0.755007692418"
"SL2.50ch03:13285827-13286202","78","13285827","13286202","375","1549.65308533","0.241989645006"
"SL2.50ch03:13310956-13311988","190","13310956","13311988","1032","1549.65308533","0.665955503056"
"SL2.50ch03:13318155-13320178","735","13318155","13320178","2023","1549.65308533","1.30545347159"
"SL2.50ch03:13318237-13320243","737","13318237","13320243","2006","1549.65308533","1.29448327435"
"SL2.50ch03:13321597-13325545","959","13321597","13325545","3948","1549.65308533","2.54766698262"
"SL2.50ch03:13328728-13330066","218","13328728","13330066","1338","1549.65308533","0.86341905338"
"SL2.50ch03:13343373-13345685","578","13343373","13345685","2312","1549.65308533","1.49194682467"
"SL2.50ch03:13345087-13345634","301","13345087","13345634","547","1549.65308533","0.352982228848"
"SL2.50ch03:13361926-13363313","721","13361926","13363313","1387","1549.65308533","0.895039033661"
"SL2.50ch03:13362057-13363232","715","13362057","13363232","1175","1549.65308533","0.758234221018"
"SL2.50ch03:13366705-13367423","196","13366705","13367423","718","1549.65308533","0.463329506971"
"SL2.50ch03:13366857-13367314","182","13366857","13367314","457","1549.65308533","0.294904714047"
"SL2.50ch03:13368070-13372262","1381","13368070","13372262","4192","1549.65308533","2.7051215783"
"SL2.50ch03:13370100-13371123","525","13370100","13371123","1023","1549.65308533","0.660147751575"
"SL2.50ch03:13371493-13372100","298","13371493","13372100","607","1549.65308533","0.391700572049"
"SL2.50ch03:15952990-15954350","727","15952990","15954350","1360","1549.65308533","0.87761577922"
"SL2.50ch03:15953045-15954247","716","15953045","15954247","1202","1549.65308533","0.775657475458"
"SL2.50ch03:15955764-15957555","849","15955764","15957555","1791","1549.65308533","1.15574254455"
"SL2.50ch03:15955776-15957621","849","15955776","15957621","1845","1549.65308533","1.19058905343"
"SL2.50ch03:15958682-15960492","599","15958682","15960492","1810","1549.65308533","1.16800335323"
"SL2.50ch03:15958738-15960952","677","15958738","15960952","2214","1549.65308533","1.42870686411"
"SL2.50ch03:15969139-15970086","1357","15969139","15970086","947","1549.65308533","0.611104516854"
"SL2.50ch03:15969145-15973104","2810","15969145","15973104","3959","1549.65308533","2.55476534554"
"SL2.50ch03:15971370-15973139","1209","15971370","15973139","1769","1549.65308533","1.14154581871"
"SL2.50ch03:15974157-15977428","3166","15974157","15977428","3271","1549.65308533","2.11079501017"
"SL2.50ch03:15974187-15977450","3164","15974187","15977450","3263","1549.65308533","2.10563256441"
"SL2.50ch03:16287134-16287937","153","16287134","16287937","803","1549.65308533","0.518180493172"
"SL2.50ch03:16289540-16291454","446","16289540","16291454","1914","1549.65308533","1.23511514811"
"SL2.50ch03:16291061-16291425","178","16291061","16291425","364","1549.65308533","0.234891282085"
"SL2.50ch03:16295263-16296034","146","16295263","16296034","771","1549.65308533","0.497530710132"
"SL2.50ch03:16306709-16308124","295","16306709","16308124","1415","1549.65308533","0.913107593821"
"SL2.50ch03:16483504-16484101","125","16483504","16484101","597","1549.65308533","0.385247514849"
"SL2.50ch03:16813732-16814096","794","16813732","16814096","364","1549.65308533","0.234891282085"
"SL2.50ch03:17787362-17788004","126","17787362","17788004","642","1549.65308533","0.41428627225"
"SL2.50ch03:1788130-1789325","220","1788130","1789325","1195","1549.65308533","0.771140335418"
"SL2.50ch03:19394122-19395508","288","19394122","19395508","1386","1549.65308533","0.894393727941"
"SL2.50ch03:20102977-20103352","113","20102977","20103352","375","1549.65308533","0.241989645006"
"SL2.50ch03:20151953-20152438","104","20151953","20152438","485","1549.65308533","0.312973274207"
"SL2.50ch03:20391278-20392186","183","20391278","20392186","908","1549.65308533","0.585937593774"
"SL2.50ch03:20430092-20431061","157","20430092","20431061","969","1549.65308533","0.625301242695"
"SL2.50ch03:20510377-20510956","210","20510377","20510956","579","1549.65308533","0.373632011889"
"SL2.50ch03:22923191-22923755","221","22923191","22923755","564","1549.65308533","0.363952426088"
"SL2.50ch03:23544067-23545151","616","23544067","23545151","1084","1549.65308533","0.699511400496"
"SL2.50ch03:23694522-23695413","3107","23694522","23695413","891","1549.65308533","0.574967396533"
"SL2.50ch03:23694671-23695441","3107","23694671","23695441","770","1549.65308533","0.496885404412"
"SL2.50ch03:23696883-23697471","1245","23696883","23697471","588","1549.65308533","0.379439763369"
"SL2.50ch03:23696909-23697471","1242","23696909","23697471","562","1549.65308533","0.362661814648"
"SL2.50ch03:24895811-24896734","195","24895811","24896734","923","1549.65308533","0.595617179574"
"SL2.50ch03:25794957-25795545","7272","25794957","25795545","588","1549.65308533","0.379439763369"
"SL2.50ch03:25795072-25795633","7267","25795072","25795633","561","1549.65308533","0.362016508928"
"SL2.50ch03:27306822-27307351","121","27306822","27307351","529","1549.65308533","0.341366725888"
"SL2.50ch03:28416380-28416853","96","28416380","28416853","473","1549.65308533","0.305229605567"
"SL2.50ch03:29465861-29466440","127","29465861","29466440","579","1549.65308533","0.373632011889"
"SL2.50ch03:29582486-29582986","93","29582486","29582986","500","1549.65308533","0.322652860008"
"SL2.50ch03:29750176-29750777","145","29750176","29750777","601","1549.65308533","0.387828737729"
"SL2.50ch03:30364137-30369932","10502","30364137","30369932","5795","1549.65308533","3.73954664749"
"SL2.50ch03:30365454-30369641","10254","30365454","30369641","4187","1549.65308533","2.7018950497"
"SL2.50ch03:30568857-30569547","134","30568857","30569547","690","1549.65308533","0.44526094681"
"SL2.50ch03:30712542-30712917","66","30712542","30712917","375","1549.65308533","0.241989645006"
"SL2.50ch03:30751607-30751982","67","30751607","30751982","375","1549.65308533","0.241989645006"
"SL2.50ch03:31454419-31455482","164","31454419","31455482","1063","1549.65308533","0.685959980376"
"SL2.50ch03:31622071-31623812","651","31622071","31623812","1741","1549.65308533","1.12347725855"
"SL2.50ch03:31622181-31623823","649","31622181","31623823","1642","1549.65308533","1.05959199226"
"SL2.50ch03:32171068-32172297","10083","32171068","32172297","1229","1549.65308533","0.793080729898"
"SL2.50ch03:32171095-32172287","10082","32171095","32172287","1192","1549.65308533","0.769204418258"
"SL2.50ch03:32831365-32831740","68","32831365","32831740","375","1549.65308533","0.241989645006"
"SL2.50ch03:33136306-33137004","25313","33136306","33137004","698","1549.65308533","0.450423392571"
"SL2.50ch03:33136431-33140781","129488","33136431","33140781","4350","1549.65308533","2.80707988207"
"SL2.50ch03:33277703-33278173","184","33277703","33278173","470","1549.65308533","0.303293688407"
"SL2.50ch03:33529669-33530151","83","33529669","33530151","482","1549.65308533","0.311037357047"
"SL2.50ch03:34590828-34592461","2098","34590828","34592461","1633","1549.65308533","1.05378424078"
"SL2.50ch03:34590893-34593313","2351","34590893","34593313","2420","1549.65308533","1.56163984244"
"SL2.50ch03:34595186-34597006","1730","34595186","34597006","1820","1549.65308533","1.17445641043"
"SL2.50ch03:34595264-34596000","1541","34595264","34596000","736","1549.65308533","0.474945009931"
"SL2.50ch03:34597534-34598433","1689","34597534","34598433","899","1549.65308533","0.580129842294"
"SL2.50ch03:34597718-34598454","1676","34597718","34598454","736","1549.65308533","0.474945009931"
"SL2.50ch03:34600038-34601442","7497","34600038","34601442","1404","1549.65308533","0.906009230901"
"SL2.50ch03:34600055-34601530","7499","34600055","34601530","1475","1549.65308533","0.951825937022"
"SL2.50ch03:34606036-34609039","7958","34606036","34609039","3003","1549.65308533","1.93785307721"
"SL2.50ch03:34606313-34608829","7914","34606313","34608829","2516","1549.65308533","1.62358919156"
"SL2.50ch03:36149961-36150437","125","36149961","36150437","476","1549.65308533","0.307165522727"
"SL2.50ch03:36366203-36366578","68","36366203","36366578","375","1549.65308533","0.241989645006"
"SL2.50ch03:36590703-36591078","70","36590703","36591078","375","1549.65308533","0.241989645006"
"SL2.50ch03:37388255-37389163","1862","37388255","37389163","908","1549.65308533","0.585937593774"
"SL2.50ch03:37388377-37389133","1848","37388377","37389133","756","1549.65308533","0.487851124331"
"SL2.50ch03:37574696-37575071","87","37574696","37575071","375","1549.65308533","0.241989645006"
"SL2.50ch03:37822705-37823364","144","37822705","37823364","659","1549.65308533","0.42525646949"
"SL2.50ch03:38127483-38128156","131","38127483","38128156","673","1549.65308533","0.43429074957"
"SL2.50ch03:38361197-38362150","157","38361197","38362150","953","1549.65308533","0.614976351174"
"SL2.50ch03:38719280-38719655","69","38719280","38719655","375","1549.65308533","0.241989645006"
"SL2.50ch03:39625938-39626421","113","39625938","39626421","483","1549.65308533","0.311682662767"
"SL2.50ch03:39746072-39747433","532","39746072","39747433","1361","1549.65308533","0.87826108494"
"SL2.50ch03:39746103-39747589","543","39746103","39747589","1486","1549.65308533","0.958924299942"
"SL2.50ch03:40280870-40281693","157","40280870","40281693","823","1549.65308533","0.531086607572"
"SL2.50ch03:40663941-40664707","148","40663941","40664707","766","1549.65308533","0.494304181532"
"SL2.50ch03:407239-407963","189","407239","407963","724","1549.65308533","0.467201341291"
"SL2.50ch03:41525316-41529259","892","41525316","41529259","3943","1549.65308533","2.54444045402"
"SL2.50ch03:42823323-42823911","3204","42823323","42823911","588","1549.65308533","0.379439763369"
"SL2.50ch03:43238956-43239331","91","43238956","43239331","375","1549.65308533","0.241989645006"
"SL2.50ch03:43439997-43440467","96","43439997","43440467","470","1549.65308533","0.303293688407"
"SL2.50ch03:44111885-44114528","33488","44111885","44114528","2643","1549.65308533","1.705543018"
"SL2.50ch03:44111907-44114461","33488","44111907","44114461","2554","1549.65308533","1.64811080892"
"SL2.50ch03:44115844-44117098","35184","44115844","44117098","1254","1549.65308533","0.809213372899"
"SL2.50ch03:44115862-44117038","35105","44115862","44117038","1176","1549.65308533","0.758879526738"
"SL2.50ch03:44452735-44453445","269","44452735","44453445","710","1549.65308533","0.458167061211"
"SL2.50ch03:44456798-44458035","469","44456798","44458035","1237","1549.65308533","0.798243175659"
"SL2.50ch03:44459174-44460260","216","44459174","44460260","1086","1549.65308533","0.700802011936"
"SL2.50ch03:44888615-44888990","67","44888615","44888990","375","1549.65308533","0.241989645006"
"SL2.50ch03:45065945-45066556","130","45065945","45066556","611","1549.65308533","0.394281794929"
"SL2.50ch03:45136597-45137264","112","45136597","45137264","667","1549.65308533","0.43041891525"
"SL2.50ch03:45289744-45290119","70","45289744","45290119","375","1549.65308533","0.241989645006"
"SL2.50ch03:45379356-45381522","596","45379356","45381522","2166","1549.65308533","1.39773218955"
"SL2.50ch03:46522492-46523088","122","46522492","46523088","596","1549.65308533","0.384602209129"
"SL2.50ch03:47014584-47015543","179","47014584","47015543","959","1549.65308533","0.618848185494"
"SL2.50ch03:48906516-48909745","1606","48906516","48909745","3229","1549.65308533","2.08369216993"
"SL2.50ch03:48907431-48908888","1322","48907431","48908888","1457","1549.65308533","0.940210434062"
"SL2.50ch03:49590590-49590965","85","49590590","49590965","375","1549.65308533","0.241989645006"
"SL2.50ch03:49931866-49932241","73","49931866","49932241","375","1549.65308533","0.241989645006"
"SL2.50ch03:50412262-50412732","106","50412262","50412732","470","1549.65308533","0.303293688407"
"SL2.50ch03:50954079-50954793","142","50954079","50954793","714","1549.65308533","0.460748284091"
"SL2.50ch03:51039866-51040458","1560","51039866","51040458","592","1549.65308533","0.382020986249"
"SL2.50ch03:51201915-51202653","146","51201915","51202653","738","1549.65308533","0.476235621371"
"SL2.50ch03:51702261-51703142","3144","51702261","51703142","881","1549.65308533","0.568514339333"
"SL2.50ch03:51702327-51702992","3136","51702327","51702992","665","1549.65308533","0.42912830381"
"SL2.50ch03:52270878-52272691","382","52270878","52272691","1813","1549.65308533","1.16993927039"
"SL2.50ch03:52274986-52275969","171","52274986","52275969","983","1549.65308533","0.634335522775"
"SL2.50ch03:53569746-53570307","280","53569746","53570307","561","1549.65308533","0.362016508928"
"SL2.50ch03:53623662-53624026","604","53623662","53624026","364","1549.65308533","0.234891282085"
"SL2.50ch03:53623667-53624356","670","53623667","53624356","689","1549.65308533","0.44461564109"
"SL2.50ch03:53627858-53628621","2833","53627858","53628621","763","1549.65308533","0.492368264371"
"SL2.50ch03:53627954-53628689","2819","53627954","53628689","735","1549.65308533","0.474299704211"
"SL2.50ch03:53931373-53932658","572","53931373","53932658","1285","1549.65308533","0.829217850219"
"SL2.50ch03:53931538-53932671","517","53931538","53932671","1133","1549.65308533","0.731131380777"
"SL2.50ch03:54169559-54172842","929","54169559","54172842","3283","1549.65308533","2.11853867881"
"SL2.50ch03:54169574-54172066","809","54169574","54172066","2492","1549.65308533","1.60810185428"
"SL2.50ch03:54176340-54177266","399","54176340","54177266","926","1549.65308533","0.597553096734"
"SL2.50ch03:54176459-54177211","389","54176459","54177211","752","1549.65308533","0.485269901451"
"SL2.50ch03:54180801-54182640","668","54180801","54182640","1839","1549.65308533","1.18671721911"
"SL2.50ch03:54181347-54181902","380","54181347","54181902","555","1549.65308533","0.358144674608"
"SL2.50ch03:56488540-56490509","8933","56488540","56490509","1969","1549.65308533","1.27060696271"
"SL2.50ch03:56488708-56490525","8911","56488708","56490525","1817","1549.65308533","1.17252049327"
"SL2.50ch03:57065964-57066328","863","57065964","57066328","364","1549.65308533","0.234891282085"
"SL2.50ch03:57120790-57121298","98","57120790","57121298","508","1549.65308533","0.327815305768"
"SL2.50ch03:60836717-60839032","452","60836717","60839032","2315","1549.65308533","1.49388274183"
"SL2.50ch03:60887178-60887935","183","60887178","60887935","757","1549.65308533","0.488496430051"
"SL2.50ch03:6452047-6452566","203","6452047","6452566","519","1549.65308533","0.334913668688"
"SL2.50ch03:6454447-6455012","226","6454447","6455012","565","1549.65308533","0.364597731809"
"SL2.50ch03:64821387-64822171","215","64821387","64822171","784","1549.65308533","0.505919684492"
"SL2.50ch03:64832472-64835555","590","64832472","64835555","3083","1549.65308533","1.98947753481"
"SL2.50ch03:64925071-64929301","927","64925071","64929301","4230","1549.65308533","2.72964319566"
"SL2.50ch03:64925853-64926441","166","64925853","64926441","588","1549.65308533","0.379439763369"
"SL2.50ch03:65838756-65839344","562","65838756","65839344","588","1549.65308533","0.379439763369"
"SL2.50ch03:67851299-67851887","7044","67851299","67851887","588","1549.65308533","0.379439763369"
"SL2.50ch03:67851421-67851889","7041","67851421","67851889","468","1549.65308533","0.302003076967"
"SL2.50ch03:6857395-6859016","631","6857395","6859016","1621","1549.65308533","1.04604057214"
"SL2.50ch03:6883156-6883946","227","6883156","6883946","790","1549.65308533","0.509791518812"
"SL2.50ch03:6883275-6883926","217","6883275","6883926","651","1549.65308533","0.42009402373"
"SL2.50ch03:6919095-6919569","94","6919095","6919569","474","1549.65308533","0.305874911287"
"SL2.50ch03:6921518-6922643","301","6921518","6922643","1125","1549.65308533","0.725968935017"
"SL2.50ch03:6947130-6948891","498","6947130","6948891","1761","1549.65308533","1.13638337295"
"SL2.50ch03:6947715-6948515","325","6947715","6948515","800","1549.65308533","0.516244576012"
"SL2.50ch03:6950630-6953393","920","6950630","6953393","2763","1549.65308533","1.7829797044"
"SL2.50ch03:6951796-6953097","553","6951796","6953097","1301","1549.65308533","0.83954274174"
"SL2.50ch03:6965441-6966808","435","6965441","6966808","1367","1549.65308533","0.882132919261"
"SL2.50ch03:6965562-6966307","265","6965562","6966307","745","1549.65308533","0.480752761411"
"SL2.50ch03:70528822-70529410","806","70528822","70529410","588","1549.65308533","0.379439763369"
"SL2.50ch03:7105723-7106192","320","7105723","7106192","469","1549.65308533","0.302648382687"
"SL2.50ch03:7108873-7110202","315","7108873","7110202","1329","1549.65308533","0.8576113019"
"SL2.50ch04:11167865-11168494","1340","11167865","11168494","629","1549.65308533","0.405897297889"
"SL2.50ch04:11568536-11569010","221","11568536","11569010","474","1549.65308533","0.305874911287"
"SL2.50ch04:12101341-12101705","132","12101341","12101705","364","1549.65308533","0.234891282085"
"SL2.50ch04:12134891-12135381","96","12134891","12135381","490","1549.65308533","0.316199802807"
"SL2.50ch04:12536113-12537064","291","12536113","12537064","951","1549.65308533","0.613685739734"
"SL2.50ch04:12545616-12546288","172","12545616","12546288","672","1549.65308533","0.43364544385"
"SL2.50ch04:12547228-12547707","119","12547228","12547707","479","1549.65308533","0.309101439887"
"SL2.50ch04:13811031-13811873","157","13811031","13811873","842","1549.65308533","0.543347416253"
"SL2.50ch04:14454669-14455748","257","14454669","14455748","1079","1549.65308533","0.696284871896"
"SL2.50ch04:14457217-14457581","99","14457217","14457581","364","1549.65308533","0.234891282085"
"SL2.50ch04:14534431-14535267","184","14534431","14535267","836","1549.65308533","0.539475581933"
"SL2.50ch04:14616283-14616879","176","14616283","14616879","596","1549.65308533","0.384602209129"
"SL2.50ch04:14616344-14616913","170","14616344","14616913","569","1549.65308533","0.367178954689"
"SL2.50ch04:14677439-14678027","158","14677439","14678027","588","1549.65308533","0.379439763369"
"SL2.50ch04:14685626-14686434","202","14685626","14686434","808","1549.65308533","0.521407021772"
"SL2.50ch04:14715454-14716627","288","14715454","14716627","1173","1549.65308533","0.756943609578"
"SL2.50ch04:14715559-14716412","233","14715559","14716412","853","1549.65308533","0.550445779173"
"SL2.50ch04:14729523-14730718","372","14729523","14730718","1195","1549.65308533","0.771140335418"
"SL2.50ch04:14729594-14730907","392","14729594","14730907","1313","1549.65308533","0.84728641038"
"SL2.50ch04:14738542-14739013","119","14738542","14739013","471","1549.65308533","0.303938994127"
"SL2.50ch04:14742241-14743162","218","14742241","14743162","921","1549.65308533","0.594326568134"
"SL2.50ch04:14742352-14743858","424","14742352","14743858","1506","1549.65308533","0.971830414343"
"SL2.50ch04:14755876-14756951","257","14755876","14756951","1075","1549.65308533","0.693703649016"
"SL2.50ch04:14768565-14769960","366","14768565","14769960","1395","1549.65308533","0.900201479421"
"SL2.50ch04:14807941-14809954","485","14807941","14809954","2013","1549.65308533","1.29900041439"
"SL2.50ch04:14808573-14809510","216","14808573","14809510","937","1549.65308533","0.604651459654"
"SL2.50ch04:14813993-14814806","182","14813993","14814806","813","1549.65308533","0.524633550372"
"SL2.50ch04:14814049-14814533","146","14814049","14814533","484","1549.65308533","0.312327968487"
"SL2.50ch04:14834142-14836881","769","14834142","14836881","2739","1549.65308533","1.76749236712"
"SL2.50ch04:14841334-14841876","107","14841334","14841876","542","1549.65308533","0.349755700248"
"SL2.50ch04:14842574-14844001","347","14842574","14844001","1427","1549.65308533","0.920851262461"
"SL2.50ch04:14985947-14986465","98","14985947","14986465","518","1549.65308533","0.334268362968"
"SL2.50ch04:15038500-15041316","869","15038500","15041316","2816","1549.65308533","1.81718090756"
"SL2.50ch04:15038618-15040470","584","15038618","15040470","1852","1549.65308533","1.19510619347"
"SL2.50ch04:15417417-15418005","110","15417417","15418005","588","1549.65308533","0.379439763369"
"SL2.50ch04:15958079-15958454","76","15958079","15958454","375","1549.65308533","0.241989645006"
"SL2.50ch04:17160851-17161555","210","17160851","17161555","704","1549.65308533","0.454295226891"
"SL2.50ch04:17249218-17250111","187","17249218","17250111","893","1549.65308533","0.576258007973"
"SL2.50ch04:17251619-17251994","90","17251619","17251994","375","1549.65308533","0.241989645006"
"SL2.50ch04:18560488-18561075","2732","18560488","18561075","587","1549.65308533","0.378794457649"
"SL2.50ch04:18560530-18561287","2729","18560530","18561287","757","1549.65308533","0.488496430051"
"SL2.50ch04:19878321-19878696","91","19878321","19878696","375","1549.65308533","0.241989645006"
"SL2.50ch04:20399812-20400187","81","20399812","20400187","375","1549.65308533","0.241989645006"
"SL2.50ch04:20722013-20722494","98","20722013","20722494","481","1549.65308533","0.310392051327"
"SL2.50ch04:20773780-20774549","184","20773780","20774549","769","1549.65308533","0.496240098692"
"SL2.50ch04:21059530-21059905","84","21059530","21059905","375","1549.65308533","0.241989645006"
"SL2.50ch04:21369111-21369486","80","21369111","21369486","375","1549.65308533","0.241989645006"
"SL2.50ch04:21474510-21475246","156","21474510","21475246","736","1549.65308533","0.474945009931"
"SL2.50ch04:21979423-21979950","139","21979423","21979950","527","1549.65308533","0.340076114448"
"SL2.50ch04:24046018-24046963","234","24046018","24046963","945","1549.65308533","0.609813905414"
"SL2.50ch04:25230288-25230780","106","25230288","25230780","492","1549.65308533","0.317490414247"
"SL2.50ch04:26075214-26075689","114","26075214","26075689","475","1549.65308533","0.306520217007"
"SL2.50ch04:26395424-26397215","362","26395424","26397215","1791","1549.65308533","1.15574254455"
"SL2.50ch04:26611662-26612026","101","26611662","26612026","364","1549.65308533","0.234891282085"
"SL2.50ch04:26620940-26622083","206","26620940","26622083","1143","1549.65308533","0.737584437977"
"SL2.50ch04:26655663-26657240","332","26655663","26657240","1577","1549.65308533","1.01764712046"
"SL2.50ch04:26659143-26659507","105","26659143","26659507","364","1549.65308533","0.234891282085"
"SL2.50ch04:26669361-26671911","700","26669361","26671911","2550","1549.65308533","1.64552958604"
"SL2.50ch04:26674539-26675115","158","26674539","26675115","576","1549.65308533","0.371696094729"
"SL2.50ch04:26705733-26708543","518","26705733","26708543","2810","1549.65308533","1.81330907324"
"SL2.50ch04:26707309-26707673","91","26707309","26707673","364","1549.65308533","0.234891282085"
"SL2.50ch04:26712301-26716719","947","26712301","26716719","4418","1549.65308533","2.85096067103"
"SL2.50ch04:26717448-26722901","1212","26717448","26722901","5453","1549.65308533","3.51885209124"
"SL2.50ch04:26719178-26720143","328","26719178","26720143","965","1549.65308533","0.622720019815"
"SL2.50ch04:26721564-26721928","124","26721564","26721928","364","1549.65308533","0.234891282085"
"SL2.50ch04:26757403-26764442","1342","26757403","26764442","7039","1549.65308533","4.54230696319"
"SL2.50ch04:26778881-26785520","1382","26778881","26785520","6639","1549.65308533","4.28418467518"
"SL2.50ch04:26795859-26796448","157","26795859","26796448","589","1549.65308533","0.380085069089"
"SL2.50ch04:26808024-26809257","332","26808024","26809257","1233","1549.65308533","0.795661952779"
"SL2.50ch04:26820655-26821019","131","26820655","26821019","364","1549.65308533","0.234891282085"
"SL2.50ch04:26825939-26827886","408","26825939","26827886","1947","1549.65308533","1.25641023687"
"SL2.50ch04:26834101-26837317","628","26834101","26837317","3216","1549.65308533","2.07530319557"
"SL2.50ch04:26837800-26842030","987","26837800","26842030","4230","1549.65308533","2.72964319566"
"SL2.50ch04:26842476-26843087","130","26842476","26843087","611","1549.65308533","0.394281794929"
"SL2.50ch04:27596327-27597043","137","27596327","27597043","716","1549.65308533","0.462038895531"
"SL2.50ch04:28236598-28236973","78","28236598","28236973","375","1549.65308533","0.241989645006"
"SL2.50ch04:28285363-28285727","1449","28285363","28285727","364","1549.65308533","0.234891282085"
"SL2.50ch04:28522434-28523268","166","28522434","28523268","834","1549.65308533","0.538184970493"
"SL2.50ch04:28683585-28684526","185","28683585","28684526","941","1549.65308533","0.607232682534"
"SL2.50ch04:28706517-28706892","80","28706517","28706892","375","1549.65308533","0.241989645006"
"SL2.50ch04:28822623-28823312","125","28822623","28823312","689","1549.65308533","0.44461564109"
"SL2.50ch04:29184607-29186133","251","29184607","29186133","1526","1549.65308533","0.984736528743"
"SL2.50ch04:30142765-30143129","421","30142765","30143129","364","1549.65308533","0.234891282085"
"SL2.50ch04:31278302-31278785","103","31278302","31278785","483","1549.65308533","0.311682662767"
"SL2.50ch04:31286822-31287586","7887","31286822","31287586","764","1549.65308533","0.493013570091"
"SL2.50ch04:31286907-31287641","7887","31286907","31287641","734","1549.65308533","0.473654398491"
"SL2.50ch04:31883443-31883818","66","31883443","31883818","375","1549.65308533","0.241989645006"
"SL2.50ch04:32073532-32073907","69","32073532","32073907","375","1549.65308533","0.241989645006"
"SL2.50ch04:32664006-32664594","141","32664006","32664594","588","1549.65308533","0.379439763369"
"SL2.50ch04:3316527-3317115","2814","3316527","3317115","588","1549.65308533","0.379439763369"
"SL2.50ch04:33195737-33196632","173","33195737","33196632","895","1549.65308533","0.577548619413"
"SL2.50ch04:33411788-33412553","1021","33411788","33412553","765","1549.65308533","0.493658875812"
"SL2.50ch04:33411816-33412465","1012","33411816","33412465","649","1549.65308533","0.41880341229"
"SL2.50ch04:33600068-33600848","1156","33600068","33600848","780","1549.65308533","0.503338461612"
"SL2.50ch04:33600145-33600733","1140","33600145","33600733","588","1549.65308533","0.379439763369"
"SL2.50ch04:33964667-33965957","2892","33964667","33965957","1290","1549.65308533","0.832444378819"
"SL2.50ch04:33966591-33967359","2508","33966591","33967359","768","1549.65308533","0.495594792972"
"SL2.50ch04:35556262-35557403","231","35556262","35557403","1141","1549.65308533","0.736293826537"
"SL2.50ch04:35724231-35724606","67","35724231","35724606","375","1549.65308533","0.241989645006"
"SL2.50ch04:36421237-36421612","74","36421237","36421612","375","1549.65308533","0.241989645006"
"SL2.50ch04:37931966-37932599","111","37931966","37932599","633","1549.65308533","0.40847852077"
"SL2.50ch04:4062358-4062722","563","4062358","4062722","364","1549.65308533","0.234891282085"
"SL2.50ch04:4062368-4062840","561","4062368","4062840","472","1549.65308533","0.304584299847"
"SL2.50ch04:40873440-40873972","108","40873440","40873972","532","1549.65308533","0.343302643048"
"SL2.50ch04:41198237-41199273","538","41198237","41199273","1036","1549.65308533","0.668536725936"
"SL2.50ch04:41209844-41211136","409","41209844","41211136","1292","1549.65308533","0.833734990259"
"SL2.50ch04:41210167-41210755","279","41210167","41210755","588","1549.65308533","0.379439763369"
"SL2.50ch04:41211981-41213004","1445","41211981","41213004","1023","1549.65308533","0.660147751575"
"SL2.50ch04:41212181-41214051","1818","41212181","41214051","1870","1549.65308533","1.20672169643"
"SL2.50ch04:42479013-42479482","84","42479013","42479482","469","1549.65308533","0.302648382687"
"SL2.50ch04:42564795-42565478","448","42564795","42565478","683","1549.65308533","0.44074380677"
"SL2.50ch04:42863763-42864367","336","42863763","42864367","604","1549.65308533","0.389764654889"
"SL2.50ch04:43245790-43246413","832","43245790","43246413","623","1549.65308533","0.402025463569"
"SL2.50ch04:4481891-4482361","201","4481891","4482361","470","1549.65308533","0.303293688407"
"SL2.50ch04:4482009-4482373","190","4482009","4482373","364","1549.65308533","0.234891282085"
"SL2.50ch04:45285911-45287297","275","45285911","45287297","1386","1549.65308533","0.894393727941"
"SL2.50ch04:48279789-48280361","335","48279789","48280361","572","1549.65308533","0.369114871849"
"SL2.50ch04:49036971-49038698","332","49036971","49038698","1727","1549.65308533","1.11444297847"
"SL2.50ch04:49143558-49143933","64","49143558","49143933","375","1549.65308533","0.241989645006"
"SL2.50ch04:49645104-49645946","237","49645104","49645946","842","1549.65308533","0.543347416253"
"SL2.50ch04:50234340-50234809","276","50234340","50234809","469","1549.65308533","0.302648382687"
"SL2.50ch04:50472460-50472835","79","50472460","50472835","375","1549.65308533","0.241989645006"
"SL2.50ch04:51278355-51279207","177","51278355","51279207","852","1549.65308533","0.549800473453"
"SL2.50ch04:51485000-51485853","190","51485000","51485853","853","1549.65308533","0.550445779173"
"SL2.50ch04:51635479-51636070","109","51635479","51636070","591","1549.65308533","0.381375680529"
"SL2.50ch04:53900359-53901025","450","53900359","53901025","666","1549.65308533","0.42977360953"
"SL2.50ch04:53908837-53910787","495","53908837","53910787","1950","1549.65308533","1.25834615403"
"SL2.50ch04:54906279-54907178","165","54906279","54907178","899","1549.65308533","0.580129842294"
"SL2.50ch04:55565029-55568902","1190","55565029","55568902","3873","1549.65308533","2.49926905362"
"SL2.50ch04:55565386-55566821","707","55565386","55566821","1435","1549.65308533","0.926013708222"
"SL2.50ch04:55576961-55578041","318","55576961","55578041","1080","1549.65308533","0.696930177616"
"SL2.50ch04:56149342-56149930","389","56149342","56149930","588","1549.65308533","0.379439763369"
"SL2.50ch04:56149404-56149902","387","56149404","56149902","498","1549.65308533","0.321362248567"
"SL2.50ch04:58235669-58236257","1975","58235669","58236257","588","1549.65308533","0.379439763369"
"SL2.50ch04:64832166-64832755","1377","64832166","64832755","589","1549.65308533","0.380085069089"
"SL2.50ch04:65387266-65387854","1720","65387266","65387854","588","1549.65308533","0.379439763369"
"SL2.50ch04:6910385-6910973","1690","6910385","6910973","588","1549.65308533","0.379439763369"
"SL2.50ch04:7364261-7369138","994","7364261","7369138","4877","1549.65308533","3.14715599651"
"SL2.50ch04:7371892-7377121","1143","7371892","7377121","5229","1549.65308533","3.37430360996"
"SL2.50ch04:7374165-7375072","312","7374165","7375072","907","1549.65308533","0.585292288054"
"SL2.50ch04:7380735-7382481","388","7380735","7382481","1746","1549.65308533","1.12670378715"
"SL2.50ch04:7382991-7384030","212","7382991","7384030","1039","1549.65308533","0.670472643096"
"SL2.50ch04:7386752-7387485","171","7386752","7387485","733","1549.65308533","0.473009092771"
"SL2.50ch04:7459635-7460520","203","7459635","7460520","885","1549.65308533","0.571095562213"
"SL2.50ch05:10221775-10222463","167","10221775","10222463","688","1549.65308533","0.44397033537"
"SL2.50ch05:11785031-11785619","1100","11785031","11785619","588","1549.65308533","0.379439763369"
"SL2.50ch05:12450271-12450772","95","12450271","12450772","501","1549.65308533","0.323298165728"
"SL2.50ch05:124695-125283","597","124695","125283","588","1549.65308533","0.379439763369"
"SL2.50ch05:124783-125158","586","124783","125158","375","1549.65308533","0.241989645006"
"SL2.50ch05:14605812-14607111","22150","14605812","14607111","1299","1549.65308533","0.8382521303"
"SL2.50ch05:14606088-14607125","22110","14606088","14607125","1037","1549.65308533","0.669182031656"
"SL2.50ch05:14690339-14690813","85","14690339","14690813","474","1549.65308533","0.305874911287"
"SL2.50ch05:15085150-15085738","112","15085150","15085738","588","1549.65308533","0.379439763369"
"SL2.50ch05:16694334-16695352","202","16694334","16695352","1018","1549.65308533","0.656921222975"
"SL2.50ch05:16723083-16723458","87","16723083","16723458","375","1549.65308533","0.241989645006"
"SL2.50ch05:16979697-16980582","210","16979697","16980582","885","1549.65308533","0.571095562213"
"SL2.50ch05:17037597-17038067","125","17037597","17038067","470","1549.65308533","0.303293688407"
"SL2.50ch05:17039214-17042071","529","17039214","17042071","2857","1549.65308533","1.84363844208"
"SL2.50ch05:17047401-17049149","421","17047401","17049149","1748","1549.65308533","1.12799439859"
"SL2.50ch05:17049999-17051202","303","17049999","17051202","1203","1549.65308533","0.776302781178"
"SL2.50ch05:17051674-17053585","371","17051674","17053585","1911","1549.65308533","1.23317923095"
"SL2.50ch05:17159967-17160908","200","17159967","17160908","941","1549.65308533","0.607232682534"
"SL2.50ch05:17351314-17351783","122","17351314","17351783","469","1549.65308533","0.302648382687"
"SL2.50ch05:17385040-17386799","322","17385040","17386799","1759","1549.65308533","1.13509276151"
"SL2.50ch05:17470266-17470748","97","17470266","17470748","482","1549.65308533","0.311037357047"
"SL2.50ch05:18101997-18104616","457","18101997","18104616","2619","1549.65308533","1.69005568072"
"SL2.50ch05:18104063-18104616","119","18104063","18104616","553","1549.65308533","0.356854063168"
"SL2.50ch05:18552024-18552965","180","18552024","18552965","941","1549.65308533","0.607232682534"
"SL2.50ch05:19596372-19596747","92","19596372","19596747","375","1549.65308533","0.241989645006"
"SL2.50ch05:1959664-1960304","130","1959664","1960304","640","1549.65308533","0.41299566081"
"SL2.50ch05:19600676-19604409","902","19600676","19604409","3733","1549.65308533","2.40892625282"
"SL2.50ch05:19602346-19603372","364","19602346","19603372","1026","1549.65308533","0.662083668735"
"SL2.50ch05:19605239-19606212","232","19605239","19606212","973","1549.65308533","0.627882465575"
"SL2.50ch05:19607655-19608710","197","19607655","19608710","1055","1549.65308533","0.680797534616"
"SL2.50ch05:19639952-19645121","1190","19639952","19645121","5169","1549.65308533","3.33558526676"
"SL2.50ch05:19649748-19655004","979","19649748","19655004","5256","1549.65308533","3.3917268644"
"SL2.50ch05:19672296-19678999","1392","19672296","19678999","6703","1549.65308533","4.32548424126"
"SL2.50ch05:19691784-19692791","179","19691784","19692791","1007","1549.65308533","0.649822860055"
"SL2.50ch05:19710141-19716979","1434","19710141","19716979","6838","1549.65308533","4.41260051346"
"SL2.50ch05:19834195-19835596","275","19834195","19835596","1401","1549.65308533","0.904073313741"
"SL2.50ch05:19838872-19840504","321","19838872","19840504","1632","1549.65308533","1.05313893506"
"SL2.50ch05:19852665-19856166","845","19852665","19856166","3501","1549.65308533","2.25921532577"
"SL2.50ch05:19853693-19854439","232","19853693","19854439","746","1549.65308533","0.481398067131"
"SL2.50ch05:20464725-20465198","110","20464725","20465198","473","1549.65308533","0.305229605567"
"SL2.50ch05:20931305-20931870","123","20931305","20931870","565","1549.65308533","0.364597731809"
"SL2.50ch05:2203006-2203774","2723","2203006","2203774","768","1549.65308533","0.495594792972"
"SL2.50ch05:2203096-2203684","2711","2203096","2203684","588","1549.65308533","0.379439763369"
"SL2.50ch05:23493368-23493743","163","23493368","23493743","375","1549.65308533","0.241989645006"
"SL2.50ch05:24103540-24104273","158","24103540","24104273","733","1549.65308533","0.473009092771"
"SL2.50ch05:24361724-24362496","1738","24361724","24362496","772","1549.65308533","0.498176015852"
"SL2.50ch05:24361812-24362408","1713","24361812","24362408","596","1549.65308533","0.384602209129"
"SL2.50ch05:25812465-25813284","9084","25812465","25813284","819","1549.65308533","0.528505384692"
"SL2.50ch05:25812607-25813352","9072","25812607","25813352","745","1549.65308533","0.480752761411"
"SL2.50ch05:26626408-26626996","2009","26626408","26626996","588","1549.65308533","0.379439763369"
"SL2.50ch05:26632661-26633731","232","26632661","26633731","1070","1549.65308533","0.690477120416"
"SL2.50ch05:27250714-27251089","80","27250714","27251089","375","1549.65308533","0.241989645006"
"SL2.50ch05:27332298-27332886","204","27332298","27332886","588","1549.65308533","0.379439763369"
"SL2.50ch05:27332339-27332714","198","27332339","27332714","375","1549.65308533","0.241989645006"
"SL2.50ch05:28102352-28102954","136","28102352","28102954","602","1549.65308533","0.388474043449"
"SL2.50ch05:28301223-28301970","9500","28301223","28301970","747","1549.65308533","0.482043372851"
"SL2.50ch05:28301241-28302022","9502","28301241","28302022","781","1549.65308533","0.503983767332"
"SL2.50ch05:29407450-29407825","75","29407450","29407825","375","1549.65308533","0.241989645006"
"SL2.50ch05:29577080-29577455","85","29577080","29577455","375","1549.65308533","0.241989645006"
"SL2.50ch05:30101233-30101608","83","30101233","30101608","375","1549.65308533","0.241989645006"
"SL2.50ch05:30135085-30135988","160","30135085","30135988","903","1549.65308533","0.582711065174"
"SL2.50ch05:30137680-30138917","430","30137680","30138917","1237","1549.65308533","0.798243175659"
"SL2.50ch05:30147666-30148456","353","30147666","30148456","790","1549.65308533","0.509791518812"
"SL2.50ch05:30147701-30148176","309","30147701","30148176","475","1549.65308533","0.306520217007"
"SL2.50ch05:30149749-30150226","146","30149749","30150226","477","1549.65308533","0.307810828447"
"SL2.50ch05:30153553-30154008","818","30153553","30154008","455","1549.65308533","0.293614102607"
"SL2.50ch05:30155193-30155675","115","30155193","30155675","482","1549.65308533","0.311037357047"
"SL2.50ch05:30156848-30157316","383","30156848","30157316","468","1549.65308533","0.302003076967"
"SL2.50ch05:31170466-31171574","209","31170466","31171574","1108","1549.65308533","0.714998737777"
"SL2.50ch05:31776487-31776851","1418","31776487","31776851","364","1549.65308533","0.234891282085"
"SL2.50ch05:32634842-32635820","199","32634842","32635820","978","1549.65308533","0.631108994175"
"SL2.50ch05:33142930-33143667","132","33142930","33143667","737","1549.65308533","0.475590315651"
"SL2.50ch05:34059053-34059641","2611","34059053","34059641","588","1549.65308533","0.379439763369"
"SL2.50ch05:34096088-34097600","15285","34096088","34097600","1512","1549.65308533","0.975702248663"
"SL2.50ch05:34096133-34097461","15274","34096133","34097461","1328","1549.65308533","0.85696599618"
"SL2.50ch05:34099408-34100973","88110","34099408","34100973","1565","1549.65308533","1.00990345182"
"SL2.50ch05:34099468-34100879","88096","34099468","34100879","1411","1549.65308533","0.910526370941"
"SL2.50ch05:35110337-35110701","174","35110337","35110701","364","1549.65308533","0.234891282085"
"SL2.50ch05:35698420-35699648","2415","35698420","35699648","1228","1549.65308533","0.792435424178"
"SL2.50ch05:35698612-35699552","2410","35698612","35699552","940","1549.65308533","0.606587376814"
"SL2.50ch05:36600134-36600509","68","36600134","36600509","375","1549.65308533","0.241989645006"
"SL2.50ch05:36816130-36816505","83","36816130","36816505","375","1549.65308533","0.241989645006"
"SL2.50ch05:36962589-36963177","1460","36962589","36963177","588","1549.65308533","0.379439763369"
"SL2.50ch05:36962627-36963125","1459","36962627","36963125","498","1549.65308533","0.321362248567"
"SL2.50ch05:37476736-37477111","73","37476736","37477111","375","1549.65308533","0.241989645006"
"SL2.50ch05:39968305-39970931","1025","39968305","39970931","2626","1549.65308533","1.69457282076"
"SL2.50ch05:40067674-40069045","1158","40067674","40069045","1371","1549.65308533","0.884714142141"
"SL2.50ch05:40067984-40069152","1081","40067984","40069152","1168","1549.65308533","0.753717080978"
"SL2.50ch05:41165357-41165846","116","41165357","41165846","489","1549.65308533","0.315554497087"
"SL2.50ch05:41940526-41940901","70","41940526","41940901","375","1549.65308533","0.241989645006"
"SL2.50ch05:41976040-41976415","78","41976040","41976415","375","1549.65308533","0.241989645006"
"SL2.50ch05:42985477-42985949","178","42985477","42985949","472","1549.65308533","0.304584299847"
"SL2.50ch05:42985498-42985862","174","42985498","42985862","364","1549.65308533","0.234891282085"
"SL2.50ch05:45135206-45136043","6314","45135206","45136043","837","1549.65308533","0.540120887653"
"SL2.50ch05:45135265-45135853","6295","45135265","45135853","588","1549.65308533","0.379439763369"
"SL2.50ch05:47140025-47140809","149","47140025","47140809","784","1549.65308533","0.505919684492"
"SL2.50ch05:47294704-47295828","222","47294704","47295828","1124","1549.65308533","0.725323629297"
"SL2.50ch05:47551289-47551880","114","47551289","47551880","591","1549.65308533","0.381375680529"
"SL2.50ch05:47671730-47672105","100","47671730","47672105","375","1549.65308533","0.241989645006"
"SL2.50ch05:48166716-48167327","117","48166716","48167327","611","1549.65308533","0.394281794929"
"SL2.50ch05:48423873-48424237","472","48423873","48424237","364","1549.65308533","0.234891282085"
"SL2.50ch05:49228459-49228834","84","49228459","49228834","375","1549.65308533","0.241989645006"
"SL2.50ch05:49830583-49830958","101","49830583","49830958","375","1549.65308533","0.241989645006"
"SL2.50ch05:49929704-49930705","1178","49929704","49930705","1001","1549.65308533","0.645951025735"
"SL2.50ch05:49929957-49930545","1107","49929957","49930545","588","1549.65308533","0.379439763369"
"SL2.50ch05:51313961-51315479","29088","51313961","51315479","1518","1549.65308533","0.979574082983"
"SL2.50ch05:51314025-51315420","29068","51314025","51315420","1395","1549.65308533","0.900201479421"
"SL2.50ch05:51316938-51317633","362","51316938","51317633","695","1549.65308533","0.44848747541"
"SL2.50ch05:51467477-51468328","288","51467477","51468328","851","1549.65308533","0.549155167733"
"SL2.50ch05:5398937-5399493","109","5398937","5399493","556","1549.65308533","0.358789980328"
"SL2.50ch05:56673377-56673752","72","56673377","56673752","375","1549.65308533","0.241989645006"
"SL2.50ch05:56705687-56706449","568","56705687","56706449","762","1549.65308533","0.491722958651"
"SL2.50ch05:57568564-57573125","6794","57568564","57573125","4561","1549.65308533","2.94323938899"
"SL2.50ch05:57568948-57570538","1288","57568948","57570538","1590","1549.65308533","1.02603609482"
"SL2.50ch05:57571780-57573003","4831","57571780","57573003","1223","1549.65308533","0.789208895578"
"SL2.50ch05:57574567-57576582","2963","57574567","57576582","2015","1549.65308533","1.30029102583"
"SL2.50ch05:57574936-57576026","2810","57574936","57576026","1090","1549.65308533","0.703383234816"
"SL2.50ch05:57583750-57584573","510","57583750","57584573","823","1549.65308533","0.531086607572"
"SL2.50ch05:57583771-57584526","505","57583771","57584526","755","1549.65308533","0.487205818611"
"SL2.50ch05:57990456-57991043","114","57990456","57991043","587","1549.65308533","0.378794457649"
"SL2.50ch05:58886943-58888070","335","58886943","58888070","1127","1549.65308533","0.727259546457"
"SL2.50ch05:58891989-58892921","18006","58891989","58892921","932","1549.65308533","0.601424931054"
"SL2.50ch05:58892060-58892860","17995","58892060","58892860","800","1549.65308533","0.516244576012"
"SL2.50ch05:60997404-60998305","1913","60997404","60998305","901","1549.65308533","0.581420453734"
"SL2.50ch05:60997425-60998326","1909","60997425","60998326","901","1549.65308533","0.581420453734"
"SL2.50ch05:62772343-62773063","4690","62772343","62773063","720","1549.65308533","0.464620118411"
"SL2.50ch05:62772378-62772966","4680","62772378","62772966","588","1549.65308533","0.379439763369"
"SL2.50ch05:62857695-62858167","341","62857695","62858167","472","1549.65308533","0.304584299847"
"SL2.50ch05:64808123-64809136","900","64808123","64809136","1013","1549.65308533","0.653694694375"
"SL2.50ch05:6498288-6499170","21253","6498288","6499170","882","1549.65308533","0.569159645053"
"SL2.50ch05:6498340-6499318","21268","6498340","6499318","978","1549.65308533","0.631108994175"
"SL2.50ch05:6728375-6728963","791","6728375","6728963","588","1549.65308533","0.379439763369"
"SL2.50ch05:6773478-6774066","1997","6773478","6774066","588","1549.65308533","0.379439763369"
"SL2.50ch05:6773480-6774045","1997","6773480","6774045","565","1549.65308533","0.364597731809"
"SL2.50ch05:8435969-8436440","145","8435969","8436440","471","1549.65308533","0.303938994127"
"SL2.50ch05:8891224-8892218","147","8891224","8892218","994","1549.65308533","0.641433885695"
"SL2.50ch05:9087602-9088399","195","9087602","9088399","797","1549.65308533","0.514308658852"
"SL2.50ch05:932544-933080","117","932544","933080","536","1549.65308533","0.345883865928"
"SL2.50ch05:9672010-9673035","162","9672010","9673035","1025","1549.65308533","0.661438363015"
"SL2.50ch06:10946406-10946781","79","10946406","10946781","375","1549.65308533","0.241989645006"
"SL2.50ch06:10947723-10948504","230","10947723","10948504","781","1549.65308533","0.503983767332"
"SL2.50ch06:10950419-10951848","395","10950419","10951848","1429","1549.65308533","0.922141873902"
"SL2.50ch06:10950987-10951731","284","10950987","10951731","744","1549.65308533","0.480107455691"
"SL2.50ch06:10957290-10958336","273","10957290","10958336","1046","1549.65308533","0.674989783136"
"SL2.50ch06:10957716-10958318","212","10957716","10958318","602","1549.65308533","0.388474043449"
"SL2.50ch06:10960949-10962258","472","10960949","10962258","1309","1549.65308533","0.8447051875"
"SL2.50ch06:10961248-10962297","417","10961248","10962297","1049","1549.65308533","0.676925700296"
"SL2.50ch06:10963237-10964462","355","10963237","10964462","1225","1549.65308533","0.790499507018"
"SL2.50ch06:10965818-10966637","315","10965818","10966637","819","1549.65308533","0.528505384692"
"SL2.50ch06:10966029-10966617","294","10966029","10966617","588","1549.65308533","0.379439763369"
"SL2.50ch06:10968874-10970273","640","10968874","10970273","1399","1549.65308533","0.902782702301"
"SL2.50ch06:10969250-10970199","489","10969250","10970199","949","1549.65308533","0.612395128294"
"SL2.50ch06:10971741-10972816","587","10971741","10972816","1075","1549.65308533","0.693703649016"
"SL2.50ch06:10971756-10972893","587","10971756","10972893","1137","1549.65308533","0.733712603657"
"SL2.50ch06:10979385-10980122","269","10979385","10980122","737","1549.65308533","0.475590315651"
"SL2.50ch06:10979499-10980082","260","10979499","10980082","583","1549.65308533","0.376213234769"
"SL2.50ch06:10982192-10983000","296","10982192","10983000","808","1549.65308533","0.521407021772"
"SL2.50ch06:10982197-10983099","296","10982197","10983099","902","1549.65308533","0.582065759454"
"SL2.50ch06:10986790-10990092","1138","10986790","10990092","3302","1549.65308533","2.13079948749"
"SL2.50ch06:10986800-10990160","1138","10986800","10990160","3360","1549.65308533","2.16822721925"
"SL2.50ch06:10996534-10999029","906","10996534","10999029","2495","1549.65308533","1.61003777144"
"SL2.50ch06:10996599-10999028","906","10996599","10999028","2429","1549.65308533","1.56744759392"
"SL2.50ch06:11000014-11000982","695","11000014","11000982","968","1549.65308533","0.624655936975"
"SL2.50ch06:11000042-11000979","695","11000042","11000979","937","1549.65308533","0.604651459654"
"SL2.50ch06:11008998-11014464","1512","11008998","11014464","5466","1549.65308533","3.5272410656"
"SL2.50ch06:11013646-11014010","256","11013646","11014010","364","1549.65308533","0.234891282085"
"SL2.50ch06:11019627-11027478","4255","11019627","11027478","7851","1549.65308533","5.06629520784"
"SL2.50ch06:11019663-11027361","4255","11019663","11027361","7698","1549.65308533","4.96756343268"
"SL2.50ch06:11032846-11036979","1905","11032846","11036979","4133","1549.65308533","2.66704854082"
"SL2.50ch06:11032885-11037142","1903","11032885","11037142","4257","1549.65308533","2.7470664501"
"SL2.50ch06:11037799-11040277","1194","11037799","11040277","2478","1549.65308533","1.5990675742"
"SL2.50ch06:11037848-11040368","1194","11037848","11040368","2520","1549.65308533","1.62617041444"
"SL2.50ch06:11040980-11043976","1391","11040980","11043976","2996","1549.65308533","1.93333593717"
"SL2.50ch06:11040994-11044052","1391","11040994","11044052","3058","1549.65308533","1.97334489181"
"SL2.50ch06:11050075-11054389","2498","11050075","11054389","4314","1549.65308533","2.78384887614"
"SL2.50ch06:11050112-11054369","2498","11050112","11054369","4257","1549.65308533","2.7470664501"
"SL2.50ch06:11063385-11064584","219","11063385","11064584","1199","1549.65308533","0.773721558298"
"SL2.50ch06:11088653-11090639","401","11088653","11090639","1986","1549.65308533","1.28157715995"
"SL2.50ch06:11092108-11092483","110","11092108","11092483","375","1549.65308533","0.241989645006"
"SL2.50ch06:11101527-11102398","212","11101527","11102398","871","1549.65308533","0.562061282133"
"SL2.50ch06:11121982-11124438","955","11121982","11124438","2456","1549.65308533","1.58487084836"
"SL2.50ch06:11122078-11124486","941","11122078","11124486","2408","1549.65308533","1.5538961738"
"SL2.50ch06:11125035-11127101","636","11125035","11127101","2066","1549.65308533","1.33320161755"
"SL2.50ch06:11125813-11127002","448","11125813","11127002","1189","1549.65308533","0.767268501098"
"SL2.50ch06:11127805-11128825","372","11127805","11128825","1020","1549.65308533","0.658211834415"
"SL2.50ch06:11140999-11141612","177","11140999","11141612","613","1549.65308533","0.395572406369"
"SL2.50ch06:11142205-11147114","1446","11142205","11147114","4909","1549.65308533","3.16780577955"
"SL2.50ch06:11142264-11149330","1862","11142264","11149330","7066","1549.65308533","4.55973021763"
"SL2.50ch06:11149990-11152229","1034","11149990","11152229","2239","1549.65308533","1.44483950711"
"SL2.50ch06:11194777-11195365","1177","11194777","11195365","588","1549.65308533","0.379439763369"
"SL2.50ch06:11227151-11227909","140","11227151","11227909","758","1549.65308533","0.489141735771"
"SL2.50ch06:11232084-11232643","147","11232084","11232643","559","1549.65308533","0.360725897488"
"SL2.50ch06:11232159-11232747","142","11232159","11232747","588","1549.65308533","0.379439763369"
"SL2.50ch06:11242479-11243580","198","11242479","11243580","1101","1549.65308533","0.710481597737"
"SL2.50ch06:11249527-11251064","316","11249527","11251064","1537","1549.65308533","0.991834891663"
"SL2.50ch06:11251623-11252887","253","11251623","11252887","1264","1549.65308533","0.815666430099"
"SL2.50ch06:11281571-11283224","259","11281571","11283224","1653","1549.65308533","1.06669035518"
"SL2.50ch06:11284966-11285462","110","11284966","11285462","496","1549.65308533","0.320071637127"
"SL2.50ch06:11374114-11374791","341","11374114","11374791","677","1549.65308533","0.43687197245"
"SL2.50ch06:11403082-11403457","70","11403082","11403457","375","1549.65308533","0.241989645006"
"SL2.50ch06:11534237-11534695","563","11534237","11534695","458","1549.65308533","0.295550019767"
"SL2.50ch06:11555574-11556564","1605","11555574","11556564","990","1549.65308533","0.638852662815"
"SL2.50ch06:11564973-11565846","433","11564973","11565846","873","1549.65308533","0.563351893573"
"SL2.50ch06:11565004-11565460","361","11565004","11565460","456","1549.65308533","0.294259408327"
"SL2.50ch06:11566179-11567270","389","11566179","11567270","1091","1549.65308533","0.704028540536"
"SL2.50ch06:11567625-11569107","258","11567625","11569107","1482","1549.65308533","0.956343077062"
"SL2.50ch06:11578294-11578894","226","11578294","11578894","600","1549.65308533","0.387183432009"
"SL2.50ch06:11581333-11582077","224","11581333","11582077","744","1549.65308533","0.480107455691"
"SL2.50ch06:11590094-11593520","871","11590094","11593520","3426","1549.65308533","2.21081739677"
"SL2.50ch06:11591589-11593443","625","11591589","11593443","1854","1549.65308533","1.19639680491"
"SL2.50ch06:11599666-11601367","463","11599666","11601367","1701","1549.65308533","1.09766502975"
"SL2.50ch06:11600774-11601362","222","11600774","11601362","588","1549.65308533","0.379439763369"
"SL2.50ch06:11604823-11606584","408","11604823","11606584","1761","1549.65308533","1.13638337295"
"SL2.50ch06:11605838-11606358","179","11605838","11606358","520","1549.65308533","0.335558974408"
"SL2.50ch06:11607763-11609101","760","11607763","11609101","1338","1549.65308533","0.86341905338"
"SL2.50ch06:11607763-11609274","785","11607763","11609274","1511","1549.65308533","0.975056942943"
"SL2.50ch06:11610985-11612389","446","11610985","11612389","1404","1549.65308533","0.906009230901"
"SL2.50ch06:11611003-11612279","420","11611003","11612279","1276","1549.65308533","0.823410098739"
"SL2.50ch06:11615330-11616382","259","11615330","11616382","1052","1549.65308533","0.678861617456"
"SL2.50ch06:11620070-11620580","127","11620070","11620580","510","1549.65308533","0.329105917208"
"SL2.50ch06:11622839-11624605","880","11622839","11624605","1766","1549.65308533","1.13960990155"
"SL2.50ch06:11622852-11624515","879","11622852","11624515","1663","1549.65308533","1.07314341239"
"SL2.50ch06:11632054-11632642","536","11632054","11632642","588","1549.65308533","0.379439763369"
"SL2.50ch06:11632067-11632732","536","11632067","11632732","665","1549.65308533","0.42912830381"
"SL2.50ch06:11634495-11636850","1122","11634495","11636850","2355","1549.65308533","1.51969497064"
"SL2.50ch06:11634541-11636861","1122","11634541","11636861","2320","1549.65308533","1.49710927043"
"SL2.50ch06:12253792-12255393","851","12253792","12255393","1601","1549.65308533","1.03313445774"
"SL2.50ch06:12253975-12255364","831","12253975","12255364","1389","1549.65308533","0.896329645101"
"SL2.50ch06:12260839-12261482","199","12260839","12261482","643","1549.65308533","0.41493157797"
"SL2.50ch06:12260932-12261847","251","12260932","12261847","915","1549.65308533","0.590454733814"
"SL2.50ch06:12263995-12269859","3328","12263995","12269859","5864","1549.65308533","3.78407274217"
"SL2.50ch06:12264074-12269684","3298","12264074","12269684","5610","1549.65308533","3.62016508928"
"SL2.50ch06:12276344-12278623","417","12276344","12278623","2279","1549.65308533","1.47065173591"
"SL2.50ch06:12283739-12284815","187","12283739","12284815","1076","1549.65308533","0.694348954736"
"SL2.50ch06:12296049-12296637","829","12296049","12296637","588","1549.65308533","0.379439763369"
"SL2.50ch06:12375345-12376977","295","12375345","12376977","1632","1549.65308533","1.05313893506"
"SL2.50ch06:12380252-12382058","372","12380252","12382058","1806","1549.65308533","1.16542213035"
"SL2.50ch06:12387063-12389014","349","12387063","12389014","1951","1549.65308533","1.25899145975"
"SL2.50ch06:12392143-12392763","124","12392143","12392763","620","1549.65308533","0.400089546409"
"SL2.50ch06:12402165-12402540","78","12402165","12402540","375","1549.65308533","0.241989645006"
"SL2.50ch06:12429086-12429450","48","12429086","12429450","364","1549.65308533","0.234891282085"
"SL2.50ch06:12431451-12433857","452","12431451","12433857","2406","1549.65308533","1.55260556236"
"SL2.50ch06:12447289-12448805","301","12447289","12448805","1516","1549.65308533","0.978283471543"
"SL2.50ch06:12449493-12450841","250","12449493","12450841","1348","1549.65308533","0.86987211058"
"SL2.50ch06:12457559-12459263","298","12457559","12459263","1704","1549.65308533","1.09960094691"
"SL2.50ch06:12465109-12465990","188","12465109","12465990","881","1549.65308533","0.568514339333"
"SL2.50ch06:12477838-12478858","233","12477838","12478858","1020","1549.65308533","0.658211834415"
"SL2.50ch06:12482968-12484779","286","12482968","12484779","1811","1549.65308533","1.16864865895"
"SL2.50ch06:12488303-12489856","302","12488303","12489856","1553","1549.65308533","1.00215978318"
"SL2.50ch06:12492685-12493828","185","12492685","12493828","1143","1549.65308533","0.737584437977"
"SL2.50ch06:12504601-12506605","349","12504601","12506605","2004","1549.65308533","1.29319266291"
"SL2.50ch06:12507326-12508268","190","12507326","12508268","942","1549.65308533","0.607877988254"
"SL2.50ch06:12533674-12534900","212","12533674","12534900","1226","1549.65308533","0.791144812738"
"SL2.50ch06:12562663-12564129","262","12562663","12564129","1466","1549.65308533","0.946018185542"
"SL2.50ch06:12579820-12580762","208","12579820","12580762","942","1549.65308533","0.607877988254"
"SL2.50ch06:12602997-12604244","243","12602997","12604244","1247","1549.65308533","0.804696232859"
"SL2.50ch06:12606000-12607139","200","12606000","12607139","1139","1549.65308533","0.735003215097"
"SL2.50ch06:12618856-12619563","147","12618856","12619563","707","1549.65308533","0.456231144051"
"SL2.50ch06:12621804-12623260","281","12621804","12623260","1456","1549.65308533","0.939565128342"
"SL2.50ch06:12642682-12643616","169","12642682","12643616","934","1549.65308533","0.602715542494"
"SL2.50ch06:12655595-12656931","231","12655595","12656931","1336","1549.65308533","0.86212844194"
"SL2.50ch06:12659346-12659814","108","12659346","12659814","468","1549.65308533","0.302003076967"
"SL2.50ch06:12667513-12670001","435","12667513","12670001","2488","1549.65308533","1.6055206314"
"SL2.50ch06:12673868-12675784","429","12673868","12675784","1916","1549.65308533","1.23640575955"
"SL2.50ch06:12691023-12692471","347","12691023","12692471","1448","1549.65308533","0.934402682582"
"SL2.50ch06:12715474-12716891","227","12715474","12716891","1417","1549.65308533","0.914398205261"
"SL2.50ch06:12741197-12743812","495","12741197","12743812","2615","1549.65308533","1.68747445784"
"SL2.50ch06:12754105-12754923","188","12754105","12754923","818","1549.65308533","0.527860078972"
"SL2.50ch06:12772546-12774247","421","12772546","12774247","1701","1549.65308533","1.09766502975"
"SL2.50ch06:12779180-12780745","285","12779180","12780745","1565","1549.65308533","1.00990345182"
"SL2.50ch06:12849430-12850318","1635","12849430","12850318","888","1549.65308533","0.573031479373"
"SL2.50ch06:12849446-12850249","1629","12849446","12850249","803","1549.65308533","0.518180493172"
"SL2.50ch06:12880369-12882549","424","12880369","12882549","2180","1549.65308533","1.40676646963"
"SL2.50ch06:12904330-12905284","178","12904330","12905284","954","1549.65308533","0.615621656894"
"SL2.50ch06:12911795-12912848","177","12911795","12912848","1053","1549.65308533","0.679506923176"
"SL2.50ch06:12927539-12930895","632","12927539","12930895","3356","1549.65308533","2.16564599637"
"SL2.50ch06:12935094-12935563","145","12935094","12935563","469","1549.65308533","0.302648382687"
"SL2.50ch06:12944847-12945380","104","12944847","12945380","533","1549.65308533","0.343947948768"
"SL2.50ch06:12978564-12978939","97","12978564","12978939","375","1549.65308533","0.241989645006"
"SL2.50ch06:12987225-12987600","78","12987225","12987600","375","1549.65308533","0.241989645006"
"SL2.50ch06:12993501-12994303","193","12993501","12994303","802","1549.65308533","0.517535187452"
"SL2.50ch06:13025796-13026986","212","13025796","13026986","1190","1549.65308533","0.767913806818"
"SL2.50ch06:13027702-13029858","363","13027702","13029858","2156","1549.65308533","1.39127913235"
"SL2.50ch06:13035131-13036192","189","13035131","13036192","1061","1549.65308533","0.684669368936"
"SL2.50ch06:13037463-13040146","459","13037463","13040146","2683","1549.65308533","1.7313552468"
"SL2.50ch06:13042253-13043575","228","13042253","13043575","1322","1549.65308533","0.85309416186"
"SL2.50ch06:13045620-13046727","196","13045620","13046727","1107","1549.65308533","0.714353432057"
"SL2.50ch06:13422343-13423245","2164","13422343","13423245","902","1549.65308533","0.582065759454"
"SL2.50ch06:13424246-13425133","1495","13424246","13425133","887","1549.65308533","0.572386173653"
"SL2.50ch06:13424305-13425043","1445","13424305","13425043","738","1549.65308533","0.476235621371"
"SL2.50ch06:15863785-15864253","83","15863785","15864253","468","1549.65308533","0.302003076967"
"SL2.50ch06:16299554-16300320","150","16299554","16300320","766","1549.65308533","0.494304181532"
"SL2.50ch06:19442474-19442849","77","19442474","19442849","375","1549.65308533","0.241989645006"
"SL2.50ch06:19446373-19446886","95","19446373","19446886","513","1549.65308533","0.331041834368"
"SL2.50ch06:19472302-19473254","169","19472302","19473254","952","1549.65308533","0.614331045454"
"SL2.50ch06:19676262-19680566","894","19676262","19680566","4304","1549.65308533","2.77739581894"
"SL2.50ch06:19877103-19877664","98","19877103","19877664","561","1549.65308533","0.362016508928"
"SL2.50ch06:19933156-19934187","199","19933156","19934187","1031","1549.65308533","0.665310197336"
"SL2.50ch06:20126822-20130263","23934","20126822","20130263","3441","1549.65308533","2.22049698257"
"SL2.50ch06:20128274-20129320","5849","20128274","20129320","1046","1549.65308533","0.674989783136"
"SL2.50ch06:20129779-20130247","13323","20129779","20130247","468","1549.65308533","0.302003076967"
"SL2.50ch06:20515044-20515632","974","20515044","20515632","588","1549.65308533","0.379439763369"
"SL2.50ch06:20964815-20965283","98","20964815","20965283","468","1549.65308533","0.302003076967"
"SL2.50ch06:21340907-21341495","5191","21340907","21341495","588","1549.65308533","0.379439763369"
"SL2.50ch06:21340983-21341547","5207","21340983","21341547","564","1549.65308533","0.363952426088"
"SL2.50ch06:21522154-21523200","192","21522154","21523200","1046","1549.65308533","0.674989783136"
"SL2.50ch06:21771275-21772056","327","21771275","21772056","781","1549.65308533","0.503983767332"
"SL2.50ch06:21771348-21772213","337","21771348","21772213","865","1549.65308533","0.558189447813"
"SL2.50ch06:21888593-21889067","113","21888593","21889067","474","1549.65308533","0.305874911287"
"SL2.50ch06:22013353-22014090","203","22013353","22014090","737","1549.65308533","0.475590315651"
"SL2.50ch06:22674068-22674566","76","22674068","22674566","498","1549.65308533","0.321362248567"
"SL2.50ch06:24168368-24168956","2124","24168368","24168956","588","1549.65308533","0.379439763369"
"SL2.50ch06:24292005-24292708","134","24292005","24292708","703","1549.65308533","0.453649921171"
"SL2.50ch06:24536081-24536815","2204","24536081","24536815","734","1549.65308533","0.473654398491"
"SL2.50ch06:2523103-2523691","3132","2523103","2523691","588","1549.65308533","0.379439763369"
"SL2.50ch06:26056380-26056852","89","26056380","26056852","472","1549.65308533","0.304584299847"
"SL2.50ch06:26505820-26506408","133","26505820","26506408","588","1549.65308533","0.379439763369"
"SL2.50ch06:27182207-27182795","2017","27182207","27182795","588","1549.65308533","0.379439763369"
"SL2.50ch06:27219236-27219611","79","27219236","27219611","375","1549.65308533","0.241989645006"
"SL2.50ch06:27246387-27246762","77","27246387","27246762","375","1549.65308533","0.241989645006"
"SL2.50ch06:27367795-27368170","81","27367795","27368170","375","1549.65308533","0.241989645006"
"SL2.50ch06:27436517-27437148","417","27436517","27437148","631","1549.65308533","0.407187909329"
"SL2.50ch06:27475556-27478013","538","27475556","27478013","2457","1549.65308533","1.58551615408"
"SL2.50ch06:29196945-29199345","522","29196945","29199345","2400","1549.65308533","1.54873372804"
"SL2.50ch06:29609666-29610630","162","29609666","29610630","964","1549.65308533","0.622074714095"
"SL2.50ch06:30951127-30951502","151","30951127","30951502","375","1549.65308533","0.241989645006"
"SL2.50ch06:31135950-31136539","583","31135950","31136539","589","1549.65308533","0.380085069089"
"SL2.50ch06:31136095-31136459","560","31136095","31136459","364","1549.65308533","0.234891282085"
"SL2.50ch06:32398471-32399126","139","32398471","32399126","655","1549.65308533","0.42267524661"
"SL2.50ch06:32472746-32473580","248","32472746","32473580","834","1549.65308533","0.538184970493"
"SL2.50ch06:3332759-3333441","186","3332759","3333441","682","1549.65308533","0.44009850105"
"SL2.50ch06:33858320-33858908","509","33858320","33858908","588","1549.65308533","0.379439763369"
"SL2.50ch06:33858481-33858856","501","33858481","33858856","375","1549.65308533","0.241989645006"
"SL2.50ch06:3414131-3415346","351","3414131","3415346","1215","1549.65308533","0.784046449818"
"SL2.50ch06:3416275-3416978","201","3416275","3416978","703","1549.65308533","0.453649921171"
"SL2.50ch06:34189577-34189952","85","34189577","34189952","375","1549.65308533","0.241989645006"
"SL2.50ch06:3440582-3441174","124","3440582","3441174","592","1549.65308533","0.382020986249"
"SL2.50ch06:3447211-3449683","689","3447211","3449683","2472","1549.65308533","1.59519573988"
"SL2.50ch06:3451043-3451623","153","3451043","3451623","580","1549.65308533","0.374277317609"
"SL2.50ch06:35232373-35232979","123","35232373","35232979","606","1549.65308533","0.391055266329"
"SL2.50ch06:35841331-35842181","218","35841331","35842181","850","1549.65308533","0.548509862013"
"SL2.50ch06:35848126-35848934","143","35848126","35848934","808","1549.65308533","0.521407021772"
"SL2.50ch06:36593453-36594041","7441","36593453","36594041","588","1549.65308533","0.379439763369"
"SL2.50ch06:36593593-36594154","7457","36593593","36594154","561","1549.65308533","0.362016508928"
"SL2.50ch06:38692655-38693019","390","38692655","38693019","364","1549.65308533","0.234891282085"
"SL2.50ch06:3923921-3924746","165","3923921","3924746","825","1549.65308533","0.532377219012"
"SL2.50ch06:39340377-39340967","932","39340377","39340967","590","1549.65308533","0.380730374809"
"SL2.50ch06:39340474-39340972","923","39340474","39340972","498","1549.65308533","0.321362248567"
"SL2.50ch06:40138733-40139321","897","40138733","40139321","588","1549.65308533","0.379439763369"
"SL2.50ch06:40138792-40139290","889","40138792","40139290","498","1549.65308533","0.321362248567"
"SL2.50ch06:40454177-40455330","257","40454177","40455330","1153","1549.65308533","0.744037495177"
"SL2.50ch06:42662776-42663530","9470","42662776","42663530","754","1549.65308533","0.486560512891"
"SL2.50ch06:42662838-42663574","9466","42662838","42663574","736","1549.65308533","0.474945009931"
"SL2.50ch06:4357166-4357783","3601","4357166","4357783","617","1549.65308533","0.398153629249"
"SL2.50ch06:44550669-44551657","173","44550669","44551657","988","1549.65308533","0.637562051375"
"SL2.50ch06:44655029-44655393","577","44655029","44655393","364","1549.65308533","0.234891282085"
"SL2.50ch06:44744051-44744639","9938","44744051","44744639","588","1549.65308533","0.379439763369"
"SL2.50ch06:44744152-44744620","9932","44744152","44744620","468","1549.65308533","0.302003076967"
"SL2.50ch06:46138783-46140500","1854","46138783","46140500","1717","1549.65308533","1.10798992127"
"SL2.50ch06:46139922-46140510","1439","46139922","46140510","588","1549.65308533","0.379439763369"
"SL2.50ch06:46145263-46148659","33255","46145263","46148659","3396","1549.65308533","2.19145822517"
"SL2.50ch06:46145921-46148732","33066","46145921","46148732","2811","1549.65308533","1.81395437896"
"SL2.50ch06:47239501-47240089","665","47239501","47240089","588","1549.65308533","0.379439763369"
"SL2.50ch06:47293410-47294104","3571","47293410","47294104","694","1549.65308533","0.44784216969"
"SL2.50ch06:47293531-47294119","3571","47293531","47294119","588","1549.65308533","0.379439763369"
"SL2.50ch06:49737655-49738607","330","49737655","49738607","952","1549.65308533","0.614331045454"
"SL2.50ch06:5020160-5021283","204","5020160","5021283","1123","1549.65308533","0.724678323577"
"SL2.50ch06:5039987-5040769","198","5039987","5040769","782","1549.65308533","0.504629073052"
"SL2.50ch06:5041583-5042558","162","5041583","5042558","975","1549.65308533","0.629173077015"
"SL2.50ch06:5043143-5045374","447","5043143","5045374","2231","1549.65308533","1.43967706135"
"SL2.50ch06:5047687-5048863","220","5047687","5048863","1176","1549.65308533","0.758879526738"
"SL2.50ch06:5059484-5060242","136","5059484","5060242","758","1549.65308533","0.489141735771"
"SL2.50ch06:5075343-5076357","216","5075343","5076357","1014","1549.65308533","0.654340000095"
"SL2.50ch06:5118428-5118960","94","5118428","5118960","532","1549.65308533","0.343302643048"
"SL2.50ch06:5261780-5262144","357","5261780","5262144","364","1549.65308533","0.234891282085"
"SL2.50ch06:5300730-5301297","336","5300730","5301297","567","1549.65308533","0.365888343249"
"SL2.50ch06:5452603-5453175","123","5452603","5453175","572","1549.65308533","0.369114871849"
"SL2.50ch06:5534297-5535698","864","5534297","5535698","1401","1549.65308533","0.904073313741"
"SL2.50ch06:5745929-5747291","211","5745929","5747291","1362","1549.65308533","0.878906390661"
"SL2.50ch06:5771150-5772119","229","5771150","5772119","969","1549.65308533","0.625301242695"
"SL2.50ch06:5772988-5773457","119","5772988","5773457","469","1549.65308533","0.302648382687"
"SL2.50ch06:6317096-6317682","106","6317096","6317682","586","1549.65308533","0.378149151929"
"SL2.50ch06:6377893-6378409","101","6377893","6378409","516","1549.65308533","0.332977751528"
"SL2.50ch06:6389532-6390120","1581","6389532","6390120","588","1549.65308533","0.379439763369"
"SL2.50ch06:7153407-7154126","144","7153407","7154126","719","1549.65308533","0.463974812691"
"SL2.50ch06:7235782-7236157","78","7235782","7236157","375","1549.65308533","0.241989645006"
"SL2.50ch06:7609878-7610335","445","7609878","7610335","457","1549.65308533","0.294904714047"
"SL2.50ch06:7753223-7754056","156","7753223","7754056","833","1549.65308533","0.537539664773"
"SL2.50ch06:8413666-8414041","68","8413666","8414041","375","1549.65308533","0.241989645006"
"SL2.50ch06:8559912-8561917","362","8559912","8561917","2005","1549.65308533","1.29383796863"
"SL2.50ch06:8595972-8597144","203","8595972","8597144","1172","1549.65308533","0.756298303858"
"SL2.50ch07:10330984-10331487","91","10330984","10331487","503","1549.65308533","0.324588777168"
"SL2.50ch07:10484574-10485384","1041","10484574","10485384","810","1549.65308533","0.522697633212"
"SL2.50ch07:10484716-10485304","1002","10484716","10485304","588","1549.65308533","0.379439763369"
"SL2.50ch07:10490115-10490850","4911","10490115","10490850","735","1549.65308533","0.474299704211"
"SL2.50ch07:10490286-10490874","4901","10490286","10490874","588","1549.65308533","0.379439763369"
"SL2.50ch07:113-701","310","113","701","588","1549.65308533","0.379439763369"
"SL2.50ch07:11359676-11360051","79","11359676","11360051","375","1549.65308533","0.241989645006"
"SL2.50ch07:11631133-11631734","251","11631133","11631734","601","1549.65308533","0.387828737729"
"SL2.50ch07:11633188-11633660","102","11633188","11633660","472","1549.65308533","0.304584299847"
"SL2.50ch07:11852425-11856905","5005","11852425","11856905","4480","1549.65308533","2.89096962567"
"SL2.50ch07:11852432-11853170","757","11852432","11853170","738","1549.65308533","0.476235621371"
"SL2.50ch07:11854825-11856973","3620","11854825","11856973","2148","1549.65308533","1.38611668659"
"SL2.50ch07:12855807-12856325","102","12855807","12856325","518","1549.65308533","0.334268362968"
"SL2.50ch07:13215968-13216343","78","13215968","13216343","375","1549.65308533","0.241989645006"
"SL2.50ch07:13510775-13511856","218","13510775","13511856","1081","1549.65308533","0.697575483336"
"SL2.50ch07:13703611-13704084","83","13703611","13704084","473","1549.65308533","0.305229605567"
"SL2.50ch07:14478817-14479429","118","14478817","14479429","612","1549.65308533","0.394927100649"
"SL2.50ch07:14670431-14670952","86","14670431","14670952","521","1549.65308533","0.336204280128"
"SL2.50ch07:14879251-14880856","320","14879251","14880856","1605","1549.65308533","1.03571568062"
"SL2.50ch07:15207359-15207939","157","15207359","15207939","580","1549.65308533","0.374277317609"
"SL2.50ch07:15364684-15365534","183","15364684","15365534","850","1549.65308533","0.548509862013"
"SL2.50ch07:15509086-15509461","80","15509086","15509461","375","1549.65308533","0.241989645006"
"SL2.50ch07:16223192-16226558","742","16223192","16226558","3366","1549.65308533","2.17209905357"
"SL2.50ch07:16793730-16795427","466","16793730","16795427","1697","1549.65308533","1.09508380687"
"SL2.50ch07:17357581-17358076","92","17357581","17358076","495","1549.65308533","0.319426331407"
"SL2.50ch07:18155913-18156854","251","18155913","18156854","941","1549.65308533","0.607232682534"
"SL2.50ch07:18155969-18156557","186","18155969","18156557","588","1549.65308533","0.379439763369"
"SL2.50ch07:18257099-18259691","458","18257099","18259691","2592","1549.65308533","1.67263242628"
"SL2.50ch07:18723447-18723990","117","18723447","18723990","543","1549.65308533","0.350401005968"
"SL2.50ch07:19363002-19363653","138","19363002","19363653","651","1549.65308533","0.42009402373"
"SL2.50ch07:19794728-19795857","262","19794728","19795857","1129","1549.65308533","0.728550157897"
"SL2.50ch07:19803738-19805595","353","19803738","19805595","1857","1549.65308533","1.19833272207"
"SL2.50ch07:19807330-19812504","1153","19807330","19812504","5174","1549.65308533","3.33881179536"
"SL2.50ch07:19831167-19835424","867","19831167","19835424","4257","1549.65308533","2.7470664501"
"SL2.50ch07:19838534-19839278","159","19838534","19839278","744","1549.65308533","0.480107455691"
"SL2.50ch07:19842461-19843414","213","19842461","19843414","953","1549.65308533","0.614976351174"
"SL2.50ch07:19847505-19849329","396","19847505","19849329","1824","1549.65308533","1.17703763331"
"SL2.50ch07:19862863-19866371","760","19862863","19866371","3508","1549.65308533","2.26373246581"
"SL2.50ch07:19871390-19873872","509","19871390","19873872","2482","1549.65308533","1.60164879708"
"SL2.50ch07:19880441-19881351","185","19880441","19881351","910","1549.65308533","0.587228205214"
"SL2.50ch07:19882133-19882812","183","19882133","19882812","679","1549.65308533","0.43816258389"
"SL2.50ch07:19886196-19887691","398","19886196","19887691","1495","1549.65308533","0.964732051423"
"SL2.50ch07:19898114-19899111","220","19898114","19899111","997","1549.65308533","0.643369802855"
"SL2.50ch07:19950395-19950978","114","19950395","19950978","583","1549.65308533","0.376213234769"
"SL2.50ch07:19983938-19984833","253","19983938","19984833","895","1549.65308533","0.577548619413"
"SL2.50ch07:2005-2593","228","2005","2593","588","1549.65308533","0.379439763369"
"SL2.50ch07:20362429-20362966","99","20362429","20362966","537","1549.65308533","0.346529171648"
"SL2.50ch07:20482154-20482529","90","20482154","20482529","375","1549.65308533","0.241989645006"
"SL2.50ch07:20862124-20862962","150","20862124","20862962","838","1549.65308533","0.540766193373"
"SL2.50ch07:21109522-21110259","138","21109522","21110259","737","1549.65308533","0.475590315651"
"SL2.50ch07:21158805-21159733","164","21158805","21159733","928","1549.65308533","0.598843708174"
"SL2.50ch07:22267574-22267949","81","22267574","22267949","375","1549.65308533","0.241989645006"
"SL2.50ch07:23178828-23179371","132","23178828","23179371","543","1549.65308533","0.350401005968"
"SL2.50ch07:23705203-23705721","97","23705203","23705721","518","1549.65308533","0.334268362968"
"SL2.50ch07:23731754-23732129","66","23731754","23732129","375","1549.65308533","0.241989645006"
"SL2.50ch07:24165265-24165640","75","24165265","24165640","375","1549.65308533","0.241989645006"
"SL2.50ch07:24197521-24197896","80","24197521","24197896","375","1549.65308533","0.241989645006"
"SL2.50ch07:24678668-24679043","64","24678668","24679043","375","1549.65308533","0.241989645006"
"SL2.50ch07:24747101-24747570","104","24747101","24747570","469","1549.65308533","0.302648382687"
"SL2.50ch07:25085594-25085969","78","25085594","25085969","375","1549.65308533","0.241989645006"
"SL2.50ch07:25270007-25270603","123","25270007","25270603","596","1549.65308533","0.384602209129"
"SL2.50ch07:25828749-25829260","100","25828749","25829260","511","1549.65308533","0.329751222928"
"SL2.50ch07:26467698-26468166","179","26467698","26468166","468","1549.65308533","0.302003076967"
"SL2.50ch07:27088118-27088667","97","27088118","27088667","549","1549.65308533","0.354272840288"
"SL2.50ch07:27171286-27171661","65","27171286","27171661","375","1549.65308533","0.241989645006"
"SL2.50ch07:27291165-27291868","220","27291165","27291868","703","1549.65308533","0.453649921171"
"SL2.50ch07:28302938-28303526","10180","28302938","28303526","588","1549.65308533","0.379439763369"
"SL2.50ch07:28303049-28303517","10171","28303049","28303517","468","1549.65308533","0.302003076967"
"SL2.50ch07:29209644-29210101","1245","29209644","29210101","457","1549.65308533","0.294904714047"
"SL2.50ch07:29426734-29427203","100","29426734","29427203","469","1549.65308533","0.302648382687"
"SL2.50ch07:29887449-29887958","86","29887449","29887958","509","1549.65308533","0.328460611488"
"SL2.50ch07:29919954-29920437","83","29919954","29920437","483","1549.65308533","0.311682662767"
"SL2.50ch07:2999403-3000995","581","2999403","3000995","1592","1549.65308533","1.02732670626"
"SL2.50ch07:2999560-3000385","407","2999560","3000385","825","1549.65308533","0.532377219012"
"SL2.50ch07:30150552-30151140","2017","30150552","30151140","588","1549.65308533","0.379439763369"
"SL2.50ch07:30175177-30175660","90","30175177","30175660","483","1549.65308533","0.311682662767"
"SL2.50ch07:30901950-30903452","870","30901950","30903452","1502","1549.65308533","0.969249191463"
"SL2.50ch07:30902000-30903467","870","30902000","30903467","1467","1549.65308533","0.946663491262"
"SL2.50ch07:30904026-30904590","243","30904026","30904590","564","1549.65308533","0.363952426088"
"SL2.50ch07:30904057-30904517","242","30904057","30904517","460","1549.65308533","0.296840631207"
"SL2.50ch07:30906024-30906612","1392","30906024","30906612","588","1549.65308533","0.379439763369"
"SL2.50ch07:3184639-3185227","1532","3184639","3185227","588","1549.65308533","0.379439763369"
"SL2.50ch07:32432796-32433583","5441","32432796","32433583","787","1549.65308533","0.507855601652"
"SL2.50ch07:32432929-32433517","5413","32432929","32433517","588","1549.65308533","0.379439763369"
"SL2.50ch07:3315-4050","999","3315","4050","735","1549.65308533","0.474299704211"
"SL2.50ch07:34209928-34210528","134","34209928","34210528","600","1549.65308533","0.387183432009"
"SL2.50ch07:34439127-34439673","100","34439127","34439673","546","1549.65308533","0.352336923128"
"SL2.50ch07:34595240-34595615","80","34595240","34595615","375","1549.65308533","0.241989645006"
"SL2.50ch07:34915326-34915920","120","34915326","34915920","594","1549.65308533","0.383311597689"
"SL2.50ch07:35058834-35059437","134","35058834","35059437","603","1549.65308533","0.389119349169"
"SL2.50ch07:36068592-36069317","345","36068592","36069317","725","1549.65308533","0.467846647011"
"SL2.50ch07:37273451-37273949","120","37273451","37273949","498","1549.65308533","0.321362248567"
"SL2.50ch07:3774743-3776382","430","3774743","3776382","1639","1549.65308533","1.0576560751"
"SL2.50ch07:38058364-38058833","84","38058364","38058833","469","1549.65308533","0.302648382687"
"SL2.50ch07:38160847-38161662","192","38160847","38161662","815","1549.65308533","0.525924161812"
"SL2.50ch07:38212908-38213396","94","38212908","38213396","488","1549.65308533","0.314909191367"
"SL2.50ch07:4007281-4008058","1193","4007281","4008058","777","1549.65308533","0.501402544452"
"SL2.50ch07:4007319-4008058","1190","4007319","4008058","739","1549.65308533","0.476880927091"
"SL2.50ch07:40130551-40130926","95","40130551","40130926","375","1549.65308533","0.241989645006"
"SL2.50ch07:40168529-40169090","172","40168529","40169090","561","1549.65308533","0.362016508928"
"SL2.50ch07:40295479-40296056","115","40295479","40296056","577","1549.65308533","0.372341400449"
"SL2.50ch07:41249675-41250932","224","41249675","41250932","1257","1549.65308533","0.811149290059"
"SL2.50ch07:41360345-41360720","76","41360345","41360720","375","1549.65308533","0.241989645006"
"SL2.50ch07:44009853-44010353","94","44009853","44010353","500","1549.65308533","0.322652860008"
"SL2.50ch07:44373038-44373861","209","44373038","44373861","823","1549.65308533","0.531086607572"
"SL2.50ch07:44663230-44663705","92","44663230","44663705","475","1549.65308533","0.306520217007"
"SL2.50ch07:45274098-45275110","206","45274098","45275110","1012","1549.65308533","0.653049388655"
"SL2.50ch07:45482513-45482888","68","45482513","45482888","375","1549.65308533","0.241989645006"
"SL2.50ch07:46279404-46280757","228","46279404","46280757","1353","1549.65308533","0.87309863918"
"SL2.50ch07:4794178-4794650","106","4794178","4794650","472","1549.65308533","0.304584299847"
"SL2.50ch07:48383329-48383933","124","48383329","48383933","604","1549.65308533","0.389764654889"
"SL2.50ch07:48899122-48899639","99","48899122","48899639","517","1549.65308533","0.333623057248"
"SL2.50ch07:49605353-49605728","76","49605353","49605728","375","1549.65308533","0.241989645006"
"SL2.50ch07:50218720-50219647","329","50218720","50219647","927","1549.65308533","0.598198402454"
"SL2.50ch07:50387754-50388861","251","50387754","50388861","1107","1549.65308533","0.714353432057"
"SL2.50ch07:50623523-50623994","148","50623523","50623994","471","1549.65308533","0.303938994127"
"SL2.50ch07:51235920-51236508","2319","51235920","51236508","588","1549.65308533","0.379439763369"
"SL2.50ch07:52229791-52230155","501","52229791","52230155","364","1549.65308533","0.234891282085"
"SL2.50ch07:52294483-52295151","137","52294483","52295151","668","1549.65308533","0.43106422097"
"SL2.50ch07:52522616-52524449","330","52522616","52524449","1833","1549.65308533","1.18284538479"
"SL2.50ch07:53599442-53600287","187","53599442","53600287","845","1549.65308533","0.545283333413"
"SL2.50ch07:53965457-53966247","170","53965457","53966247","790","1549.65308533","0.509791518812"
"SL2.50ch07:5413089-5413754","142","5413089","5413754","665","1549.65308533","0.42912830381"
"SL2.50ch07:5449682-5452325","716","5449682","5452325","2643","1549.65308533","1.705543018"
"SL2.50ch07:5450752-5451354","213","5450752","5451354","602","1549.65308533","0.388474043449"
"SL2.50ch07:54736705-54737343","863","54736705","54737343","638","1549.65308533","0.41170504937"
"SL2.50ch07:54736748-54737336","863","54736748","54737336","588","1549.65308533","0.379439763369"
"SL2.50ch07:55282709-55283297","721","55282709","55283297","588","1549.65308533","0.379439763369"
"SL2.50ch07:55623508-55624399","145","55623508","55624399","891","1549.65308533","0.574967396533"
"SL2.50ch07:55632576-55633447","262","55632576","55633447","871","1549.65308533","0.562061282133"
"SL2.50ch07:55632726-55633305","236","55632726","55633305","579","1549.65308533","0.373632011889"
"SL2.50ch07:5584399-5585220","209","5584399","5585220","821","1549.65308533","0.529795996132"
"SL2.50ch07:5586890-5587265","80","5586890","5587265","375","1549.65308533","0.241989645006"
"SL2.50ch07:56754891-56755463","179","56754891","56755463","572","1549.65308533","0.369114871849"
"SL2.50ch07:56757127-56757897","222","56757127","56757897","770","1549.65308533","0.496885404412"
"SL2.50ch07:57398872-57400681","345","57398872","57400681","1809","1549.65308533","1.16735804751"
"SL2.50ch07:57403887-57404531","125","57403887","57404531","644","1549.65308533","0.41557688369"
"SL2.50ch07:57406693-57407290","142","57406693","57407290","597","1549.65308533","0.385247514849"
"SL2.50ch07:57409285-57410276","205","57409285","57410276","991","1549.65308533","0.639497968535"
"SL2.50ch07:58301086-58301688","563","58301086","58301688","602","1549.65308533","0.388474043449"
"SL2.50ch07:58301187-58301551","542","58301187","58301551","364","1549.65308533","0.234891282085"
"SL2.50ch07:58802352-58805143","705","58802352","58805143","2791","1549.65308533","1.80104826456"
"SL2.50ch07:58803413-58804001","154","58803413","58804001","588","1549.65308533","0.379439763369"
"SL2.50ch07:59388843-59389425","766","59388843","59389425","582","1549.65308533","0.375567929049"
"SL2.50ch07:59388882-59389470","767","59388882","59389470","588","1549.65308533","0.379439763369"
"SL2.50ch07:59506934-59507820","12229","59506934","59507820","886","1549.65308533","0.571740867933"
"SL2.50ch07:59507038-59507626","12180","59507038","59507626","588","1549.65308533","0.379439763369"
"SL2.50ch07:61301649-61302327","911","61301649","61302327","678","1549.65308533","0.43751727817"
"SL2.50ch07:61301675-61302263","910","61301675","61302263","588","1549.65308533","0.379439763369"
"SL2.50ch07:61414731-61415106","78","61414731","61415106","375","1549.65308533","0.241989645006"
"SL2.50ch07:63553939-63554314","69","63553939","63554314","375","1549.65308533","0.241989645006"
"SL2.50ch07:63554982-63555460","112","63554982","63555460","478","1549.65308533","0.308456134167"
"SL2.50ch07:64790120-64790495","122","64790120","64790495","375","1549.65308533","0.241989645006"
"SL2.50ch07:65397005-65397380","152","65397005","65397380","375","1549.65308533","0.241989645006"
"SL2.50ch07:65784724-65785088","668","65784724","65785088","364","1549.65308533","0.234891282085"
"SL2.50ch07:7832030-7832618","893","7832030","7832618","588","1549.65308533","0.379439763369"
"SL2.50ch07:8195959-8196334","75","8195959","8196334","375","1549.65308533","0.241989645006"
"SL2.50ch07:8823185-8824057","306","8823185","8824057","872","1549.65308533","0.562706587853"
"SL2.50ch07:8824605-8825074","170","8824605","8825074","469","1549.65308533","0.302648382687"
"SL2.50ch07:90612-91248","110","90612","91248","636","1549.65308533","0.41041443793"
"SL2.50ch07:9403987-9405063","174","9403987","9405063","1076","1549.65308533","0.694348954736"
"SL2.50ch08:10002631-10004774","959","10002631","10004774","2143","1549.65308533","1.38289015799"
"SL2.50ch08:10002650-10004726","959","10002650","10004726","2076","1549.65308533","1.33965467475"
"SL2.50ch08:10005513-10006872","522","10005513","10006872","1359","1549.65308533","0.8769704735"
"SL2.50ch08:10005552-10006837","511","10005552","10006837","1285","1549.65308533","0.829217850219"
"SL2.50ch08:10011794-10013467","1045","10011794","10013467","1673","1549.65308533","1.07959646959"
"SL2.50ch08:10011819-10013442","1045","10011819","10013442","1623","1549.65308533","1.04733118358"
"SL2.50ch08:10015688-10017864","1522","10015688","10017864","2176","1549.65308533","1.40418524675"
"SL2.50ch08:10015792-10017881","1518","10015792","10017881","2089","1549.65308533","1.34804364911"
"SL2.50ch08:10024202-10028266","2759","10024202","10028266","4064","1549.65308533","2.62252244614"
"SL2.50ch08:10024259-10028312","2758","10024259","10028312","4053","1549.65308533","2.61542408322"
"SL2.50ch08:10030614-10031938","485","10030614","10031938","1324","1549.65308533","0.8543847733"
"SL2.50ch08:10030644-10031872","485","10030644","10031872","1228","1549.65308533","0.792435424178"
"SL2.50ch08:10032530-10036482","1651","10032530","10036482","3952","1549.65308533","2.5502482055"
"SL2.50ch08:10032707-10036303","1561","10032707","10036303","3596","1549.65308533","2.32051936917"
"SL2.50ch08:10434313-10437377","588","10434313","10437377","3064","1549.65308533","1.97721672613"
"SL2.50ch08:10445852-10446438","101","10445852","10446438","586","1549.65308533","0.378149151929"
"SL2.50ch08:10563767-10564351","132","10563767","10564351","584","1549.65308533","0.376858540489"
"SL2.50ch08:10821212-10821897","238","10821212","10821897","685","1549.65308533","0.44203441821"
"SL2.50ch08:10888393-10890109","380","10888393","10890109","1716","1549.65308533","1.10734461555"
"SL2.50ch08:10889305-10889996","186","10889305","10889996","691","1549.65308533","0.44590625253"
"SL2.50ch08:11082856-11083444","851","11082856","11083444","588","1549.65308533","0.379439763369"
"SL2.50ch08:11082930-11083400","841","11082930","11083400","470","1549.65308533","0.303293688407"
"SL2.50ch08:11130673-11131445","1476","11130673","11131445","772","1549.65308533","0.498176015852"
"SL2.50ch08:11137848-11141424","24015","11137848","11141424","3576","1549.65308533","2.30761325477"
"SL2.50ch08:11138070-11141237","23970","11138070","11141237","3167","1549.65308533","2.04368321529"
"SL2.50ch08:11147837-11149023","1813","11147837","11149023","1186","1549.65308533","0.765332583938"
"SL2.50ch08:11147845-11149133","1816","11147845","11149133","1288","1549.65308533","0.831153767379"
"SL2.50ch08:11732728-11733548","1071","11732728","11733548","820","1549.65308533","0.529150690412"
"SL2.50ch08:11732795-11733433","1063","11732795","11733433","638","1549.65308533","0.41170504937"
"SL2.50ch08:11880892-11881676","259","11880892","11881676","784","1549.65308533","0.505919684492"
"SL2.50ch08:12271948-12272456","98","12271948","12272456","508","1549.65308533","0.327815305768"
"SL2.50ch08:13446739-13447472","169","13446739","13447472","733","1549.65308533","0.473009092771"
"SL2.50ch08:14138174-14139779","263","14138174","14139779","1605","1549.65308533","1.03571568062"
"SL2.50ch08:14423080-14423455","81","14423080","14423455","375","1549.65308533","0.241989645006"
"SL2.50ch08:14782409-14783639","243","14782409","14783639","1230","1549.65308533","0.793726035619"
"SL2.50ch08:14849153-14849922","144","14849153","14849922","769","1549.65308533","0.496240098692"
"SL2.50ch08:14906344-14906719","84","14906344","14906719","375","1549.65308533","0.241989645006"
"SL2.50ch08:14929397-14930627","201","14929397","14930627","1230","1549.65308533","0.793726035619"
"SL2.50ch08:14939719-14940094","73","14939719","14940094","375","1549.65308533","0.241989645006"
"SL2.50ch08:14999361-15000850","1513","14999361","15000850","1489","1549.65308533","0.960860217102"
"SL2.50ch08:14999725-15000633","1414","14999725","15000633","908","1549.65308533","0.585937593774"
"SL2.50ch08:15012585-15015861","569","15012585","15015861","3276","1549.65308533","2.11402153877"
"SL2.50ch08:15167719-15168629","924","15167719","15168629","910","1549.65308533","0.587228205214"
"SL2.50ch08:15167799-15168553","920","15167799","15168553","754","1549.65308533","0.486560512891"
"SL2.50ch08:15513770-15514768","302","15513770","15514768","998","1549.65308533","0.644015108575"
"SL2.50ch08:15515434-15516356","349","15515434","15516356","922","1549.65308533","0.594971873854"
"SL2.50ch08:15515651-15516366","318","15515651","15516366","715","1549.65308533","0.461393589811"
"SL2.50ch08:15517553-15518021","174","15517553","15518021","468","1549.65308533","0.302003076967"
"SL2.50ch08:15547353-15547924","185","15547353","15547924","571","1549.65308533","0.368469566129"
"SL2.50ch08:15547381-15547969","186","15547381","15547969","588","1549.65308533","0.379439763369"
"SL2.50ch08:15554983-15555438","216","15554983","15555438","455","1549.65308533","0.293614102607"
"SL2.50ch08:15555027-15555495","204","15555027","15555495","468","1549.65308533","0.302003076967"
"SL2.50ch08:15556257-15557433","309","15556257","15557433","1176","1549.65308533","0.758879526738"
"SL2.50ch08:15570741-15571524","158","15570741","15571524","783","1549.65308533","0.505274378772"
"SL2.50ch08:15612648-15613407","183","15612648","15613407","759","1549.65308533","0.489787041491"
"SL2.50ch08:15838966-15839330","445","15838966","15839330","364","1549.65308533","0.234891282085"
"SL2.50ch08:15840200-15840698","568","15840200","15840698","498","1549.65308533","0.321362248567"
"SL2.50ch08:15840227-15840591","557","15840227","15840591","364","1549.65308533","0.234891282085"
"SL2.50ch08:15842238-15842811","376","15842238","15842811","573","1549.65308533","0.369760177569"
"SL2.50ch08:15843673-15844141","299","15843673","15844141","468","1549.65308533","0.302003076967"
"SL2.50ch08:16026314-16027981","1038","16026314","16027981","1667","1549.65308533","1.07572463527"
"SL2.50ch08:16027248-16027983","790","16027248","16027983","735","1549.65308533","0.474299704211"
"SL2.50ch08:16184608-16185513","168","16184608","16185513","905","1549.65308533","0.584001676614"
"SL2.50ch08:16330791-16331166","72","16330791","16331166","375","1549.65308533","0.241989645006"
"SL2.50ch08:18438018-18438486","401","18438018","18438486","468","1549.65308533","0.302003076967"
"SL2.50ch08:18882883-18883258","82","18882883","18883258","375","1549.65308533","0.241989645006"
"SL2.50ch08:20831258-20831944","132","20831258","20831944","686","1549.65308533","0.44267972393"
"SL2.50ch08:21993489-21994553","231","21993489","21994553","1064","1549.65308533","0.686605286096"
"SL2.50ch08:22048713-22049654","164","22048713","22049654","941","1549.65308533","0.607232682534"
"SL2.50ch08:22057628-22059113","246","22057628","22059113","1485","1549.65308533","0.958278994222"
"SL2.50ch08:22106435-22107140","137","22106435","22107140","705","1549.65308533","0.454940532611"
"SL2.50ch08:22110937-22112032","281","22110937","22112032","1095","1549.65308533","0.706609763416"
"SL2.50ch08:22754166-22754762","113","22754166","22754762","596","1549.65308533","0.384602209129"
"SL2.50ch08:23194922-23195394","102","23194922","23195394","472","1549.65308533","0.304584299847"
"SL2.50ch08:24008165-24008906","164","24008165","24008906","741","1549.65308533","0.478171538531"
"SL2.50ch08:25319895-25320574","148","25319895","25320574","679","1549.65308533","0.43816258389"
"SL2.50ch08:25881646-25882394","171","25881646","25882394","748","1549.65308533","0.482688678571"
"SL2.50ch08:26152852-26153326","112","26152852","26153326","474","1549.65308533","0.305874911287"
"SL2.50ch08:2620392-2620767","412","2620392","2620767","375","1549.65308533","0.241989645006"
"SL2.50ch08:26922990-26923365","82","26922990","26923365","375","1549.65308533","0.241989645006"
"SL2.50ch08:27633040-27633813","16919","27633040","27633813","773","1549.65308533","0.498821321572"
"SL2.50ch08:27633144-27633732","16910","27633144","27633732","588","1549.65308533","0.379439763369"
"SL2.50ch08:28973967-28974989","225","28973967","28974989","1022","1549.65308533","0.659502445855"
"SL2.50ch08:29032708-29033083","71","29032708","29033083","375","1549.65308533","0.241989645006"
"SL2.50ch08:29725656-29726031","81","29725656","29726031","375","1549.65308533","0.241989645006"
"SL2.50ch08:29731350-29731725","83","29731350","29731725","375","1549.65308533","0.241989645006"
"SL2.50ch08:29735774-29736548","198","29735774","29736548","774","1549.65308533","0.499466627292"
"SL2.50ch08:29769736-29770224","96","29769736","29770224","488","1549.65308533","0.314909191367"
"SL2.50ch08:30721854-30722229","89","30721854","30722229","375","1549.65308533","0.241989645006"
"SL2.50ch08:31710872-31711236","45","31710872","31711236","364","1549.65308533","0.234891282085"
"SL2.50ch08:31765609-31766616","7919","31765609","31766616","1007","1549.65308533","0.649822860055"
"SL2.50ch08:32308823-32309711","229","32308823","32309711","888","1549.65308533","0.573031479373"
"SL2.50ch08:32821715-32822303","1075","32821715","32822303","588","1549.65308533","0.379439763369"
"SL2.50ch08:32821729-32822351","1076","32821729","32822351","622","1549.65308533","0.401380157849"
"SL2.50ch08:33532582-33533633","239","33532582","33533633","1051","1549.65308533","0.678216311736"
"SL2.50ch08:33539540-33540141","118","33539540","33540141","601","1549.65308533","0.387828737729"
"SL2.50ch08:33559933-33561952","389","33559933","33561952","2019","1549.65308533","1.30287224871"
"SL2.50ch08:33791999-33792945","167","33791999","33792945","946","1549.65308533","0.610459211134"
"SL2.50ch08:33847277-33847952","126","33847277","33847952","675","1549.65308533","0.43558136101"
"SL2.50ch08:33973640-33974015","75","33973640","33974015","375","1549.65308533","0.241989645006"
"SL2.50ch08:34038094-34038610","115","34038094","34038610","516","1549.65308533","0.332977751528"
"SL2.50ch08:34452829-34453204","74","34452829","34453204","375","1549.65308533","0.241989645006"
"SL2.50ch08:36254055-36254523","87","36254055","36254523","468","1549.65308533","0.302003076967"
"SL2.50ch08:36327095-36327819","159","36327095","36327819","724","1549.65308533","0.467201341291"
"SL2.50ch08:37202826-37204271","891","37202826","37204271","1445","1549.65308533","0.932466765422"
"SL2.50ch08:37202866-37203619","761","37202866","37203619","753","1549.65308533","0.485915207171"
"SL2.50ch08:37207199-37208138","205","37207199","37208138","939","1549.65308533","0.605942071094"
"SL2.50ch08:37401855-37402443","1830","37401855","37402443","588","1549.65308533","0.379439763369"
"SL2.50ch08:38677562-38678150","1476","38677562","38678150","588","1549.65308533","0.379439763369"
"SL2.50ch08:39144765-39154049","46646","39144765","39154049","9284","1549.65308533","5.99101830462"
"SL2.50ch08:39144867-39154189","46642","39144867","39154189","9322","1549.65308533","6.01553992198"
"SL2.50ch08:39461737-39462112","72","39461737","39462112","375","1549.65308533","0.241989645006"
"SL2.50ch08:40119573-40120194","123","40119573","40120194","621","1549.65308533","0.400734852129"
"SL2.50ch08:40507516-40507891","86","40507516","40507891","375","1549.65308533","0.241989645006"
"SL2.50ch08:40624439-40624918","100","40624439","40624918","479","1549.65308533","0.309101439887"
"SL2.50ch08:40631090-40631465","72","40631090","40631465","375","1549.65308533","0.241989645006"
"SL2.50ch08:40632968-40633569","129","40632968","40633569","601","1549.65308533","0.387828737729"
"SL2.50ch08:41075319-41076236","269","41075319","41076236","917","1549.65308533","0.591745345254"
"SL2.50ch08:41315057-41315579","108","41315057","41315579","522","1549.65308533","0.336849585848"
"SL2.50ch08:42177146-42177627","226","42177146","42177627","481","1549.65308533","0.310392051327"
"SL2.50ch08:4256808-4257458","115","4256808","4257458","650","1549.65308533","0.41944871801"
"SL2.50ch08:43103108-43103472","103","43103108","43103472","364","1549.65308533","0.234891282085"
"SL2.50ch08:4393879-4394467","1222","4393879","4394467","588","1549.65308533","0.379439763369"
"SL2.50ch08:44328114-44328997","172","44328114","44328997","883","1549.65308533","0.569804950773"
"SL2.50ch08:44452680-44453276","198","44452680","44453276","596","1549.65308533","0.384602209129"
"SL2.50ch08:44809859-44810351","90","44809859","44810351","492","1549.65308533","0.317490414247"
"SL2.50ch08:46708959-46710564","1428","46708959","46710564","1605","1549.65308533","1.03571568062"
"SL2.50ch08:46709566-46710369","1324","46709566","46710369","803","1549.65308533","0.518180493172"
"SL2.50ch08:46782997-46783372","71","46782997","46783372","375","1549.65308533","0.241989645006"
"SL2.50ch08:46873921-46876100","337","46873921","46876100","2179","1549.65308533","1.40612116391"
"SL2.50ch08:46950792-46951507","158","46950792","46951507","715","1549.65308533","0.461393589811"
"SL2.50ch08:46953229-46956365","63502","46953229","46956365","3136","1549.65308533","2.02367873797"
"SL2.50ch08:46953323-46955990","63121","46953323","46955990","2667","1549.65308533","1.72103035528"
"SL2.50ch08:48239737-48240989","1515","48239737","48240989","1252","1549.65308533","0.807922761459"
"SL2.50ch08:48578587-48579189","139","48578587","48579189","602","1549.65308533","0.388474043449"
"SL2.50ch08:50477166-50478169","223","50477166","50478169","1003","1549.65308533","0.647241637175"
"SL2.50ch08:51015740-51016115","94","51015740","51016115","375","1549.65308533","0.241989645006"
"SL2.50ch08:51242868-51243343","103","51242868","51243343","475","1549.65308533","0.306520217007"
"SL2.50ch08:51743941-51744529","3758","51743941","51744529","588","1549.65308533","0.379439763369"
"SL2.50ch08:5419972-5420932","110","5419972","5420932","960","1549.65308533","0.619493491214"
"SL2.50ch08:54478506-54479094","3447","54478506","54479094","588","1549.65308533","0.379439763369"
"SL2.50ch08:54824004-54824605","235","54824004","54824605","601","1549.65308533","0.387828737729"
"SL2.50ch08:54992791-54994630","375","54992791","54994630","1839","1549.65308533","1.18671721911"
"SL2.50ch08:54992936-54994168","256","54992936","54994168","1232","1549.65308533","0.795016647059"
"SL2.50ch08:57456514-57456878","1053","57456514","57456878","364","1549.65308533","0.234891282085"
"SL2.50ch08:5746546-5747235","163","5746546","5747235","689","1549.65308533","0.44461564109"
"SL2.50ch08:57484981-57486206","4782","57484981","57486206","1225","1549.65308533","0.790499507018"
"SL2.50ch08:57485406-57486324","4722","57485406","57486324","918","1549.65308533","0.592390650974"
"SL2.50ch08:57859884-57863473","951","57859884","57863473","3589","1549.65308533","2.31600222913"
"SL2.50ch08:60629063-60629911","350","60629063","60629911","848","1549.65308533","0.547219250573"
"SL2.50ch08:6345911-6346468","125","6345911","6346468","557","1549.65308533","0.359435286048"
"SL2.50ch08:63628760-63629740","214","63628760","63629740","980","1549.65308533","0.632399605615"
"SL2.50ch08:6502019-6502394","86","6502019","6502394","375","1549.65308533","0.241989645006"
"SL2.50ch08:65066031-65066691","231","65066031","65066691","660","1549.65308533","0.42590177521"
"SL2.50ch08:65133266-65133734","233","65133266","65133734","468","1549.65308533","0.302003076967"
"SL2.50ch08:65133303-65133667","221","65133303","65133667","364","1549.65308533","0.234891282085"
"SL2.50ch08:65160430-65161335","174","65160430","65161335","905","1549.65308533","0.584001676614"
"SL2.50ch08:6548251-6548839","4535","6548251","6548839","588","1549.65308533","0.379439763369"
"SL2.50ch08:6548271-6548931","4543","6548271","6548931","660","1549.65308533","0.42590177521"
"SL2.50ch08:65731792-65734597","590","65731792","65734597","2805","1549.65308533","1.81008254464"
"SL2.50ch08:7035399-7036137","511","7035399","7036137","738","1549.65308533","0.476235621371"
"SL2.50ch08:7035438-7036053","509","7035438","7036053","615","1549.65308533","0.396863017809"
"SL2.50ch08:7130693-7131166","98","7130693","7131166","473","1549.65308533","0.305229605567"
"SL2.50ch08:8130598-8131124","113","8130598","8131124","526","1549.65308533","0.339430808728"
"SL2.50ch08:8702609-8703998","317","8702609","8703998","1389","1549.65308533","0.896329645101"
"SL2.50ch08:9019480-9019855","88","9019480","9019855","375","1549.65308533","0.241989645006"
"SL2.50ch08:9361556-9364116","489","9361556","9364116","2560","1549.65308533","1.65198264324"
"SL2.50ch08:9427529-9431458","736","9427529","9431458","3929","1549.65308533","2.53540617394"
"SL2.50ch08:9436310-9437747","260","9436310","9437747","1437","1549.65308533","0.927304319662"
"SL2.50ch08:9455858-9456233","74","9455858","9456233","375","1549.65308533","0.241989645006"
"SL2.50ch08:9460721-9462248","263","9460721","9462248","1527","1549.65308533","0.985381834463"
"SL2.50ch08:9465618-9467091","473","9465618","9467091","1473","1549.65308533","0.950535325582"
"SL2.50ch08:9466112-9467078","312","9466112","9467078","966","1549.65308533","0.623365325535"
"SL2.50ch08:9985689-9986330","526","9985689","9986330","641","1549.65308533","0.41364096653"
"SL2.50ch08:9985729-9986390","526","9985729","9986390","661","1549.65308533","0.42654708093"
"SL2.50ch08:9987900-9990327","2160","9987900","9990327","2427","1549.65308533","1.56615698248"
"SL2.50ch08:9987993-9990336","2120","9987993","9990336","2343","1549.65308533","1.511951302"
"SL2.50ch08:9993036-9995912","2500","9993036","9995912","2876","1549.65308533","1.85589925076"
"SL2.50ch08:9993066-9995930","2500","9993066","9995930","2864","1549.65308533","1.84815558212"
"SL2.50ch09:10913610-10913985","84","10913610","10913985","375","1549.65308533","0.241989645006"
"SL2.50ch09:11297426-11301539","16933","11297426","11301539","4113","1549.65308533","2.65414242642"
"SL2.50ch09:11297433-11301505","16933","11297433","11301505","4072","1549.65308533","2.6276848919"
"SL2.50ch09:11302156-11304215","8244","11302156","11304215","2059","1549.65308533","1.32868447751"
"SL2.50ch09:11302374-11304283","8243","11302374","11304283","1909","1549.65308533","1.23188861951"
"SL2.50ch09:11306583-11308316","5609","11306583","11308316","1733","1549.65308533","1.11831481279"
"SL2.50ch09:11306703-11308280","5570","11306703","11308280","1577","1549.65308533","1.01764712046"
"SL2.50ch09:11310073-11314098","7971","11310073","11314098","4025","1549.65308533","2.59735552306"
"SL2.50ch09:11310161-11312108","7390","11310161","11312108","1947","1549.65308533","1.25641023687"
"SL2.50ch09:11575480-11576351","160","11575480","11576351","871","1549.65308533","0.562061282133"
"SL2.50ch09:12099517-12100172","113","12099517","12100172","655","1549.65308533","0.42267524661"
"SL2.50ch09:12786329-12786968","146","12786329","12786968","639","1549.65308533","0.41235035509"
"SL2.50ch09:12883847-12884332","104","12883847","12884332","485","1549.65308533","0.312973274207"
"SL2.50ch09:13687828-13688416","1476","13687828","13688416","588","1549.65308533","0.379439763369"
"SL2.50ch09:14455145-14456119","189","14455145","14456119","974","1549.65308533","0.628527771295"
"SL2.50ch09:15203638-15204013","81","15203638","15204013","375","1549.65308533","0.241989645006"
"SL2.50ch09:1555849-1556419","362","1555849","1556419","570","1549.65308533","0.367824260409"
"SL2.50ch09:1555858-1556446","363","1555858","1556446","588","1549.65308533","0.379439763369"
"SL2.50ch09:16779793-16780722","203","16779793","16780722","929","1549.65308533","0.599489013894"
"SL2.50ch09:16784081-16785298","241","16784081","16785298","1217","1549.65308533","0.785337061258"
"SL2.50ch09:17834934-17835451","115","17834934","17835451","517","1549.65308533","0.333623057248"
"SL2.50ch09:18467595-18469417","526","18467595","18469417","1822","1549.65308533","1.17574702187"
"SL2.50ch09:18938790-18939378","1085","18938790","18939378","588","1549.65308533","0.379439763369"
"SL2.50ch09:19183208-19183583","74","19183208","19183583","375","1549.65308533","0.241989645006"
"SL2.50ch09:20902832-20903304","87","20902832","20903304","472","1549.65308533","0.304584299847"
"SL2.50ch09:21073066-21073441","75","21073066","21073441","375","1549.65308533","0.241989645006"
"SL2.50ch09:21620518-21621122","163","21620518","21621122","604","1549.65308533","0.389764654889"
"SL2.50ch09:22012360-22012948","148","22012360","22012948","588","1549.65308533","0.379439763369"
"SL2.50ch09:22141916-22142778","168","22141916","22142778","862","1549.65308533","0.556253530653"
"SL2.50ch09:23494719-23495226","106","23494719","23495226","507","1549.65308533","0.327170000048"
"SL2.50ch09:2437018-2437642","4014","2437018","2437642","624","1549.65308533","0.402670769289"
"SL2.50ch09:2437079-2437650","4011","2437079","2437650","571","1549.65308533","0.368469566129"
"SL2.50ch09:24474503-24475414","2665","24474503","24475414","911","1549.65308533","0.587873510934"
"SL2.50ch09:24474541-24475334","2661","24474541","24475334","793","1549.65308533","0.511727435972"
"SL2.50ch09:25552558-25553171","142","25552558","25553171","613","1549.65308533","0.395572406369"
"SL2.50ch09:25887216-25887696","350","25887216","25887696","480","1549.65308533","0.309746745607"
"SL2.50ch09:25887297-25887661","344","25887297","25887661","364","1549.65308533","0.234891282085"
"SL2.50ch09:27249298-27250497","172","27249298","27250497","1199","1549.65308533","0.773721558298"
"SL2.50ch09:27730679-27731464","187","27730679","27731464","785","1549.65308533","0.506564990212"
"SL2.50ch09:27733037-27733692","438","27733037","27733692","655","1549.65308533","0.42267524661"
"SL2.50ch09:27891051-27891426","83","27891051","27891426","375","1549.65308533","0.241989645006"
"SL2.50ch09:28285369-28285744","86","28285369","28285744","375","1549.65308533","0.241989645006"
"SL2.50ch09:28762960-28763600","113","28762960","28763600","640","1549.65308533","0.41299566081"
"SL2.50ch09:28838378-28838972","109","28838378","28838972","594","1549.65308533","0.383311597689"
"SL2.50ch09:28987986-28988586","121","28987986","28988586","600","1549.65308533","0.387183432009"
"SL2.50ch09:29282249-29282761","110","29282249","29282761","512","1549.65308533","0.330396528648"
"SL2.50ch09:29455461-29456594","180","29455461","29456594","1133","1549.65308533","0.731131380777"
"SL2.50ch09:29741821-29742409","1890","29741821","29742409","588","1549.65308533","0.379439763369"
"SL2.50ch09:29757793-29758168","83","29757793","29758168","375","1549.65308533","0.241989645006"
"SL2.50ch09:29912063-29912915","163","29912063","29912915","852","1549.65308533","0.549800473453"
"SL2.50ch09:29954305-29954866","143","29954305","29954866","561","1549.65308533","0.362016508928"
"SL2.50ch09:30236488-30236968","99","30236488","30236968","480","1549.65308533","0.309746745607"
"SL2.50ch09:33570958-33572285","241","33570958","33572285","1327","1549.65308533","0.85632069046"
"SL2.50ch09:34125225-34126397","240","34125225","34126397","1172","1549.65308533","0.756298303858"
"SL2.50ch09:34702464-34702969","97","34702464","34702969","505","1549.65308533","0.325879388608"
"SL2.50ch09:34844549-34845493","183","34844549","34845493","944","1549.65308533","0.609168599694"
"SL2.50ch09:34860382-34860983","144","34860382","34860983","601","1549.65308533","0.387828737729"
"SL2.50ch09:34987011-34988002","162","34987011","34988002","991","1549.65308533","0.639497968535"
"SL2.50ch09:35168289-35168779","109","35168289","35168779","490","1549.65308533","0.316199802807"
"SL2.50ch09:35300602-35302548","8827","35300602","35302548","1946","1549.65308533","1.25576493115"
"SL2.50ch09:35300754-35302578","8809","35300754","35302578","1824","1549.65308533","1.17703763331"
"SL2.50ch09:35303351-35308999","17510","35303351","35308999","5648","1549.65308533","3.64468670665"
"SL2.50ch09:35303445-35305407","8558","35303445","35305407","1962","1549.65308533","1.26608982267"
"SL2.50ch09:35306232-35308687","8611","35306232","35308687","2455","1549.65308533","1.58422554264"
"SL2.50ch09:37196994-37197835","169","37196994","37197835","841","1549.65308533","0.542702110533"
"SL2.50ch09:37216149-37217048","165","37216149","37217048","899","1549.65308533","0.580129842294"
"SL2.50ch09:37249312-37249946","133","37249312","37249946","634","1549.65308533","0.40912382649"
"SL2.50ch09:37475320-37476676","249","37475320","37476676","1356","1549.65308533","0.87503455634"
"SL2.50ch09:37523057-37523715","756","37523057","37523715","658","1549.65308533","0.42461116377"
"SL2.50ch09:37523263-37523627","702","37523263","37523627","364","1549.65308533","0.234891282085"
"SL2.50ch09:3848301-3852522","922","3848301","3852522","4221","1549.65308533","2.72383544418"
"SL2.50ch09:38513258-38514429","196","38513258","38514429","1171","1549.65308533","0.755652998138"
"SL2.50ch09:40279709-40281584","46272","40279709","40281584","1875","1549.65308533","1.20994822503"
"SL2.50ch09:40280059-40281540","46199","40280059","40281540","1481","1549.65308533","0.955697771342"
"SL2.50ch09:40552759-40553134","78","40552759","40553134","375","1549.65308533","0.241989645006"
"SL2.50ch09:40947150-40948005","288","40947150","40948005","855","1549.65308533","0.551736390613"
"SL2.50ch09:41484055-41484889","164","41484055","41484889","834","1549.65308533","0.538184970493"
"SL2.50ch09:4209581-4210169","2477","4209581","4210169","588","1549.65308533","0.379439763369"
"SL2.50ch09:42326378-42326753","75","42326378","42326753","375","1549.65308533","0.241989645006"
"SL2.50ch09:42545887-42546262","71","42545887","42546262","375","1549.65308533","0.241989645006"
"SL2.50ch09:43426394-43426930","101","43426394","43426930","536","1549.65308533","0.345883865928"
"SL2.50ch09:43698962-43699337","76","43698962","43699337","375","1549.65308533","0.241989645006"
"SL2.50ch09:44219804-44220533","164","44219804","44220533","729","1549.65308533","0.470427869891"
"SL2.50ch09:45397067-45398140","3299","45397067","45398140","1073","1549.65308533","0.692413037576"
"SL2.50ch09:45397097-45398282","3300","45397097","45398282","1185","1549.65308533","0.764687278218"
"SL2.50ch09:45408056-45408524","102","45408056","45408524","468","1549.65308533","0.302003076967"
"SL2.50ch09:45873708-45874276","127","45873708","45874276","568","1549.65308533","0.366533648969"
"SL2.50ch09:45954908-45955894","191","45954908","45955894","986","1549.65308533","0.636271439935"
"SL2.50ch09:45983903-45985557","260","45983903","45985557","1654","1549.65308533","1.0673356609"
"SL2.50ch09:46155173-46155548","72","46155173","46155548","375","1549.65308533","0.241989645006"
"SL2.50ch09:46262538-46263493","30609","46262538","46263493","955","1549.65308533","0.616266962614"
"SL2.50ch09:46262544-46263390","30587","46262544","46263390","846","1549.65308533","0.545928639133"
"SL2.50ch09:46321036-46321411","85","46321036","46321411","375","1549.65308533","0.241989645006"
"SL2.50ch09:46513407-46513782","102","46513407","46513782","375","1549.65308533","0.241989645006"
"SL2.50ch09:46933685-46934274","124","46933685","46934274","589","1549.65308533","0.380085069089"
"SL2.50ch09:47142074-47142625","128","47142074","47142625","551","1549.65308533","0.355563451728"
"SL2.50ch09:47738019-47738394","77","47738019","47738394","375","1549.65308533","0.241989645006"
"SL2.50ch09:48423702-48424298","118","48423702","48424298","596","1549.65308533","0.384602209129"
"SL2.50ch09:49050495-49050990","91","49050495","49050990","495","1549.65308533","0.319426331407"
"SL2.50ch09:49471027-49473562","566","49471027","49473562","2535","1549.65308533","1.63585000024"
"SL2.50ch09:50420333-50420882","101","50420333","50420882","549","1549.65308533","0.354272840288"
"SL2.50ch09:50745497-50746146","581","50745497","50746146","649","1549.65308533","0.41880341229"
"SL2.50ch09:50745754-50746118","546","50745754","50746118","364","1549.65308533","0.234891282085"
"SL2.50ch09:51275962-51276550","2059","51275962","51276550","588","1549.65308533","0.379439763369"
"SL2.50ch09:51344045-51344420","74","51344045","51344420","375","1549.65308533","0.241989645006"
"SL2.50ch09:51595983-51596497","99","51595983","51596497","514","1549.65308533","0.331687140088"
"SL2.50ch09:51905531-51905906","78","51905531","51905906","375","1549.65308533","0.241989645006"
"SL2.50ch09:53088338-53091071","9424","53088338","53091071","2733","1549.65308533","1.7636205328"
"SL2.50ch09:53088641-53090633","9340","53088641","53090633","1992","1549.65308533","1.28544899427"
"SL2.50ch09:53828985-53829972","182","53828985","53829972","987","1549.65308533","0.636916745655"
"SL2.50ch09:54057403-54057882","95","54057403","54057882","479","1549.65308533","0.309101439887"
"SL2.50ch09:54977951-54978315","1248","54977951","54978315","364","1549.65308533","0.234891282085"
"SL2.50ch09:55002502-55003120","130","55002502","55003120","618","1549.65308533","0.398798934969"
"SL2.50ch09:55027668-55028256","2405","55027668","55028256","588","1549.65308533","0.379439763369"
"SL2.50ch09:55543055-55543527","76","55543055","55543527","472","1549.65308533","0.304584299847"
"SL2.50ch09:58045759-58046663","172","58045759","58046663","904","1549.65308533","0.583356370894"
"SL2.50ch09:58157621-58158308","119","58157621","58158308","687","1549.65308533","0.44332502965"
"SL2.50ch09:58182606-58182981","92","58182606","58182981","375","1549.65308533","0.241989645006"
"SL2.50ch09:58995412-58997131","14850","58995412","58997131","1719","1549.65308533","1.10928053271"
"SL2.50ch09:58995673-58996829","14735","58995673","58996829","1156","1549.65308533","0.745973412337"
"SL2.50ch09:60656705-60657375","1183","60656705","60657375","670","1549.65308533","0.43235483241"
"SL2.50ch09:60656772-60657385","1176","60656772","60657385","613","1549.65308533","0.395572406369"
"SL2.50ch09:61857396-61858161","18671","61857396","61858161","765","1549.65308533","0.493658875812"
"SL2.50ch09:61857461-61858227","18663","61857461","61858227","766","1549.65308533","0.494304181532"
"SL2.50ch09:62110564-62111152","2349","62110564","62111152","588","1549.65308533","0.379439763369"
"SL2.50ch09:63666478-63667066","2947","63666478","63667066","588","1549.65308533","0.379439763369"
"SL2.50ch09:63970820-63971408","14527","63970820","63971408","588","1549.65308533","0.379439763369"
"SL2.50ch09:63970859-63971481","14531","63970859","63971481","622","1549.65308533","0.401380157849"
"SL2.50ch09:63993740-63994328","1390","63993740","63994328","588","1549.65308533","0.379439763369"
"SL2.50ch09:64935402-64937389","640","64935402","64937389","1987","1549.65308533","1.28222246567"
"SL2.50ch09:64935722-64937123","529","64935722","64937123","1401","1549.65308533","0.904073313741"
"SL2.50ch09:65535060-65535648","413","65535060","65535648","588","1549.65308533","0.379439763369"
"SL2.50ch09:67002207-67003115","297","67002207","67003115","908","1549.65308533","0.585937593774"
"SL2.50ch09:67762875-67763250","74","67762875","67763250","375","1549.65308533","0.241989645006"
"SL2.50ch09:6789992-6791557","1543","6789992","6791557","1565","1549.65308533","1.00990345182"
"SL2.50ch09:6790016-6791316","1521","6790016","6791316","1300","1549.65308533","0.83889743602"
"SL2.50ch09:68837167-68838375","335","68837167","68838375","1208","1549.65308533","0.779529309778"
"SL2.50ch09:68837401-68837989","237","68837401","68837989","588","1549.65308533","0.379439763369"
"SL2.50ch09:70696416-70697033","1890","70696416","70697033","617","1549.65308533","0.398153629249"
"SL2.50ch09:70696467-70697055","1890","70696467","70697055","588","1549.65308533","0.379439763369"
"SL2.50ch09:71682972-71683347","73","71682972","71683347","375","1549.65308533","0.241989645006"
"SL2.50ch09:7384132-7384605","219","7384132","7384605","473","1549.65308533","0.305229605567"
"SL2.50ch09:8067272-8067647","140","8067272","8067647","375","1549.65308533","0.241989645006"
"SL2.50ch09:8532278-8533253","317","8532278","8533253","975","1549.65308533","0.629173077015"
"SL2.50ch09:8786424-8786799","265","8786424","8786799","375","1549.65308533","0.241989645006"
"SL2.50ch10:1-561","362","1","561","560","1549.65308533","0.361371203208"
"SL2.50ch10:10731514-10732335","1197","10731514","10732335","821","1549.65308533","0.529795996132"
"SL2.50ch10:10731626-10732406","1202","10731626","10732406","780","1549.65308533","0.503338461612"
"SL2.50ch10:10733544-10734282","633","10733544","10734282","738","1549.65308533","0.476235621371"
"SL2.50ch10:10734965-10735553","920","10734965","10735553","588","1549.65308533","0.379439763369"
"SL2.50ch10:11251550-11252004","394","11251550","11252004","454","1549.65308533","0.292968796887"
"SL2.50ch10:11654073-11654599","107","11654073","11654599","526","1549.65308533","0.339430808728"
"SL2.50ch10:11687652-11689381","372","11687652","11689381","1729","1549.65308533","1.11573358991"
"SL2.50ch10:12559557-12560236","134","12559557","12560236","679","1549.65308533","0.43816258389"
"SL2.50ch10:13106178-13107086","162","13106178","13107086","908","1549.65308533","0.585937593774"
"SL2.50ch10:13112693-13113212","122","13112693","13113212","519","1549.65308533","0.334913668688"
"SL2.50ch10:14078179-14078554","85","14078179","14078554","375","1549.65308533","0.241989645006"
"SL2.50ch10:14203407-14204871","280","14203407","14204871","1464","1549.65308533","0.944727574102"
"SL2.50ch10:14222028-14222403","100","14222028","14222403","375","1549.65308533","0.241989645006"
"SL2.50ch10:14253242-14253617","70","14253242","14253617","375","1549.65308533","0.241989645006"
"SL2.50ch10:14308409-14308963","111","14308409","14308963","554","1549.65308533","0.357499368888"
"SL2.50ch10:14396595-14397204","116","14396595","14397204","609","1549.65308533","0.392991183489"
"SL2.50ch10:14724591-14726784","442","14724591","14726784","2193","1549.65308533","1.41515544399"
"SL2.50ch10:15241379-15242845","55831","15241379","15242845","1466","1549.65308533","0.946018185542"
"SL2.50ch10:15241393-15242901","55829","15241393","15242901","1508","1549.65308533","0.973121025783"
"SL2.50ch10:15272405-15273237","258","15272405","15273237","832","1549.65308533","0.536894359053"
"SL2.50ch10:15372211-15372855","115","15372211","15372855","644","1549.65308533","0.41557688369"
"SL2.50ch10:15650527-15651102","124","15650527","15651102","575","1549.65308533","0.371050789009"
"SL2.50ch10:15654170-15654545","78","15654170","15654545","375","1549.65308533","0.241989645006"
"SL2.50ch10:15721784-15725257","673","15721784","15725257","3473","1549.65308533","2.24114676561"
"SL2.50ch10:15742129-15745008","695","15742129","15745008","2879","1549.65308533","1.85783516792"
"SL2.50ch10:15782402-15786109","788","15782402","15786109","3707","1549.65308533","2.3921483041"
"SL2.50ch10:15874568-15875171","135","15874568","15875171","603","1549.65308533","0.389119349169"
"SL2.50ch10:15949441-15949909","86","15949441","15949909","468","1549.65308533","0.302003076967"
"SL2.50ch10:16275581-16276262","124","16275581","16276262","681","1549.65308533","0.43945319533"
"SL2.50ch10:16338716-16339287","124","16338716","16339287","571","1549.65308533","0.368469566129"
"SL2.50ch10:16372227-16372851","117","16372227","16372851","624","1549.65308533","0.402670769289"
"SL2.50ch10:16378991-16379660","136","16378991","16379660","669","1549.65308533","0.43170952669"
"SL2.50ch10:16717479-16717854","73","16717479","16717854","375","1549.65308533","0.241989645006"
"SL2.50ch10:16939078-16940016","163","16939078","16940016","938","1549.65308533","0.605296765374"
"SL2.50ch10:18-641","362","18","641","623","1549.65308533","0.402025463569"
"SL2.50ch10:18054873-18056070","207","18054873","18056070","1197","1549.65308533","0.772430946858"
"SL2.50ch10:18417510-18421836","1972","18417510","18421836","4326","1549.65308533","2.79159254479"
"SL2.50ch10:18418264-18420296","1463","18418264","18420296","2032","1549.65308533","1.31126122307"
"SL2.50ch10:18762956-18763614","1338","18762956","18763614","658","1549.65308533","0.42461116377"
"SL2.50ch10:19088893-19089504","112","19088893","19089504","611","1549.65308533","0.394281794929"
"SL2.50ch10:19334782-19335157","74","19334782","19335157","375","1549.65308533","0.241989645006"
"SL2.50ch10:19988231-19988804","105","19988231","19988804","573","1549.65308533","0.369760177569"
"SL2.50ch10:20007176-20007918","136","20007176","20007918","742","1549.65308533","0.478816844251"
"SL2.50ch10:20194133-20195111","185","20194133","20195111","978","1549.65308533","0.631108994175"
"SL2.50ch10:20311622-20312105","99","20311622","20312105","483","1549.65308533","0.311682662767"
"SL2.50ch10:20635803-20636178","69","20635803","20636178","375","1549.65308533","0.241989645006"
"SL2.50ch10:21219967-21221128","285","21219967","21221128","1161","1549.65308533","0.749199940937"
"SL2.50ch10:21225499-21228599","777","21225499","21228599","3100","1549.65308533","2.00044773205"
"SL2.50ch10:21231545-21232691","243","21231545","21232691","1146","1549.65308533","0.739520355137"
"SL2.50ch10:21236001-21237691","356","21236001","21237691","1690","1549.65308533","1.09056666683"
"SL2.50ch10:21247088-21247972","427","21247088","21247972","884","1549.65308533","0.570450256493"
"SL2.50ch10:21250900-21251570","157","21250900","21251570","670","1549.65308533","0.43235483241"
"SL2.50ch10:22463026-22463762","1485","22463026","22463762","736","1549.65308533","0.474945009931"
"SL2.50ch10:22665297-22665974","593","22665297","22665974","677","1549.65308533","0.43687197245"
"SL2.50ch10:22665331-22665919","578","22665331","22665919","588","1549.65308533","0.379439763369"
"SL2.50ch10:23945591-23946046","551","23945591","23946046","455","1549.65308533","0.293614102607"
"SL2.50ch10:23948704-23949277","297","23948704","23949277","573","1549.65308533","0.369760177569"
"SL2.50ch10:23972110-23972485","71","23972110","23972485","375","1549.65308533","0.241989645006"
"SL2.50ch10:24143571-24146441","916","24143571","24146441","2870","1549.65308533","1.85202741644"
"SL2.50ch10:24144642-24145306","427","24144642","24145306","664","1549.65308533","0.42848299809"
"SL2.50ch10:24474490-24474865","65","24474490","24474865","375","1549.65308533","0.241989645006"
"SL2.50ch10:24813287-24813755","93","24813287","24813755","468","1549.65308533","0.302003076967"
"SL2.50ch10:25679622-25680204","124","25679622","25680204","582","1549.65308533","0.375567929049"
"SL2.50ch10:25715786-25716490","163","25715786","25716490","704","1549.65308533","0.454295226891"
"SL2.50ch10:25777441-25778180","6189","25777441","25778180","739","1549.65308533","0.476880927091"
"SL2.50ch10:26348586-26357575","2736","26348586","26357575","8989","1549.65308533","5.80065311722"
"SL2.50ch10:26354543-26356438","672","26354543","26356438","1895","1549.65308533","1.22285433943"
"SL2.50ch10:26364134-26365086","228","26364134","26365086","952","1549.65308533","0.614331045454"
"SL2.50ch10:26365611-26366196","181","26365611","26366196","585","1549.65308533","0.377503846209"
"SL2.50ch10:26371425-26374710","1000","26371425","26374710","3285","1549.65308533","2.11982929025"
"SL2.50ch10:26801238-26804011","28614","26801238","26804011","2773","1549.65308533","1.7894327616"
"SL2.50ch10:26801355-26803845","28591","26801355","26803845","2490","1549.65308533","1.60681124284"
"SL2.50ch10:26805655-26806686","8846","26805655","26806686","1031","1549.65308533","0.665310197336"
"SL2.50ch10:26805743-26806634","8752","26805743","26806634","891","1549.65308533","0.574967396533"
"SL2.50ch10:26986697-26987165","100","26986697","26987165","468","1549.65308533","0.302003076967"
"SL2.50ch10:27367898-27368486","6647","27367898","27368486","588","1549.65308533","0.379439763369"
"SL2.50ch10:2743641-2744118","165","2743641","2744118","477","1549.65308533","0.307810828447"
"SL2.50ch10:28171694-28172069","73","28171694","28172069","375","1549.65308533","0.241989645006"
"SL2.50ch10:28297575-28299380","691","28297575","28299380","1805","1549.65308533","1.16477682463"
"SL2.50ch10:28298175-28299271","577","28298175","28299271","1096","1549.65308533","0.707255069136"
"SL2.50ch10:28300252-28300840","268","28300252","28300840","588","1549.65308533","0.379439763369"
"SL2.50ch10:28333936-28334311","102","28333936","28334311","375","1549.65308533","0.241989645006"
"SL2.50ch10:28974325-28975005","127","28974325","28975005","680","1549.65308533","0.43880788961"
"SL2.50ch10:29736412-29737191","159","29736412","29737191","779","1549.65308533","0.502693155892"
"SL2.50ch10:30176407-30176937","108","30176407","30176937","530","1549.65308533","0.342012031608"
"SL2.50ch10:30262764-30263256","104","30262764","30263256","492","1549.65308533","0.317490414247"
"SL2.50ch10:30914447-30915421","164","30914447","30915421","974","1549.65308533","0.628527771295"
"SL2.50ch10:3100835-3101429","812","3100835","3101429","594","1549.65308533","0.383311597689"
"SL2.50ch10:3100924-3101393","811","3100924","3101393","469","1549.65308533","0.302648382687"
"SL2.50ch10:31221287-31221662","80","31221287","31221662","375","1549.65308533","0.241989645006"
"SL2.50ch10:31948568-31949336","173","31948568","31949336","768","1549.65308533","0.495594792972"
"SL2.50ch10:32243555-32244036","100","32243555","32244036","481","1549.65308533","0.310392051327"
"SL2.50ch10:32274552-32275126","103","32274552","32275126","574","1549.65308533","0.370405483289"
"SL2.50ch10:32295418-32296388","234","32295418","32296388","970","1549.65308533","0.625946548415"
"SL2.50ch10:32297514-32298129","132","32297514","32298129","615","1549.65308533","0.396863017809"
"SL2.50ch10:32437159-32437832","128","32437159","32437832","673","1549.65308533","0.43429074957"
"SL2.50ch10:33582526-33582901","80","33582526","33582901","375","1549.65308533","0.241989645006"
"SL2.50ch10:3515329-3517677","435","3515329","3517677","2348","1549.65308533","1.5151778306"
"SL2.50ch10:35324569-35324944","81","35324569","35324944","375","1549.65308533","0.241989645006"
"SL2.50ch10:35971426-35971801","67","35971426","35971801","375","1549.65308533","0.241989645006"
"SL2.50ch10:36492781-36493290","107","36492781","36493290","509","1549.65308533","0.328460611488"
"SL2.50ch10:36675059-36675434","100","36675059","36675434","375","1549.65308533","0.241989645006"
"SL2.50ch10:36684403-36685197","596","36684403","36685197","794","1549.65308533","0.512372741692"
"SL2.50ch10:36684467-36685379","619","36684467","36685379","912","1549.65308533","0.588518816654"
"SL2.50ch10:36692808-36693396","358","36692808","36693396","588","1549.65308533","0.379439763369"
"SL2.50ch10:37171249-37171837","4387","37171249","37171837","588","1549.65308533","0.379439763369"
"SL2.50ch10:37171355-37171823","4380","37171355","37171823","468","1549.65308533","0.302003076967"
"SL2.50ch10:37566299-37566866","95","37566299","37566866","567","1549.65308533","0.365888343249"
"SL2.50ch10:3773789-3775431","356","3773789","3775431","1642","1549.65308533","1.05959199226"
"SL2.50ch10:38097493-38098081","152","38097493","38098081","588","1549.65308533","0.379439763369"
"SL2.50ch10:38100516-38105622","1140","38100516","38105622","5106","1549.65308533","3.2949310064"
"SL2.50ch10:3824639-3826206","440","3824639","3826206","1567","1549.65308533","1.01119406326"
"SL2.50ch10:38517930-38518836","283","38517930","38518836","906","1549.65308533","0.584646982334"
"SL2.50ch10:39018123-39019090","1125","39018123","39019090","967","1549.65308533","0.624010631255"
"SL2.50ch10:39018233-39019133","1122","39018233","39019133","900","1549.65308533","0.580775148014"
"SL2.50ch10:39505430-39506103","5545","39505430","39506103","673","1549.65308533","0.43429074957"
"SL2.50ch10:39505451-39506051","5535","39505451","39506051","600","1549.65308533","0.387183432009"
"SL2.50ch10:39802143-39802518","82","39802143","39802518","375","1549.65308533","0.241989645006"
"SL2.50ch10:40795268-40797366","13171","40795268","40797366","2098","1549.65308533","1.35385140059"
"SL2.50ch10:40798386-40800263","26523","40798386","40800263","1877","1549.65308533","1.21123883647"
"SL2.50ch10:40803643-40804231","3307","40803643","40804231","588","1549.65308533","0.379439763369"
"SL2.50ch10:40803669-40804328","3320","40803669","40804328","659","1549.65308533","0.42525646949"
"SL2.50ch10:41437753-41438226","187","41437753","41438226","473","1549.65308533","0.305229605567"
"SL2.50ch10:41646804-41647392","1144","41646804","41647392","588","1549.65308533","0.379439763369"
"SL2.50ch10:42461031-42462032","230","42461031","42462032","1001","1549.65308533","0.645951025735"
"SL2.50ch10:43054283-43060735","2511","43054283","43060735","6452","1549.65308533","4.16351250554"
"SL2.50ch10:43055128-43058499","1860","43055128","43058499","3371","1549.65308533","2.17532558217"
"SL2.50ch10:43059738-43060293","178","43059738","43060293","555","1549.65308533","0.358144674608"
"SL2.50ch10:43880858-43882594","16269","43880858","43882594","1736","1549.65308533","1.12025072995"
"SL2.50ch10:43880858-43882626","16269","43880858","43882626","1768","1549.65308533","1.14090051299"
"SL2.50ch10:43884398-43885693","7637","43884398","43885693","1295","1549.65308533","0.835670907419"
"SL2.50ch10:43884501-43885746","7608","43884501","43885746","1245","1549.65308533","0.803405621419"
"SL2.50ch10:43886618-43888440","15696","43886618","43888440","1822","1549.65308533","1.17574702187"
"SL2.50ch10:43886621-43888360","15696","43886621","43888360","1739","1549.65308533","1.12218664711"
"SL2.50ch10:43892653-43893387","2798","43892653","43893387","734","1549.65308533","0.473654398491"
"SL2.50ch10:43892709-43893629","2847","43892709","43893629","920","1549.65308533","0.593681262414"
"SL2.50ch10:43989776-43990151","77","43989776","43990151","375","1549.65308533","0.241989645006"
"SL2.50ch10:45905444-45906338","5924","45905444","45906338","894","1549.65308533","0.576903313693"
"SL2.50ch10:45905625-45906385","5909","45905625","45906385","760","1549.65308533","0.490432347211"
"SL2.50ch10:46185706-46186727","261","46185706","46186727","1021","1549.65308533","0.658857140135"
"SL2.50ch10:46644232-46645002","171","46644232","46645002","770","1549.65308533","0.496885404412"
"SL2.50ch10:4700007-4700937","17725","4700007","4700937","930","1549.65308533","0.600134319614"
"SL2.50ch10:4700101-4700877","17725","4700101","4700877","776","1549.65308533","0.500757238732"
"SL2.50ch10:47369518-47369986","186","47369518","47369986","468","1549.65308533","0.302003076967"
"SL2.50ch10:47369558-47369922","178","47369558","47369922","364","1549.65308533","0.234891282085"
"SL2.50ch10:47373453-47373828","77","47373453","47373828","375","1549.65308533","0.241989645006"
"SL2.50ch10:47595708-47598356","753","47595708","47598356","2648","1549.65308533","1.7087695466"
"SL2.50ch10:47837605-47837980","73","47837605","47837980","375","1549.65308533","0.241989645006"
"SL2.50ch10:48488925-48489300","73","48488925","48489300","375","1549.65308533","0.241989645006"
"SL2.50ch10:48524291-48524655","1144","48524291","48524655","364","1549.65308533","0.234891282085"
"SL2.50ch10:48677438-48678027","114","48677438","48678027","589","1549.65308533","0.380085069089"
"SL2.50ch10:49149682-49150330","127","49149682","49150330","648","1549.65308533","0.41815810657"
"SL2.50ch10:50498192-50498674","104","50498192","50498674","482","1549.65308533","0.311037357047"
"SL2.50ch10:51068064-51068556","95","51068064","51068556","492","1549.65308533","0.317490414247"
"SL2.50ch10:51237020-51237865","168","51237020","51237865","845","1549.65308533","0.545283333413"
"SL2.50ch10:52342349-52342889","100","52342349","52342889","540","1549.65308533","0.348465088808"
"SL2.50ch10:53322753-53323341","6942","53322753","53323341","588","1549.65308533","0.379439763369"
"SL2.50ch10:53322775-53323337","6941","53322775","53323337","562","1549.65308533","0.362661814648"
"SL2.50ch10:53525611-53526274","1743","53525611","53526274","663","1549.65308533","0.42783769237"
"SL2.50ch10:54021908-54024602","616","54021908","54024602","2694","1549.65308533","1.73845360972"
"SL2.50ch10:54026726-54027542","198","54026726","54027542","816","1549.65308533","0.526569467532"
"SL2.50ch10:55347672-55348047","70","55347672","55348047","375","1549.65308533","0.241989645006"
"SL2.50ch10:57563929-57565882","533","57563929","57565882","1953","1549.65308533","1.26028207119"
"SL2.50ch10:57573299-57578498","1299","57573299","57578498","5199","1549.65308533","3.35494443836"
"SL2.50ch10:57574872-57575353","208","57574872","57575353","481","1549.65308533","0.310392051327"
"SL2.50ch10:57576314-57576678","129","57576314","57576678","364","1549.65308533","0.234891282085"
"SL2.50ch10:57584192-57584885","233","57584192","57584885","693","1549.65308533","0.44719686397"
"SL2.50ch10:57584403-57584862","200","57584403","57584862","459","1549.65308533","0.296195325487"
"SL2.50ch10:57587222-57588580","466","57587222","57588580","1358","1549.65308533","0.87632516778"
"SL2.50ch10:57587671-57588510","364","57587671","57588510","839","1549.65308533","0.541411499093"
"SL2.50ch10:57594315-57595299","378","57594315","57595299","984","1549.65308533","0.634980828495"
"SL2.50ch10:57594513-57595211","350","57594513","57595211","698","1549.65308533","0.450423392571"
"SL2.50ch10:57640786-57641698","396","57640786","57641698","912","1549.65308533","0.588518816654"
"SL2.50ch10:57647997-57648865","160","57647997","57648865","868","1549.65308533","0.560125364973"
"SL2.50ch10:57659371-57660338","550","57659371","57660338","967","1549.65308533","0.624010631255"
"SL2.50ch10:57663595-57664053","117","57663595","57664053","458","1549.65308533","0.295550019767"
"SL2.50ch10:57665050-57665414","193","57665050","57665414","364","1549.65308533","0.234891282085"
"SL2.50ch10:57686854-57687326","110","57686854","57687326","472","1549.65308533","0.304584299847"
"SL2.50ch10:57698042-57699159","389","57698042","57699159","1117","1549.65308533","0.720806489257"
"SL2.50ch10:57698219-57698809","304","57698219","57698809","590","1549.65308533","0.380730374809"
"SL2.50ch10:57700866-57702286","682","57700866","57702286","1420","1549.65308533","0.916334122421"
"SL2.50ch10:57701047-57702203","654","57701047","57702203","1156","1549.65308533","0.745973412337"
"SL2.50ch10:58041899-58042263","1477","58041899","58042263","364","1549.65308533","0.234891282085"
"SL2.50ch10:58689040-58689415","79","58689040","58689415","375","1549.65308533","0.241989645006"
"SL2.50ch10:59391562-59392485","172","59391562","59392485","923","1549.65308533","0.595617179574"
"SL2.50ch10:59458580-59458955","80","59458580","59458955","375","1549.65308533","0.241989645006"
"SL2.50ch10:60013538-60014033","100","60013538","60014033","495","1549.65308533","0.319426331407"
"SL2.50ch10:60632952-60633943","294","60632952","60633943","991","1549.65308533","0.639497968535"
"SL2.50ch10:61674621-61675556","221","61674621","61675556","935","1549.65308533","0.603360848214"
"SL2.50ch10:6175070-6186660","152278","6175070","6186660","11590","1549.65308533","7.47909329497"
"SL2.50ch10:6175126-6187761","156339","6175126","6187761","12635","1549.65308533","8.15343777239"
"SL2.50ch10:63001114-63001878","226","63001114","63001878","764","1549.65308533","0.493013570091"
"SL2.50ch10:65521191-65522972","579","65521191","65522972","1781","1549.65308533","1.14928948735"
"SL2.50ch10:65521376-65522112","279","65521376","65522112","736","1549.65308533","0.474945009931"
"SL2.50ch10:65523714-65525561","652","65523714","65525561","1847","1549.65308533","1.19187966487"
"SL2.50ch10:65523917-65525465","603","65523917","65525465","1548","1549.65308533","0.998933254583"
"SL2.50ch10:6980397-6981026","141","6980397","6981026","629","1549.65308533","0.405897297889"
"SL2.50ch10:7026656-7027031","90","7026656","7027031","375","1549.65308533","0.241989645006"
"SL2.50ch10:7372271-7372746","526","7372271","7372746","475","1549.65308533","0.306520217007"
"SL2.50ch10:7965182-7965557","71","7965182","7965557","375","1549.65308533","0.241989645006"
"SL2.50ch10:8853130-8853718","951","8853130","8853718","588","1549.65308533","0.379439763369"
"SL2.50ch10:9021080-9021444","550","9021080","9021444","364","1549.65308533","0.234891282085"
"SL2.50ch10:9939738-9940925","191","9939738","9940925","1187","1549.65308533","0.765977889658"
"SL2.50ch11:10861890-10862254","752","10861890","10862254","364","1549.65308533","0.234891282085"
"SL2.50ch11:11005906-11006652","153","11005906","11006652","746","1549.65308533","0.481398067131"
"SL2.50ch11:11070287-11070746","112","11070287","11070746","459","1549.65308533","0.296195325487"
"SL2.50ch11:11074284-11074751","261","11074284","11074751","467","1549.65308533","0.301357771247"
"SL2.50ch11:11091565-11093117","319","11091565","11093117","1552","1549.65308533","1.00151447746"
"SL2.50ch11:11288397-11288772","300","11288397","11288772","375","1549.65308533","0.241989645006"
"SL2.50ch11:11405368-11406109","157","11405368","11406109","741","1549.65308533","0.478171538531"
"SL2.50ch11:12015805-12016393","2755","12015805","12016393","588","1549.65308533","0.379439763369"
"SL2.50ch11:12456445-12457150","152","12456445","12457150","705","1549.65308533","0.454940532611"
"SL2.50ch11:13246325-13247072","157","13246325","13247072","747","1549.65308533","0.482043372851"
"SL2.50ch11:13364969-13367360","676","13364969","13367360","2391","1549.65308533","1.54292597656"
"SL2.50ch11:13366370-13367105","309","13366370","13367105","735","1549.65308533","0.474299704211"
"SL2.50ch11:13371699-13372835","442","13371699","13372835","1136","1549.65308533","0.733067297937"
"SL2.50ch11:13371992-13372580","356","13371992","13372580","588","1549.65308533","0.379439763369"
"SL2.50ch11:13374609-13375317","147","13374609","13375317","708","1549.65308533","0.456876449771"
"SL2.50ch11:13377232-13380988","60282","13377232","13380988","3756","1549.65308533","2.42376828438"
"SL2.50ch11:13377984-13380911","60203","13377984","13380911","2927","1549.65308533","1.88880984248"
"SL2.50ch11:13383716-13384927","13917","13383716","13384927","1211","1549.65308533","0.781465226938"
"SL2.50ch11:13383731-13385920","15311","13383731","13385920","2189","1549.65308533","1.41257422111"
"SL2.50ch11:13386656-13388410","36729","13386656","13388410","1754","1549.65308533","1.13186623291"
"SL2.50ch11:13386673-13388431","36729","13386673","13388431","1758","1549.65308533","1.13444745579"
"SL2.50ch11:13390239-13392190","47463","13390239","13392190","1951","1549.65308533","1.25899145975"
"SL2.50ch11:13390242-13392242","47456","13390242","13392242","2000","1549.65308533","1.29061144003"
"SL2.50ch11:13394613-13399961","100431","13394613","13399961","5348","1549.65308533","3.45109499064"
"SL2.50ch11:13394681-13400108","100431","13394681","13400108","5427","1549.65308533","3.50207414252"
"SL2.50ch11:13401124-13402067","2919","13401124","13402067","943","1549.65308533","0.608523293974"
"SL2.50ch11:13401178-13402107","2913","13401178","13402107","929","1549.65308533","0.599489013894"
"SL2.50ch11:14275764-14276772","199","14275764","14276772","1008","1549.65308533","0.650468165775"
"SL2.50ch11:14383436-14384024","557","14383436","14384024","588","1549.65308533","0.379439763369"
"SL2.50ch11:14418958-14419333","65","14418958","14419333","375","1549.65308533","0.241989645006"
"SL2.50ch11:15173369-15173957","215","15173369","15173957","588","1549.65308533","0.379439763369"
"SL2.50ch11:16103027-16104474","4403","16103027","16104474","1447","1549.65308533","0.933757376862"
"SL2.50ch11:16916961-16917908","172","16916961","16917908","947","1549.65308533","0.611104516854"
"SL2.50ch11:17210233-17210821","2771","17210233","17210821","588","1549.65308533","0.379439763369"
"SL2.50ch11:17210284-17210907","2777","17210284","17210907","623","1549.65308533","0.402025463569"
"SL2.50ch11:17769198-17769859","12008","17769198","17769859","661","1549.65308533","0.42654708093"
"SL2.50ch11:17769199-17769787","12004","17769199","17769787","588","1549.65308533","0.379439763369"
"SL2.50ch11:17832274-17833728","261","17832274","17833728","1454","1549.65308533","0.938274516902"
"SL2.50ch11:17850860-17851631","172","17850860","17851631","771","1549.65308533","0.497530710132"
"SL2.50ch11:17860974-17861795","923","17860974","17861795","821","1549.65308533","0.529795996132"
"SL2.50ch11:17898587-17899783","226","17898587","17899783","1196","1549.65308533","0.771785641138"
"SL2.50ch11:17940417-17941798","307","17940417","17941798","1381","1549.65308533","0.891167199341"
"SL2.50ch11:17948197-17948854","217","17948197","17948854","657","1549.65308533","0.42396585805"
"SL2.50ch11:17952477-17954993","704","17952477","17954993","2516","1549.65308533","1.62358919156"
"SL2.50ch11:17954572-17954936","160","17954572","17954936","364","1549.65308533","0.234891282085"
"SL2.50ch11:17956473-17956952","99","17956473","17956952","479","1549.65308533","0.309101439887"
"SL2.50ch11:17963181-17963661","113","17963181","17963661","480","1549.65308533","0.309746745607"
"SL2.50ch11:17984475-17985156","152","17984475","17985156","681","1549.65308533","0.43945319533"
"SL2.50ch11:17987922-17989520","396","17987922","17989520","1598","1549.65308533","1.03119854058"
"SL2.50ch11:17998450-17999889","474","17998450","17999889","1439","1549.65308533","0.928594931102"
"SL2.50ch11:17998453-18002543","1306","17998453","18002543","4090","1549.65308533","2.63930039486"
"SL2.50ch11:18000481-18002239","627","18000481","18002239","1758","1549.65308533","1.13444745579"
"SL2.50ch11:18006055-18006643","211","18006055","18006643","588","1549.65308533","0.379439763369"
"SL2.50ch11:18006123-18007075","300","18006123","18007075","952","1549.65308533","0.614331045454"
"SL2.50ch11:18015281-18019377","958","18015281","18019377","4096","1549.65308533","2.64317222918"
"SL2.50ch11:18015531-18016536","283","18015531","18016536","1005","1549.65308533","0.648532248615"
"SL2.50ch11:18020853-18026759","1916","18020853","18026759","5906","1549.65308533","3.81117558241"
"SL2.50ch11:18022602-18023600","353","18022602","18023600","998","1549.65308533","0.644015108575"
"SL2.50ch11:18024068-18026597","958","18024068","18026597","2529","1549.65308533","1.63197816592"
"SL2.50ch11:18031842-18034551","625","18031842","18034551","2709","1549.65308533","1.74813319552"
"SL2.50ch11:18035054-18037120","787","18035054","18037120","2066","1549.65308533","1.33320161755"
"SL2.50ch11:18035533-18037165","664","18035533","18037165","1632","1549.65308533","1.05313893506"
"SL2.50ch11:18573851-18574412","130","18573851","18574412","561","1549.65308533","0.362016508928"
"SL2.50ch11:18584754-18585129","80","18584754","18585129","375","1549.65308533","0.241989645006"
"SL2.50ch11:18627183-18627859","165","18627183","18627859","676","1549.65308533","0.43622666673"
"SL2.50ch11:18644711-18645835","281","18644711","18645835","1124","1549.65308533","0.725323629297"
"SL2.50ch11:18645012-18645787","224","18645012","18645787","775","1549.65308533","0.500111933012"
"SL2.50ch11:18668989-18669577","226","18668989","18669577","588","1549.65308533","0.379439763369"
"SL2.50ch11:18669090-18669465","220","18669090","18669465","375","1549.65308533","0.241989645006"
"SL2.50ch11:18682081-18682445","222","18682081","18682445","364","1549.65308533","0.234891282085"
"SL2.50ch11:18737366-18738127","817","18737366","18738127","761","1549.65308533","0.491077652931"
"SL2.50ch11:18739810-18740727","1710","18739810","18740727","917","1549.65308533","0.591745345254"
"SL2.50ch11:18832189-18832905","166","18832189","18832905","716","1549.65308533","0.462038895531"
"SL2.50ch11:19502071-19502648","129","19502071","19502648","577","1549.65308533","0.372341400449"
"SL2.50ch11:19929961-19930336","81","19929961","19930336","375","1549.65308533","0.241989645006"
"SL2.50ch11:2007301-2007889","1453","2007301","2007889","588","1549.65308533","0.379439763369"
"SL2.50ch11:2007316-2007852","1452","2007316","2007852","536","1549.65308533","0.345883865928"
"SL2.50ch11:20225229-20225817","125","20225229","20225817","588","1549.65308533","0.379439763369"
"SL2.50ch11:20288855-20289934","204","20288855","20289934","1079","1549.65308533","0.696284871896"
"SL2.50ch11:20415697-20416739","1239","20415697","20416739","1042","1549.65308533","0.672408560256"
"SL2.50ch11:20415748-20416757","1223","20415748","20416757","1009","1549.65308533","0.651113471495"
"SL2.50ch11:20418887-20423089","6576","20418887","20423089","4202","1549.65308533","2.7115746355"
"SL2.50ch11:20418993-20420372","1621","20418993","20420372","1379","1549.65308533","0.889876587901"
"SL2.50ch11:20421502-20423220","4684","20421502","20423220","1718","1549.65308533","1.10863522699"
"SL2.50ch11:20424366-20425295","631","20424366","20425295","929","1549.65308533","0.599489013894"
"SL2.50ch11:20424601-20425189","606","20424601","20425189","588","1549.65308533","0.379439763369"
"SL2.50ch11:20739247-20741244","432","20739247","20741244","1997","1549.65308533","1.28867552287"
"SL2.50ch11:20748465-20751023","521","20748465","20751023","2558","1549.65308533","1.6506920318"
"SL2.50ch11:20757194-20758479","218","20757194","20758479","1285","1549.65308533","0.829217850219"
"SL2.50ch11:20780226-20780694","89","20780226","20780694","468","1549.65308533","0.302003076967"
"SL2.50ch11:20785382-20786849","321","20785382","20786849","1467","1549.65308533","0.946663491262"
"SL2.50ch11:20798932-20803403","811","20798932","20803403","4471","1549.65308533","2.88516187419"
"SL2.50ch11:20806121-20808163","314","20806121","20808163","2042","1549.65308533","1.31771428027"
"SL2.50ch11:20813461-20813929","93","20813461","20813929","468","1549.65308533","0.302003076967"
"SL2.50ch11:20815127-20817429","424","20815127","20817429","2302","1549.65308533","1.48549376747"
"SL2.50ch11:20827370-20828506","246","20827370","20828506","1136","1549.65308533","0.733067297937"
"SL2.50ch11:20832239-20833742","313","20832239","20833742","1503","1549.65308533","0.969894497183"
"SL2.50ch11:20837860-20838896","229","20837860","20838896","1036","1549.65308533","0.668536725936"
"SL2.50ch11:20852200-20854359","450","20852200","20854359","2159","1549.65308533","1.39321504951"
"SL2.50ch11:21922290-21923240","1093","21922290","21923240","950","1549.65308533","0.613040434014"
"SL2.50ch11:21922623-21923453","1052","21922623","21923453","830","1549.65308533","0.535603747612"
"SL2.50ch11:22100621-22101537","198","22100621","22101537","916","1549.65308533","0.591100039534"
"SL2.50ch11:22560259-22560775","133","22560259","22560775","516","1549.65308533","0.332977751528"
"SL2.50ch11:23444510-23445113","125","23444510","23445113","603","1549.65308533","0.389119349169"
"SL2.50ch11:23447891-23448359","411","23447891","23448359","468","1549.65308533","0.302003076967"
"SL2.50ch11:23453230-23453719","397","23453230","23453719","489","1549.65308533","0.315554497087"
"SL2.50ch11:23568763-23569351","139","23568763","23569351","588","1549.65308533","0.379439763369"
"SL2.50ch11:23839039-23840321","239","23839039","23840321","1282","1549.65308533","0.827281933059"
"SL2.50ch11:24012739-24014300","467","24012739","24014300","1561","1549.65308533","1.00732222894"
"SL2.50ch11:24013173-24013761","269","24013173","24013761","588","1549.65308533","0.379439763369"
"SL2.50ch11:25050880-25051468","161","25050880","25051468","588","1549.65308533","0.379439763369"
"SL2.50ch11:25050976-25051804","207","25050976","25051804","828","1549.65308533","0.534313136172"
"SL2.50ch11:25598236-25599066","152","25598236","25599066","830","1549.65308533","0.535603747612"
"SL2.50ch11:27896435-27896908","143","27896435","27896908","473","1549.65308533","0.305229605567"
"SL2.50ch11:28162925-28163513","133","28162925","28163513","588","1549.65308533","0.379439763369"
"SL2.50ch11:28248242-28248617","75","28248242","28248617","375","1549.65308533","0.241989645006"
"SL2.50ch11:28532238-28532809","118","28532238","28532809","571","1549.65308533","0.368469566129"
"SL2.50ch11:28734035-28734410","77","28734035","28734410","375","1549.65308533","0.241989645006"
"SL2.50ch11:30178500-30179077","150","30178500","30179077","577","1549.65308533","0.372341400449"
"SL2.50ch11:30180392-30180860","166","30180392","30180860","468","1549.65308533","0.302003076967"
"SL2.50ch11:30598067-30599183","1615","30598067","30599183","1116","1549.65308533","0.720161183537"
"SL2.50ch11:30608743-30609107","679","30608743","30609107","364","1549.65308533","0.234891282085"
"SL2.50ch11:30742549-30743611","270","30742549","30743611","1062","1549.65308533","0.685314674656"
"SL2.50ch11:30742573-30743051","127","30742573","30743051","478","1549.65308533","0.308456134167"
"SL2.50ch11:30981366-30982622","338","30981366","30982622","1256","1549.65308533","0.810503984339"
"SL2.50ch11:31073478-31074322","156","31073478","31074322","844","1549.65308533","0.544638027693"
"SL2.50ch11:31298315-31298903","4956","31298315","31298903","588","1549.65308533","0.379439763369"
"SL2.50ch11:31298333-31298901","4956","31298333","31298901","568","1549.65308533","0.366533648969"
"SL2.50ch11:31585927-31587699","7147","31585927","31587699","1772","1549.65308533","1.14348173587"
"SL2.50ch11:31585989-31587697","7144","31585989","31587697","1708","1549.65308533","1.10218216979"
"SL2.50ch11:32406457-32407315","536","32406457","32407315","858","1549.65308533","0.553672307773"
"SL2.50ch11:32416170-32416840","136","32416170","32416840","670","1549.65308533","0.43235483241"
"SL2.50ch11:32423926-32426840","26323","32423926","32426840","2914","1549.65308533","1.88042086812"
"SL2.50ch11:32424354-32426901","25824","32424354","32426901","2547","1549.65308533","1.64359366888"
"SL2.50ch11:33038558-33039146","295","33038558","33039146","588","1549.65308533","0.379439763369"
"SL2.50ch11:33038657-33039160","275","33038657","33039160","503","1549.65308533","0.324588777168"
"SL2.50ch11:34486737-34487207","96","34486737","34487207","470","1549.65308533","0.303293688407"
"SL2.50ch11:35491059-35491540","114","35491059","35491540","481","1549.65308533","0.310392051327"
"SL2.50ch11:36180587-36180962","71","36180587","36180962","375","1549.65308533","0.241989645006"
"SL2.50ch11:36311075-36311560","90","36311075","36311560","485","1549.65308533","0.312973274207"
"SL2.50ch11:37254852-37255227","76","37254852","37255227","375","1549.65308533","0.241989645006"
"SL2.50ch11:37661451-37661826","77","37661451","37661826","375","1549.65308533","0.241989645006"
"SL2.50ch11:37707177-37707552","76","37707177","37707552","375","1549.65308533","0.241989645006"
"SL2.50ch11:37761667-37762042","85","37761667","37762042","375","1549.65308533","0.241989645006"
"SL2.50ch11:38194523-38196143","795","38194523","38196143","1620","1549.65308533","1.04539526642"
"SL2.50ch11:38194612-38196097","793","38194612","38196097","1485","1549.65308533","0.958278994222"
"SL2.50ch11:38768420-38769019","149","38768420","38769019","599","1549.65308533","0.386538126289"
"SL2.50ch11:38960517-38961881","280","38960517","38961881","1364","1549.65308533","0.880197002101"
"SL2.50ch11:38960904-38961268","87","38960904","38961268","364","1549.65308533","0.234891282085"
"SL2.50ch11:39472431-39472806","89","39472431","39472806","375","1549.65308533","0.241989645006"
"SL2.50ch11:40317148-40320530","15523","40317148","40320530","3382","1549.65308533","2.18242394509"
"SL2.50ch11:40317250-40320440","15517","40317250","40320440","3190","1549.65308533","2.05852524685"
"SL2.50ch11:40957143-40957785","124","40957143","40957785","642","1549.65308533","0.41428627225"
"SL2.50ch11:41400250-41400963","143","41400250","41400963","713","1549.65308533","0.460102978371"
"SL2.50ch11:42695683-42696164","97","42695683","42696164","481","1549.65308533","0.310392051327"
"SL2.50ch11:42792157-42792858","128","42792157","42792858","701","1549.65308533","0.452359309731"
"SL2.50ch11:42918202-42918922","886","42918202","42918922","720","1549.65308533","0.464620118411"
"SL2.50ch11:42918205-42918703","848","42918205","42918703","498","1549.65308533","0.321362248567"
"SL2.50ch11:43122296-43122671","178","43122296","43122671","375","1549.65308533","0.241989645006"
"SL2.50ch11:43658586-43659072","107","43658586","43659072","486","1549.65308533","0.313618579927"
"SL2.50ch11:44956600-44957298","150","44956600","44957298","698","1549.65308533","0.450423392571"
"SL2.50ch11:44961553-44962410","169","44961553","44962410","857","1549.65308533","0.553027002053"
"SL2.50ch11:45009815-45010925","189","45009815","45010925","1110","1549.65308533","0.716289349217"
"SL2.50ch11:45022509-45022978","102","45022509","45022978","469","1549.65308533","0.302648382687"
"SL2.50ch11:45027784-45028326","108","45027784","45028326","542","1549.65308533","0.349755700248"
"SL2.50ch11:45233322-45239721","37136","45233322","45239721","6399","1549.65308533","4.12931130238"
"SL2.50ch11:45233648-45239773","37115","45233648","45239773","6125","1549.65308533","3.95249753509"
"SL2.50ch11:45246210-45248270","10200","45246210","45248270","2060","1549.65308533","1.32932978323"
"SL2.50ch11:45246271-45248409","10200","45246271","45248409","2138","1549.65308533","1.37966362939"
"SL2.50ch11:45250531-45251283","8583","45250531","45251283","752","1549.65308533","0.485269901451"
"SL2.50ch11:45250629-45251364","8556","45250629","45251364","735","1549.65308533","0.474299704211"
"SL2.50ch11:45252790-45254432","8668","45252790","45254432","1642","1549.65308533","1.05959199226"
"SL2.50ch11:45252807-45254478","8668","45252807","45254478","1671","1549.65308533","1.07830585815"
"SL2.50ch11:45255681-45260487","26833","45255681","45260487","4806","1549.65308533","3.10133929039"
"SL2.50ch11:45255687-45260527","26833","45255687","45260527","4840","1549.65308533","3.12327968487"
"SL2.50ch11:45336898-45338922","9766","45336898","45338922","2024","1549.65308533","1.30609877731"
"SL2.50ch11:45337014-45338875","9745","45337014","45338875","1861","1549.65308533","1.20091394495"
"SL2.50ch11:45339523-45342194","12584","45339523","45342194","2671","1549.65308533","1.72361157816"
"SL2.50ch11:45339759-45342141","12541","45339759","45342141","2382","1549.65308533","1.53711822508"
"SL2.50ch11:45343872-45345788","10645","45343872","45345788","1916","1549.65308533","1.23640575955"
"SL2.50ch11:45343940-45345815","10456","45343940","45345815","1875","1549.65308533","1.20994822503"
"SL2.50ch11:45350041-45351538","7000","45350041","45351538","1497","1549.65308533","0.966022662863"
"SL2.50ch11:45350094-45351490","7000","45350094","45351490","1396","1549.65308533","0.900846785141"
"SL2.50ch11:45354488-45356004","8215","45354488","45356004","1516","1549.65308533","0.978283471543"
"SL2.50ch11:45354538-45356028","8198","45354538","45356028","1490","1549.65308533","0.961505522822"
"SL2.50ch11:45357909-45358712","3374","45357909","45358712","803","1549.65308533","0.518180493172"
"SL2.50ch11:45357925-45358659","3374","45357925","45358659","734","1549.65308533","0.473654398491"
"SL2.50ch11:45363927-45368134","29853","45363927","45368134","4207","1549.65308533","2.7148011641"
"SL2.50ch11:45363948-45368134","29849","45363948","45368134","4186","1549.65308533","2.70124974398"
"SL2.50ch11:45371000-45372301","4402","45371000","45372301","1301","1549.65308533","0.83954274174"
"SL2.50ch11:45371051-45372719","4585","45371051","45372719","1668","1549.65308533","1.07636994099"
"SL2.50ch11:45374326-45377827","16344","45374326","45377827","3501","1549.65308533","2.25921532577"
"SL2.50ch11:45374334-45377791","16342","45374334","45377791","3457","1549.65308533","2.23082187409"
"SL2.50ch11:45386677-45388333","10710","45386677","45388333","1656","1549.65308533","1.06862627234"
"SL2.50ch11:45386703-45388297","10710","45386703","45388297","1594","1549.65308533","1.0286173177"
"SL2.50ch11:45390094-45391145","6559","45390094","45391145","1051","1549.65308533","0.678216311736"
"SL2.50ch11:45390128-45391152","6508","45390128","45391152","1024","1549.65308533","0.660793057295"
"SL2.50ch11:45392566-45394336","7203","45392566","45394336","1770","1549.65308533","1.14219112443"
"SL2.50ch11:45392721-45394219","7183","45392721","45394219","1498","1549.65308533","0.966667968583"
"SL2.50ch11:45397122-45398043","2925","45397122","45398043","921","1549.65308533","0.594326568134"
"SL2.50ch11:45400835-45401304","374","45400835","45401304","469","1549.65308533","0.302648382687"
"SL2.50ch11:45403798-45404438","853","45403798","45404438","640","1549.65308533","0.41299566081"
"SL2.50ch11:45403889-45404808","930","45403889","45404808","919","1549.65308533","0.593035956694"
"SL2.50ch11:45406044-45406720","419","45406044","45406720","676","1549.65308533","0.43622666673"
"SL2.50ch11:45411473-45413060","7390","45411473","45413060","1587","1549.65308533","1.02410017766"
"SL2.50ch11:45411477-45413071","7390","45411477","45413071","1594","1549.65308533","1.0286173177"
"SL2.50ch11:45417254-45418460","2694","45417254","45418460","1206","1549.65308533","0.778238698338"
"SL2.50ch11:45417273-45418334","2683","45417273","45418334","1061","1549.65308533","0.684669368936"
"SL2.50ch11:45422580-45423774","6068","45422580","45423774","1194","1549.65308533","0.770495029698"
"SL2.50ch11:45422658-45423737","5941","45422658","45423737","1079","1549.65308533","0.696284871896"
"SL2.50ch11:45440157-45440892","2527","45440157","45440892","735","1549.65308533","0.474299704211"
"SL2.50ch11:45440169-45441052","2546","45440169","45441052","883","1549.65308533","0.569804950773"
"SL2.50ch11:45444258-45444846","1822","45444258","45444846","588","1549.65308533","0.379439763369"
"SL2.50ch11:45444323-45444945","1822","45444323","45444945","622","1549.65308533","0.401380157849"
"SL2.50ch11:45446552-45449056","10481","45446552","45449056","2504","1549.65308533","1.61584552292"
"SL2.50ch11:45446564-45448994","10470","45446564","45448994","2430","1549.65308533","1.56809289964"
"SL2.50ch11:45450196-45452029","5270","45450196","45452029","1833","1549.65308533","1.18284538479"
"SL2.50ch11:45450331-45451907","5241","45450331","45451907","1576","1549.65308533","1.01700181474"
"SL2.50ch11:45459730-45460464","4190","45459730","45460464","734","1549.65308533","0.473654398491"
"SL2.50ch11:45459797-45460432","4190","45459797","45460432","635","1549.65308533","0.40976913221"
"SL2.50ch11:45461227-45462145","2841","45461227","45462145","918","1549.65308533","0.592390650974"
"SL2.50ch11:45461280-45462071","2792","45461280","45462071","791","1549.65308533","0.510436824532"
"SL2.50ch11:45463432-45465553","7085","45463432","45465553","2121","1549.65308533","1.36869343215"
"SL2.50ch11:45463548-45465554","7084","45463548","45465554","2006","1549.65308533","1.29448327435"
"SL2.50ch11:45475460-45476048","1240","45475460","45476048","588","1549.65308533","0.379439763369"
"SL2.50ch11:45475461-45476498","1324","45475461","45476498","1037","1549.65308533","0.669182031656"
"SL2.50ch11:45556112-45556600","102","45556112","45556600","488","1549.65308533","0.314909191367"
"SL2.50ch11:45560372-45561169","161","45560372","45561169","797","1549.65308533","0.514308658852"
"SL2.50ch11:45581334-45581709","72","45581334","45581709","375","1549.65308533","0.241989645006"
"SL2.50ch11:45626619-45626994","72","45626619","45626994","375","1549.65308533","0.241989645006"
"SL2.50ch11:45864853-45865441","147","45864853","45865441","588","1549.65308533","0.379439763369"
"SL2.50ch11:48465837-48466212","76","48465837","48466212","375","1549.65308533","0.241989645006"
"SL2.50ch11:48691823-48692411","222","48691823","48692411","588","1549.65308533","0.379439763369"
"SL2.50ch11:48691951-48692326","220","48691951","48692326","375","1549.65308533","0.241989645006"
"SL2.50ch11:48717894-48719621","9000","48717894","48719621","1727","1549.65308533","1.11444297847"
"SL2.50ch11:48717917-48719522","8994","48717917","48719522","1605","1549.65308533","1.03571568062"
"SL2.50ch11:48869503-48870926","28243","48869503","48870926","1423","1549.65308533","0.918270039581"
"SL2.50ch11:48869778-48870955","28251","48869778","48870955","1177","1549.65308533","0.759524832458"
"SL2.50ch11:48874032-48874407","70","48874032","48874407","375","1549.65308533","0.241989645006"
"SL2.50ch11:48951925-48952408","212","48951925","48952408","483","1549.65308533","0.311682662767"
"SL2.50ch11:49617763-49620700","9781","49617763","49620700","2937","1549.65308533","1.89526289968"
"SL2.50ch11:49617835-49625590","30943","49617835","49625590","7755","1549.65308533","5.00434585872"
"SL2.50ch11:49621739-49625578","20912","49621739","49625578","3839","1549.65308533","2.47732865914"
"SL2.50ch11:49629321-49636174","20903","49629321","49636174","6853","1549.65308533","4.42228009926"
"SL2.50ch11:49629443-49636071","20807","49629443","49636071","6628","1549.65308533","4.27708631226"
"SL2.50ch11:49638648-49644092","8147","49638648","49644092","5444","1549.65308533","3.51304433976"
"SL2.50ch11:49638926-49640604","4306","49638926","49640604","1678","1549.65308533","1.08282299819"
"SL2.50ch11:49641299-49643882","3682","49641299","49643882","2583","1549.65308533","1.6668246748"
"SL2.50ch11:49647978-49649592","6535","49647978","49649592","1614","1549.65308533","1.0415234321"
"SL2.50ch11:49648177-49649553","6522","49648177","49649553","1376","1549.65308533","0.887940670741"
"SL2.50ch11:50256033-50256947","5238","50256033","50256947","914","1549.65308533","0.589809428094"
"SL2.50ch11:50256234-50256904","5223","50256234","50256904","670","1549.65308533","0.43235483241"
"SL2.50ch11:50794388-50795063","759","50794388","50795063","675","1549.65308533","0.43558136101"
"SL2.50ch11:50794466-50795024","745","50794466","50795024","558","1549.65308533","0.360080591768"
"SL2.50ch11:51013007-51013677","144","51013007","51013677","670","1549.65308533","0.43235483241"
"SL2.50ch11:51640950-51641426","153","51640950","51641426","476","1549.65308533","0.307165522727"
"SL2.50ch11:53074910-53075381","228","53074910","53075381","471","1549.65308533","0.303938994127"
"SL2.50ch11:53587494-53587869","200","53587494","53587869","375","1549.65308533","0.241989645006"
"SL2.50ch11:55434400-55435696","479","55434400","55435696","1296","1549.65308533","0.83631621314"
"SL2.50ch11:55434577-55435600","463","55434577","55435600","1023","1549.65308533","0.660147751575"
"SL2.50ch11:7156086-7156752","325","7156086","7156752","666","1549.65308533","0.42977360953"
"SL2.50ch11:7159713-7160182","348","7159713","7160182","469","1549.65308533","0.302648382687"
"SL2.50ch11:8237824-8238485","151","8237824","8238485","661","1549.65308533","0.42654708093"
"SL2.50ch11:8470492-8472596","1043","8470492","8472596","2104","1549.65308533","1.35772323491"
"SL2.50ch11:8470525-8472389","1012","8470525","8472389","1864","1549.65308533","1.20284986211"
"SL2.50ch11:8479927-8480850","210","8479927","8480850","923","1549.65308533","0.595617179574"
"SL2.50ch11:8488520-8488993","104","8488520","8488993","473","1549.65308533","0.305229605567"
"SL2.50ch11:8509954-8510688","278","8509954","8510688","734","1549.65308533","0.473654398491"
"SL2.50ch11:8509978-8510566","264","8509978","8510566","588","1549.65308533","0.379439763369"
"SL2.50ch11:8517008-8517476","212","8517008","8517476","468","1549.65308533","0.302003076967"
"SL2.50ch11:9484220-9484969","235","9484220","9484969","749","1549.65308533","0.483333984291"
"SL2.50ch11:9484438-9484914","207","9484438","9484914","476","1549.65308533","0.307165522727"
"SL2.50ch12:11125717-11126081","1652","11125717","11126081","364","1549.65308533","0.234891282085"
"SL2.50ch12:11702022-11702636","113","11702022","11702636","614","1549.65308533","0.396217712089"
"SL2.50ch12:12049577-12050049","107","12049577","12050049","472","1549.65308533","0.304584299847"
"SL2.50ch12:12502481-12502856","75","12502481","12502856","375","1549.65308533","0.241989645006"
"SL2.50ch12:1281241-1282093","13740","1281241","1282093","852","1549.65308533","0.549800473453"
"SL2.50ch12:1281346-1282081","13735","1281346","1282081","735","1549.65308533","0.474299704211"
"SL2.50ch12:13093684-13094156","150","13093684","13094156","472","1549.65308533","0.304584299847"
"SL2.50ch12:13250682-13251270","789","13250682","13251270","588","1549.65308533","0.379439763369"
"SL2.50ch12:13409476-13410083","179","13409476","13410083","607","1549.65308533","0.391700572049"
"SL2.50ch12:15633989-15634957","356","15633989","15634957","968","1549.65308533","0.624655936975"
"SL2.50ch12:16497032-16498359","293","16497032","16498359","1327","1549.65308533","0.85632069046"
"SL2.50ch12:16584261-16584887","130","16584261","16584887","626","1549.65308533","0.403961380729"
"SL2.50ch12:16612583-16613064","95","16612583","16613064","481","1549.65308533","0.310392051327"
"SL2.50ch12:17016267-17017171","212","17016267","17017171","904","1549.65308533","0.583356370894"
"SL2.50ch12:17284165-17285287","261","17284165","17285287","1122","1549.65308533","0.724033017857"
"SL2.50ch12:17284279-17285139","227","17284279","17285139","860","1549.65308533","0.554962919213"
"SL2.50ch12:17316112-17316705","118","17316112","17316705","593","1549.65308533","0.382666291969"
"SL2.50ch12:17330786-17334032","836","17330786","17334032","3246","1549.65308533","2.09466236717"
"SL2.50ch12:17335049-17335912","201","17335049","17335912","863","1549.65308533","0.556898836373"
"SL2.50ch12:17336362-17340703","1035","17336362","17340703","4341","1549.65308533","2.80127213059"
"SL2.50ch12:17343133-17343956","201","17343133","17343956","823","1549.65308533","0.531086607572"
"SL2.50ch12:17344734-17347336","617","17344734","17347336","2602","1549.65308533","1.67908548348"
"SL2.50ch12:17369690-17375684","1354","17369690","17375684","5994","1549.65308533","3.86796248577"
"SL2.50ch12:17454017-17455033","199","17454017","17455033","1016","1549.65308533","0.655630611535"
"SL2.50ch12:17458226-17458590","91","17458226","17458590","364","1549.65308533","0.234891282085"
"SL2.50ch12:17462286-17463613","638","17462286","17463613","1327","1549.65308533","0.85632069046"
"SL2.50ch12:17462562-17463551","596","17462562","17463551","989","1549.65308533","0.638207357095"
"SL2.50ch12:17468858-17470321","1269","17468858","17470321","1463","1549.65308533","0.944082268382"
"SL2.50ch12:17469001-17470204","1253","17469001","17470204","1203","1549.65308533","0.776302781178"
"SL2.50ch12:17570240-17573194","750","17570240","17573194","2954","1549.65308533","1.90623309692"
"SL2.50ch12:17570258-17571915","574","17570258","17571915","1657","1549.65308533","1.06927157806"
"SL2.50ch12:17582583-17583808","519","17582583","17583808","1225","1549.65308533","0.790499507018"
"SL2.50ch12:17582628-17583817","519","17582628","17583817","1189","1549.65308533","0.767268501098"
"SL2.50ch12:17584512-17586613","1328","17584512","17586613","2101","1549.65308533","1.35578731775"
"SL2.50ch12:17584580-17586620","1328","17584580","17586620","2040","1549.65308533","1.31642366883"
"SL2.50ch12:17593329-17593704","75","17593329","17593704","375","1549.65308533","0.241989645006"
"SL2.50ch12:17598661-17599862","248","17598661","17599862","1201","1549.65308533","0.775012169738"
"SL2.50ch12:17598677-17599041","157","17598677","17599041","364","1549.65308533","0.234891282085"
"SL2.50ch12:17600360-17602099","343","17600360","17602099","1739","1549.65308533","1.12218664711"
"SL2.50ch12:17605325-17606548","247","17605325","17606548","1223","1549.65308533","0.789208895578"
"SL2.50ch12:17770873-17771640","158","17770873","17771640","767","1549.65308533","0.494949487252"
"SL2.50ch12:19410326-19411466","210","19410326","19411466","1140","1549.65308533","0.735648520817"
"SL2.50ch12:20029637-20030318","135","20029637","20030318","681","1549.65308533","0.43945319533"
"SL2.50ch12:20970666-20971159","91","20970666","20971159","493","1549.65308533","0.318135719967"
"SL2.50ch12:21136812-21137445","128","21136812","21137445","633","1549.65308533","0.40847852077"
"SL2.50ch12:21139397-21144310","1148","21139397","21144310","4913","1549.65308533","3.17038700243"
"SL2.50ch12:21395345-21396276","210","21395345","21396276","931","1549.65308533","0.600779625334"
"SL2.50ch12:22083326-22083847","111","22083326","22083847","521","1549.65308533","0.336204280128"
"SL2.50ch12:22366196-22366664","387","22366196","22366664","468","1549.65308533","0.302003076967"
"SL2.50ch12:22466405-22470000","1708","22466405","22470000","3595","1549.65308533","2.31987406345"
"SL2.50ch12:22467053-22469327","1474","22467053","22469327","2274","1549.65308533","1.46742520731"
"SL2.50ch12:22471365-22472124","331","22471365","22472124","759","1549.65308533","0.489787041491"
"SL2.50ch12:22471403-22471991","308","22471403","22471991","588","1549.65308533","0.379439763369"
"SL2.50ch12:22476830-22479067","857","22476830","22479067","2237","1549.65308533","1.44354889567"
"SL2.50ch12:22476957-22478153","719","22476957","22478153","1196","1549.65308533","0.771785641138"
"SL2.50ch12:22568860-22569567","177","22568860","22569567","707","1549.65308533","0.456231144051"
"SL2.50ch12:22571503-22572833","546","22571503","22572833","1330","1549.65308533","0.85825660762"
"SL2.50ch12:22571802-22572691","525","22571802","22572691","889","1549.65308533","0.573676785093"
"SL2.50ch12:22575848-22576880","415","22575848","22576880","1032","1549.65308533","0.665955503056"
"SL2.50ch12:22575892-22577134","462","22575892","22577134","1242","1549.65308533","0.801469704259"
"SL2.50ch12:22587644-22589017","551","22587644","22589017","1373","1549.65308533","0.886004753581"
"SL2.50ch12:22587777-22588518","419","22587777","22588518","741","1549.65308533","0.478171538531"
"SL2.50ch12:22599386-22600299","408","22599386","22600299","913","1549.65308533","0.589164122374"
"SL2.50ch12:22601707-22602071","116","22601707","22602071","364","1549.65308533","0.234891282085"
"SL2.50ch12:22607887-22609038","211","22607887","22609038","1151","1549.65308533","0.742746883737"
"SL2.50ch12:22609875-22611919","419","22609875","22611919","2044","1549.65308533","1.31900489171"
"SL2.50ch12:22619613-22621058","788","22619613","22621058","1445","1549.65308533","0.932466765422"
"SL2.50ch12:22619712-22621059","788","22619712","22621059","1347","1549.65308533","0.86922680486"
"SL2.50ch12:22622848-22624147","772","22622848","22624147","1299","1549.65308533","0.8382521303"
"SL2.50ch12:22622896-22624203","772","22622896","22624203","1307","1549.65308533","0.84341457606"
"SL2.50ch12:22626450-22627721","402","22626450","22627721","1271","1549.65308533","0.820183570139"
"SL2.50ch12:22626798-22627716","324","22626798","22627716","918","1549.65308533","0.592390650974"
"SL2.50ch12:22636213-22637123","549","22636213","22637123","910","1549.65308533","0.587228205214"
"SL2.50ch12:22636268-22637223","538","22636268","22637223","955","1549.65308533","0.616266962614"
"SL2.50ch12:22638746-22640065","776","22638746","22640065","1319","1549.65308533","0.8511582447"
"SL2.50ch12:22638777-22640151","784","22638777","22640151","1374","1549.65308533","0.886650059301"
"SL2.50ch12:22640807-22641801","417","22640807","22641801","994","1549.65308533","0.641433885695"
"SL2.50ch12:22640867-22641682","409","22640867","22641682","815","1549.65308533","0.525924161812"
"SL2.50ch12:22642957-22644250","732","22642957","22644250","1293","1549.65308533","0.834380295979"
"SL2.50ch12:22642977-22644344","731","22642977","22644344","1367","1549.65308533","0.882132919261"
"SL2.50ch12:22647671-22649157","614","22647671","22649157","1486","1549.65308533","0.958924299942"
"SL2.50ch12:22647786-22649218","595","22647786","22649218","1432","1549.65308533","0.924077791062"
"SL2.50ch12:22653598-22653973","73","22653598","22653973","375","1549.65308533","0.241989645006"
"SL2.50ch12:22661664-22664212","915","22661664","22664212","2548","1549.65308533","1.6442389746"
"SL2.50ch12:22661915-22662503","268","22661915","22662503","588","1549.65308533","0.379439763369"
"SL2.50ch12:22663134-22663704","375","22663134","22663704","570","1549.65308533","0.367824260409"
"SL2.50ch12:22698656-22699443","207","22698656","22699443","787","1549.65308533","0.507855601652"
"SL2.50ch12:22729497-22736133","1607","22729497","22736133","6636","1549.65308533","4.28224875802"
"SL2.50ch12:22733091-22733455","142","22733091","22733455","364","1549.65308533","0.234891282085"
"SL2.50ch12:22756163-22757148","172","22756163","22757148","985","1549.65308533","0.635626134215"
"SL2.50ch12:22765306-22770404","1430","22765306","22770404","5098","1549.65308533","3.28976856064"
"SL2.50ch12:22770993-22773736","707","22770993","22773736","2743","1549.65308533","1.77007359"
"SL2.50ch12:22772462-22773584","271","22772462","22773584","1122","1549.65308533","0.724033017857"
"SL2.50ch12:22791466-22791841","78","22791466","22791841","375","1549.65308533","0.241989645006"
"SL2.50ch12:23358906-23359281","73","23358906","23359281","375","1549.65308533","0.241989645006"
"SL2.50ch12:24078723-24079775","11296","24078723","24079775","1052","1549.65308533","0.678861617456"
"SL2.50ch12:24169458-24169930","87","24169458","24169930","472","1549.65308533","0.304584299847"
"SL2.50ch12:26175653-26176028","88","26175653","26176028","375","1549.65308533","0.241989645006"
"SL2.50ch12:26321657-26322032","83","26321657","26322032","375","1549.65308533","0.241989645006"
"SL2.50ch12:26463352-26463727","87","26463352","26463727","375","1549.65308533","0.241989645006"
"SL2.50ch12:26867044-26867419","68","26867044","26867419","375","1549.65308533","0.241989645006"
"SL2.50ch12:27365076-27365798","160","27365076","27365798","722","1549.65308533","0.465910729851"
"SL2.50ch12:29080961-29081520","208","29080961","29081520","559","1549.65308533","0.360725897488"
"SL2.50ch12:29095151-29097067","589","29095151","29097067","1916","1549.65308533","1.23640575955"
"SL2.50ch12:29229996-29231202","263","29229996","29231202","1206","1549.65308533","0.778238698338"
"SL2.50ch12:29494451-29494826","77","29494451","29494826","375","1549.65308533","0.241989645006"
"SL2.50ch12:30017523-30018259","3724","30017523","30018259","736","1549.65308533","0.474945009931"
"SL2.50ch12:31058653-31059028","83","31058653","31059028","375","1549.65308533","0.241989645006"
"SL2.50ch12:32393559-32395295","298","32393559","32395295","1736","1549.65308533","1.12025072995"
"SL2.50ch12:32491718-32492238","120","32491718","32492238","520","1549.65308533","0.335558974408"
"SL2.50ch12:32676301-32676676","97","32676301","32676676","375","1549.65308533","0.241989645006"
"SL2.50ch12:32788425-32789013","101","32788425","32789013","588","1549.65308533","0.379439763369"
"SL2.50ch12:33401409-33401784","73","33401409","33401784","375","1549.65308533","0.241989645006"
"SL2.50ch12:33815479-33815843","704","33815479","33815843","364","1549.65308533","0.234891282085"
"SL2.50ch12:33827523-33828515","307","33827523","33828515","992","1549.65308533","0.640143274255"
"SL2.50ch12:33961197-33961572","87","33961197","33961572","375","1549.65308533","0.241989645006"
"SL2.50ch12:34179760-34180304","106","34179760","34180304","544","1549.65308533","0.351046311688"
"SL2.50ch12:34295089-34305590","4559","34295089","34305590","10501","1549.65308533","6.77635536588"
"SL2.50ch12:34295103-34305798","4578","34295103","34305798","10695","1549.65308533","6.90154467556"
"SL2.50ch12:34306193-34319398","5055","34306193","34319398","13205","1549.65308533","8.5212620328"
"SL2.50ch12:34312143-34316734","2113","34312143","34316734","4591","1549.65308533","2.96259856059"
"SL2.50ch12:34329213-34329577","51","34329213","34329577","364","1549.65308533","0.234891282085"
"SL2.50ch12:34330107-34331809","874","34330107","34331809","1702","1549.65308533","1.09831033547"
"SL2.50ch12:34808266-34808854","776","34808266","34808854","588","1549.65308533","0.379439763369"
"SL2.50ch12:35956067-35956540","89","35956067","35956540","473","1549.65308533","0.305229605567"
"SL2.50ch12:36092612-36136248","15401","36092612","36136248","43636","1549.65308533","28.1585603986"
"SL2.50ch12:36093404-36106309","4985","36093404","36106309","12905","1549.65308533","8.32767031679"
"SL2.50ch12:36108119-36111385","1437","36108119","36111385","3266","1549.65308533","2.10756848157"
"SL2.50ch12:36111889-36115490","1281","36111889","36115490","3601","1549.65308533","2.32374589777"
"SL2.50ch12:36121452-36127480","1944","36121452","36127480","6028","1549.65308533","3.88990288025"
"SL2.50ch12:36135699-36136063","130","36135699","36136063","364","1549.65308533","0.234891282085"
"SL2.50ch12:36147721-36149541","360","36147721","36149541","1820","1549.65308533","1.17445641043"
"SL2.50ch12:36168713-36169186","101","36168713","36169186","473","1549.65308533","0.305229605567"
"SL2.50ch12:36172679-36176703","952","36172679","36176703","4024","1549.65308533","2.59671021734"
"SL2.50ch12:36178209-36178584","85","36178209","36178584","375","1549.65308533","0.241989645006"
"SL2.50ch12:36179078-36182664","727","36179078","36182664","3586","1549.65308533","2.31406631197"
"SL2.50ch12:36182715-36183079","47","36182715","36183079","364","1549.65308533","0.234891282085"
"SL2.50ch12:36192610-36197008","815","36192610","36197008","4398","1549.65308533","2.83805455663"
"SL2.50ch12:36197435-36198793","256","36197435","36198793","1358","1549.65308533","0.87632516778"
"SL2.50ch12:36213291-36218331","997","36213291","36218331","5040","1549.65308533","3.25234082888"
"SL2.50ch12:36218739-36219696","176","36218739","36219696","957","1549.65308533","0.617557574054"
"SL2.50ch12:36223379-36226257","536","36223379","36226257","2878","1549.65308533","1.8571898622"
"SL2.50ch12:36240623-36241559","166","36240623","36241559","936","1549.65308533","0.604006153934"
"SL2.50ch12:36242452-36243295","197","36242452","36243295","843","1549.65308533","0.543992721973"
"SL2.50ch12:36243674-36246207","462","36243674","36246207","2533","1549.65308533","1.6345593888"
"SL2.50ch12:36247013-36250322","608","36247013","36250322","3309","1549.65308533","2.13531662753"
"SL2.50ch12:37504894-37505472","146","37504894","37505472","578","1549.65308533","0.372986706169"
"SL2.50ch12:37679910-37680644","1041","37679910","37680644","734","1549.65308533","0.473654398491"
"SL2.50ch12:37679988-37680515","1035","37679988","37680515","527","1549.65308533","0.340076114448"
"SL2.50ch12:38096537-38098487","363","38096537","38098487","1950","1549.65308533","1.25834615403"
"SL2.50ch12:38096683-38097591","173","38096683","38097591","908","1549.65308533","0.585937593774"
"SL2.50ch12:39449893-39450478","142","39449893","39450478","585","1549.65308533","0.377503846209"
"SL2.50ch12:39482736-39483466","304","39482736","39483466","730","1549.65308533","0.471073175611"
"SL2.50ch12:42006160-42006629","96","42006160","42006629","469","1549.65308533","0.302648382687"
"SL2.50ch12:42325906-42326396","116","42325906","42326396","490","1549.65308533","0.316199802807"
"SL2.50ch12:42620046-42620621","111","42620046","42620621","575","1549.65308533","0.371050789009"
"SL2.50ch12:4279848-4283783","6191","4279848","4283783","3935","1549.65308533","2.53927800826"
"SL2.50ch12:4279881-4283610","6183","4279881","4283610","3729","1549.65308533","2.40634502994"
"SL2.50ch12:4296541-4297125","134","4296541","4297125","584","1549.65308533","0.376858540489"
"SL2.50ch12:4297709-4298629","361","4297709","4298629","920","1549.65308533","0.593681262414"
"SL2.50ch12:4297978-4298640","312","4297978","4298640","662","1549.65308533","0.42719238665"
"SL2.50ch12:4300147-4301817","367","4300147","4301817","1670","1549.65308533","1.07766055243"
"SL2.50ch12:4302871-4303457","190","4302871","4303457","586","1549.65308533","0.378149151929"
"SL2.50ch12:4308732-4310108","357","4308732","4310108","1376","1549.65308533","0.887940670741"
"SL2.50ch12:4311879-4312254","85","4311879","4312254","375","1549.65308533","0.241989645006"
"SL2.50ch12:4328833-4329798","473","4328833","4329798","965","1549.65308533","0.622720019815"
"SL2.50ch12:4328906-4330117","503","4328906","4330117","1211","1549.65308533","0.781465226938"
"SL2.50ch12:4344756-4345344","117","4344756","4345344","588","1549.65308533","0.379439763369"
"SL2.50ch12:4350333-4351162","429","4350333","4351162","829","1549.65308533","0.534958441892"
"SL2.50ch12:4350355-4351379","463","4350355","4351379","1024","1549.65308533","0.660793057295"
"SL2.50ch12:46125872-46126868","185","46125872","46126868","996","1549.65308533","0.642724497135"
"SL2.50ch12:48944674-48945049","84","48944674","48945049","375","1549.65308533","0.241989645006"
"SL2.50ch12:49282712-49283300","3423","49282712","49283300","588","1549.65308533","0.379439763369"
"SL2.50ch12:49661847-49662603","7088","49661847","49662603","756","1549.65308533","0.487851124331"
"SL2.50ch12:49661860-49662527","7069","49661860","49662527","667","1549.65308533","0.43041891525"
"SL2.50ch12:49894365-49895056","154","49894365","49895056","691","1549.65308533","0.44590625253"
"SL2.50ch12:50172170-50173835","509","50172170","50173835","1665","1549.65308533","1.07443402383"
"SL2.50ch12:50172684-50173605","382","50172684","50173605","921","1549.65308533","0.594326568134"
"SL2.50ch12:5094079-5094443","974","5094079","5094443","364","1549.65308533","0.234891282085"
"SL2.50ch12:51036441-51037152","184","51036441","51037152","711","1549.65308533","0.458812366931"
"SL2.50ch12:51040250-51042235","2506","51040250","51042235","1985","1549.65308533","1.28093185423"
"SL2.50ch12:51040548-51042097","2397","51040548","51042097","1549","1549.65308533","0.999578560303"
"SL2.50ch12:51073582-51074050","437","51073582","51074050","468","1549.65308533","0.302003076967"
"SL2.50ch12:51538121-51538709","575","51538121","51538709","588","1549.65308533","0.379439763369"
"SL2.50ch12:51538141-51538905","595","51538141","51538905","764","1549.65308533","0.493013570091"
"SL2.50ch12:51544216-51545827","719","51544216","51545827","1611","1549.65308533","1.03958751494"
"SL2.50ch12:51544328-51544916","590","51544328","51544916","588","1549.65308533","0.379439763369"
"SL2.50ch12:51597074-51597823","4670","51597074","51597823","749","1549.65308533","0.483333984291"
"SL2.50ch12:51597234-51597796","4650","51597234","51597796","562","1549.65308533","0.362661814648"
"SL2.50ch12:5192094-5192691","122","5192094","5192691","597","1549.65308533","0.385247514849"
"SL2.50ch12:5194273-5194840","116","5194273","5194840","567","1549.65308533","0.365888343249"
"SL2.50ch12:52831357-52831732","86","52831357","52831732","375","1549.65308533","0.241989645006"
"SL2.50ch12:52832186-52833138","167","52832186","52833138","952","1549.65308533","0.614331045454"
"SL2.50ch12:53994766-53995245","108","53994766","53995245","479","1549.65308533","0.309101439887"
"SL2.50ch12:54088521-54089007","85","54088521","54089007","486","1549.65308533","0.313618579927"
"SL2.50ch12:54256028-54257444","856","54256028","54257444","1416","1549.65308533","0.913752899541"
"SL2.50ch12:54256760-54257215","649","54256760","54257215","455","1549.65308533","0.293614102607"
"SL2.50ch12:54273635-54274223","5853","54273635","54274223","588","1549.65308533","0.379439763369"
"SL2.50ch12:54273746-54274315","5855","54273746","54274315","569","1549.65308533","0.367178954689"
"SL2.50ch12:54304479-54305831","758","54304479","54305831","1352","1549.65308533","0.87245333346"
"SL2.50ch12:54315136-54316473","535","54315136","54316473","1337","1549.65308533","0.86277374766"
"SL2.50ch12:54318549-54319669","472","54318549","54319669","1120","1549.65308533","0.722742406417"
"SL2.50ch12:54672271-54672742","107","54672271","54672742","471","1549.65308533","0.303938994127"
"SL2.50ch12:55224550-55225126","262","55224550","55225126","576","1549.65308533","0.371696094729"
"SL2.50ch12:55224634-55224998","254","55224634","55224998","364","1549.65308533","0.234891282085"
"SL2.50ch12:55407597-55408072","102","55407597","55408072","475","1549.65308533","0.306520217007"
"SL2.50ch12:56908811-56910145","17357","56908811","56910145","1334","1549.65308533","0.8608378305"
"SL2.50ch12:56908861-56910045","17350","56908861","56910045","1184","1549.65308533","0.764041972498"
"SL2.50ch12:57042969-57043783","155","57042969","57043783","814","1549.65308533","0.525278856092"
"SL2.50ch12:57552167-57553571","446","57552167","57553571","1404","1549.65308533","0.906009230901"
"SL2.50ch12:57552347-57553407","396","57552347","57553407","1060","1549.65308533","0.684024063216"
"SL2.50ch12:57600573-57601099","106","57600573","57601099","526","1549.65308533","0.339430808728"
"SL2.50ch12:57621647-57622235","1400","57621647","57622235","588","1549.65308533","0.379439763369"
"SL2.50ch12:57621664-57622367","1423","57621664","57622367","703","1549.65308533","0.453649921171"
"SL2.50ch12:58258318-58258901","113","58258318","58258901","583","1549.65308533","0.376213234769"
"SL2.50ch12:5831512-5832564","241","5831512","5832564","1052","1549.65308533","0.678861617456"
"SL2.50ch12:58814694-58815220","105","58814694","58815220","526","1549.65308533","0.339430808728"
"SL2.50ch12:59137520-59138108","2346","59137520","59138108","588","1549.65308533","0.379439763369"
"SL2.50ch12:59550555-59551646","191","59550555","59551646","1091","1549.65308533","0.704028540536"
"SL2.50ch12:60389381-60390063","122","60389381","60390063","682","1549.65308533","0.44009850105"
"SL2.50ch12:60463834-60464740","203","60463834","60464740","906","1549.65308533","0.584646982334"
"SL2.50ch12:60486630-60488203","376","60486630","60488203","1573","1549.65308533","1.01506589758"
"SL2.50ch12:60490968-60492417","295","60490968","60492417","1449","1549.65308533","0.935047988302"
"SL2.50ch12:60515989-60519415","728","60515989","60519415","3426","1549.65308533","2.21081739677"
"SL2.50ch12:60519967-60520916","211","60519967","60520916","949","1549.65308533","0.612395128294"
"SL2.50ch12:60523099-60526344","674","60523099","60526344","3245","1549.65308533","2.09401706145"
"SL2.50ch12:60531411-60533781","471","60531411","60533781","2370","1549.65308533","1.52937455644"
"SL2.50ch12:60539242-60543562","904","60539242","60543562","4320","1549.65308533","2.78772071047"
"SL2.50ch12:60544224-60545183","180","60544224","60545183","959","1549.65308533","0.618848185494"
"SL2.50ch12:60545801-60574312","9812","60545801","60574312","28511","1549.65308533","18.3983113833"
"SL2.50ch12:60547639-60548227","253","60547639","60548227","588","1549.65308533","0.379439763369"
"SL2.50ch12:60552962-60555260","787","60552962","60555260","2298","1549.65308533","1.48291254459"
"SL2.50ch12:60556449-60564143","3078","60556449","60564143","7694","1549.65308533","4.9649822098"
"SL2.50ch12:60567394-60573668","2506","60567394","60573668","6274","1549.65308533","4.04864808737"
"SL2.50ch12:60581033-60582132","327","60581033","60582132","1099","1549.65308533","0.709190986297"
"SL2.50ch12:60582494-60589412","2796","60582494","60589412","6918","1549.65308533","4.46422497106"
"SL2.50ch12:60597903-60599374","465","60597903","60599374","1471","1549.65308533","0.949244714142"
"SL2.50ch12:60604506-60605400","444","60604506","60605400","894","1549.65308533","0.576903313693"
"SL2.50ch12:60612282-60616334","1382","60612282","60616334","4052","1549.65308533","2.6147787775"
"SL2.50ch12:60617093-60617699","172","60617093","60617699","606","1549.65308533","0.391055266329"
"SL2.50ch12:60626176-60631414","1582","60626176","60631414","5238","1549.65308533","3.38011136144"
"SL2.50ch12:60630426-60631734","340","60630426","60631734","1308","1549.65308533","0.84405988178"
"SL2.50ch12:60638474-60640500","535","60638474","60640500","2026","1549.65308533","1.30738938875"
"SL2.50ch12:60666415-60669128","994","60666415","60669128","2713","1549.65308533","1.7507144184"
"SL2.50ch12:60672806-60674427","661","60672806","60674427","1621","1549.65308533","1.04604057214"
"SL2.50ch12:60675191-60679217","1531","60675191","60679217","4026","1549.65308533","2.59800082878"
"SL2.50ch12:60682219-60689139","2850","60682219","60689139","6920","1549.65308533","4.4655155825"
"SL2.50ch12:60689541-60691315","605","60689541","60691315","1774","1549.65308533","1.14477234731"
"SL2.50ch12:60692533-60693957","426","60692533","60693957","1424","1549.65308533","0.918915345301"
"SL2.50ch12:60695810-60696174","118","60695810","60696174","364","1549.65308533","0.234891282085"
"SL2.50ch12:60697245-60717814","7556","60697245","60717814","20569","1549.65308533","13.273293355"
"SL2.50ch12:60702780-60704262","659","60702780","60704262","1482","1549.65308533","0.956343077062"
"SL2.50ch12:60704776-60706094","516","60704776","60706094","1318","1549.65308533","0.85051293898"
"SL2.50ch12:60706609-60709065","919","60706609","60709065","2456","1549.65308533","1.58487084836"
"SL2.50ch12:60710268-60717062","2618","60710268","60717062","6794","1549.65308533","4.38420706178"
"SL2.50ch12:60718776-60737505","7785","60718776","60737505","18729","1549.65308533","12.0859308302"
"SL2.50ch12:60718860-60731744","5740","60718860","60731744","12884","1549.65308533","8.31411889667"
"SL2.50ch12:60732198-60737023","1882","60732198","60737023","4825","1549.65308533","3.11360009907"
"SL2.50ch12:60945362-60945951","151","60945362","60945951","589","1549.65308533","0.380085069089"
"SL2.50ch12:60947675-60949835","9570","60947675","60949835","2160","1549.65308533","1.39386035523"
"SL2.50ch12:60947758-60951646","10224","60947758","60951646","3888","1549.65308533","2.50894863942"
"SL2.50ch12:61002478-61005865","4525","61002478","61005865","3387","1549.65308533","2.18565047369"
"SL2.50ch12:61002948-61003502","2118","61002948","61003502","554","1549.65308533","0.357499368888"
"SL2.50ch12:61004232-61004819","925","61004232","61004819","587","1549.65308533","0.378794457649"
"SL2.50ch12:61476812-61480913","709","61476812","61480913","4101","1549.65308533","2.64639875778"
"SL2.50ch12:61617077-61618674","364","61617077","61618674","1597","1549.65308533","1.03055323486"
"SL2.50ch12:61617721-61618309","158","61617721","61618309","588","1549.65308533","0.379439763369"
"SL2.50ch12:61625619-61633960","2368","61625619","61633960","8341","1549.65308533","5.38249501065"
"SL2.50ch12:61627487-61628217","223","61627487","61628217","730","1549.65308533","0.471073175611"
"SL2.50ch12:61629024-61630028","413","61629024","61630028","1004","1549.65308533","0.647886942895"
"SL2.50ch12:61632193-61633403","396","61632193","61633403","1210","1549.65308533","0.780819921218"
"SL2.50ch12:61636552-61659148","7564","61636552","61659148","22596","1549.65308533","14.5813280495"
"SL2.50ch12:61638016-61640147","685","61638016","61640147","2131","1549.65308533","1.37514648935"
"SL2.50ch12:61643191-61643900","213","61643191","61643900","709","1549.65308533","0.457521755491"
"SL2.50ch12:61647823-61648704","453","61647823","61648704","881","1549.65308533","0.568514339333"
"SL2.50ch12:61650711-61653835","1584","61650711","61653835","3124","1549.65308533","2.01593506933"
"SL2.50ch12:61654284-61656658","1045","61654284","61656658","2374","1549.65308533","1.53195577932"
"SL2.50ch12:61657057-61657959","372","61657057","61657959","902","1549.65308533","0.582065759454"
"SL2.50ch12:6204133-6204665","115","6204133","6204665","532","1549.65308533","0.343302643048"
"SL2.50ch12:6208324-6208892","137","6208324","6208892","568","1549.65308533","0.366533648969"
"SL2.50ch12:62260103-62260691","988","62260103","62260691","588","1549.65308533","0.379439763369"
"SL2.50ch12:62260216-62260714","985","62260216","62260714","498","1549.65308533","0.321362248567"
"SL2.50ch12:62670986-62673764","691","62670986","62673764","2778","1549.65308533","1.7926592902"
"SL2.50ch12:63804493-63805112","1314","63804493","63805112","619","1549.65308533","0.399444240689"
"SL2.50ch12:63804560-63805148","1314","63804560","63805148","588","1549.65308533","0.379439763369"
"SL2.50ch12:63885206-63885794","1255","63885206","63885794","588","1549.65308533","0.379439763369"
"SL2.50ch12:63885211-63885989","1283","63885211","63885989","778","1549.65308533","0.502047850172"
"SL2.50ch12:65405426-65406020","6011","65405426","65406020","594","1549.65308533","0.383311597689"
"SL2.50ch12:65405434-65406022","6011","65405434","65406022","588","1549.65308533","0.379439763369"
"SL2.50ch12:65635992-65636884","15866","65635992","65636884","892","1549.65308533","0.575612702253"
"SL2.50ch12:65636064-65636966","15864","65636064","65636966","902","1549.65308533","0.582065759454"
"SL2.50ch12:65736494-65739214","657","65736494","65739214","2720","1549.65308533","1.75523155844"
"SL2.50ch12:65737644-65738114","280","65737644","65738114","470","1549.65308533","0.303293688407"
"SL2.50ch12:65744928-65745598","934","65744928","65745598","670","1549.65308533","0.43235483241"
"SL2.50ch12:65745059-65745647","925","65745059","65745647","588","1549.65308533","0.379439763369"
"SL2.50ch12:7262949-7263680","173","7262949","7263680","731","1549.65308533","0.471718481331"
"SL2.50ch12:7358570-7359322","14064","7358570","7359322","752","1549.65308533","0.485269901451"
"SL2.50ch12:7358646-7359387","14060","7358646","7359387","741","1549.65308533","0.478171538531"
"SL2.50ch12:8135988-8136573","125","8135988","8136573","585","1549.65308533","0.377503846209"
"SL2.50ch12:870448-871151","2415","870448","871151","703","1549.65308533","0.453649921171"
"SL2.50ch12:870454-871100","2412","870454","871100","646","1549.65308533","0.41686749513"
"SL2.50ch12:8743223-8743799","101","8743223","8743799","576","1549.65308533","0.371696094729"
"SL2.50ch12:8853019-8853607","113","8853019","8853607","588","1549.65308533","0.379439763369"
"SL2.50ch12:8853115-8853588","100","8853115","8853588","473","1549.65308533","0.305229605567"
"SL2.50ch12:9622181-9623979","469","9622181","9623979","1798","1549.65308533","1.16025968459"
"SL2.50ch12:9687502-9687877","79","9687502","9687877","375","1549.65308533","0.241989645006"
