"Read","Counts","Read Position Start","Read Position End","Read Size (rs)","Mean Read Size (mrs)","mrs/rs"
"SL2.50ch00:10005133-10011081","2406","10005133","10011081","5948","1534.31159643","3.87665713655"
"SL2.50ch00:10006571-10011218","2014","10006571","10011218","4647","1534.31159643","3.02871985769"
"SL2.50ch00:10028416-10029802","287","10028416","10029802","1386","1534.31159643","0.903336716755"
"SL2.50ch00:10040285-10041207","187","10040285","10041207","922","1534.31159643","0.600920961651"
"SL2.50ch00:10065547-10066847","389","10065547","10066847","1300","1534.31159643","0.847285520766"
"SL2.50ch00:10068678-10069836","271","10068678","10069836","1158","1534.31159643","0.754735871575"
"SL2.50ch00:10073347-10074116","428","10073347","10074116","769","1534.31159643","0.501201973438"
"SL2.50ch00:10073370-10074157","428","10073370","10074157","787","1534.31159643","0.51293361911"
"SL2.50ch00:10077053-10077901","214","10077053","10077901","848","1534.31159643","0.552690862777"
"SL2.50ch00:10083573-10085215","276","10083573","10085215","1642","1534.31159643","1.07018678854"
"SL2.50ch00:10103542-10104151","205","10103542","10104151","609","1534.31159643","0.396920678574"
"SL2.50ch00:10103592-10104363","242","10103592","10104363","771","1534.31159643","0.502505489623"
"SL2.50ch00:10105958-10106333","92","10105958","10106333","375","1534.31159643","0.244409284836"
"SL2.50ch00:10110853-10111334","96","10110853","10111334","481","1534.31159643","0.313495642683"
"SL2.50ch00:10117330-10118340","368","10117330","10118340","1010","1534.31159643","0.658275673826"
"SL2.50ch00:10120640-10122337","543","10120640","10122337","1697","1534.31159643","1.10603348365"
"SL2.50ch00:10152857-10156261","851","10152857","10156261","3404","1534.31159643","2.21858454822"
"SL2.50ch00:10157394-10158622","355","10157394","10158622","1228","1534.31159643","0.800358938077"
"SL2.50ch00:10272174-10272805","221","10272174","10272805","631","1534.31159643","0.411259356618"
"SL2.50ch00:10272195-10272892","227","10272195","10272892","697","1534.31159643","0.454275390749"
"SL2.50ch00:10279897-10280460","169","10279897","10280460","563","1534.31159643","0.366939806301"
"SL2.50ch00:10282406-10282910","146","10282406","10282910","504","1534.31159643","0.32848607882"
"SL2.50ch00:10282428-10283039","161","10282428","10283039","611","1534.31159643","0.39822419476"
"SL2.50ch00:10289371-10289773","119","10289371","10289773","402","1534.31159643","0.262006753345"
"SL2.50ch00:10289429-10289804","118","10289429","10289804","375","1534.31159643","0.244409284836"
"SL2.50ch00:10290747-10292202","322","10290747","10292202","1455","1534.31159643","0.948308025165"
"SL2.50ch00:10297658-10298405","348","10297658","10298405","747","1534.31159643","0.486863295394"
"SL2.50ch00:10297803-10298602","382","10297803","10298602","799","1534.31159643","0.520754716225"
"SL2.50ch00:10299758-10300798","269","10299758","10300798","1040","1534.31159643","0.677828416613"
"SL2.50ch00:10299813-10300215","119","10299813","10300215","402","1534.31159643","0.262006753345"
"SL2.50ch00:10302537-10303498","219","10302537","10303498","961","1534.31159643","0.626339527274"
"SL2.50ch00:10307200-10307668","117","10307200","10307668","468","1534.31159643","0.305022787476"
"SL2.50ch00:10310433-10311167","152","10310433","10311167","734","1534.31159643","0.478390440186"
"SL2.50ch00:10312893-10313507","200","10312893","10313507","614","1534.31159643","0.400179469039"
"SL2.50ch00:10399133-10400855","966","10399133","10400855","1722","1534.31159643","1.12232743597"
"SL2.50ch00:10399171-10400736","961","10399171","10400736","1565","1534.31159643","1.02000141538"
"SL2.50ch00:10401963-10403672","991","10401963","10403672","1709","1534.31159643","1.11385458076"
"SL2.50ch00:10402027-10403625","978","10402027","10403625","1598","1534.31159643","1.04150943245"
"SL2.50ch00:10405076-10406218","332","10405076","10406218","1142","1534.31159643","0.744307742088"
"SL2.50ch00:10410779-10412076","753","10410779","10412076","1297","1534.31159643","0.845330246487"
"SL2.50ch00:10410836-10412161","723","10410836","10412161","1325","1534.31159643","0.863579473088"
"SL2.50ch00:10413868-10414445","167","10413868","10414445","577","1534.31159643","0.376064419601"
"SL2.50ch00:10413950-10414440","160","10413950","10414440","490","1534.31159643","0.319361465519"
"SL2.50ch00:10421276-10421986","229","10421276","10421986","710","1534.31159643","0.462748245957"
"SL2.50ch00:10421280-10421993","229","10421280","10421993","713","1534.31159643","0.464703520235"
"SL2.50ch00:10423987-10424619","170","10423987","10424619","632","1534.31159643","0.411911114711"
"SL2.50ch00:10424007-10424533","148","10424007","10424533","526","1534.31159643","0.342824756864"
"SL2.50ch00:10428514-10429841","721","10428514","10429841","1327","1534.31159643","0.864882989274"
"SL2.50ch00:10428531-10429778","718","10428531","10429778","1247","1534.31159643","0.812742341842"
"SL2.50ch00:10431271-10432050","195","10431271","10432050","779","1534.31159643","0.507719554367"
"SL2.50ch00:10438285-10439172","231","10438285","10439172","887","1534.31159643","0.5781094284"
"SL2.50ch00:10438383-10439152","206","10438383","10439152","769","1534.31159643","0.501201973438"
"SL2.50ch00:10478820-10479373","120","10478820","10479373","553","1534.31159643","0.360422225372"
"SL2.50ch00:10479107-10484403","1306","10479107","10484403","5296","1534.31159643","3.45171085998"
"SL2.50ch00:10480220-10481435","343","10480220","10481435","1215","1534.31159643","0.79188608287"
"SL2.50ch00:10483452-10484394","294","10483452","10484394","942","1534.31159643","0.613956123509"
"SL2.50ch00:10485674-10487518","974","10485674","10487518","1844","1534.31159643","1.2018419233"
"SL2.50ch00:10485719-10487540","972","10485719","10487540","1821","1534.31159643","1.18685148717"
"SL2.50ch00:10489689-10497666","1894","10489689","10497666","7977","1534.31159643","5.19907430704"
"SL2.50ch00:10508251-10508728","140","10508251","10508728","477","1534.31159643","0.310888610312"
"SL2.50ch00:10574785-10576108","668","10574785","10576108","1323","1534.31159643","0.862275956903"
"SL2.50ch00:10574831-10576116","668","10574831","10576116","1285","1534.31159643","0.837509149372"
"SL2.50ch00:10577299-10578748","294","10577299","10578748","1449","1534.31159643","0.944397476608"
"SL2.50ch00:10583343-10583980","138","10583343","10583980","637","1534.31159643","0.415169905175"
"SL2.50ch00:10588089-10588760","189","10588089","10588760","671","1534.31159643","0.437329680334"
"SL2.50ch00:10591312-10591687","73","10591312","10591687","375","1534.31159643","0.244409284836"
"SL2.50ch00:10600386-10601998","404","10600386","10601998","1612","1534.31159643","1.05063404575"
"SL2.50ch00:10600469-10602059","398","10600469","10602059","1590","1534.31159643","1.03629536771"
"SL2.50ch00:10604587-10606328","1600","10604587","10606328","1741","1534.31159643","1.13471083973"
"SL2.50ch00:10604706-10606192","1581","10604706","10606192","1486","1534.31159643","0.968512526045"
"SL2.50ch00:10607825-10610081","1730","10607825","10610081","2256","1534.31159643","1.47036625758"
"SL2.50ch00:10607848-10610097","1730","10607848","10610097","2249","1534.31159643","1.46580395093"
"SL2.50ch00:10617034-10618103","1433","10617034","10618103","1069","1534.31159643","0.696729401307"
"SL2.50ch00:10617090-10618160","1398","10617090","10618160","1070","1534.31159643","0.6973811594"
"SL2.50ch00:10627406-10628362","1382","10627406","10628362","956","1534.31159643","0.623080736809"
"SL2.50ch00:10627454-10628374","1378","10627454","10628374","920","1534.31159643","0.599617445465"
"SL2.50ch00:10630273-10630919","549","10630273","10630919","646","1534.31159643","0.421035728011"
"SL2.50ch00:10630313-10630931","549","10630313","10630931","618","1534.31159643","0.40278650141"
"SL2.50ch00:10632641-10636726","2966","10632641","10636726","4085","1534.31159643","2.66243180948"
"SL2.50ch00:10632670-10636807","2966","10632670","10636807","4137","1534.31159643","2.69632323031"
"SL2.50ch00:10638561-10640200","2840","10638561","10640200","1639","1534.31159643","1.06823151426"
"SL2.50ch00:10638566-10640222","2840","10638566","10640222","1656","1534.31159643","1.07931140184"
"SL2.50ch00:10642060-10643975","2062","10642060","10643975","1915","1534.31159643","1.2481167479"
"SL2.50ch00:10642075-10643948","2062","10642075","10643948","1873","1534.31159643","1.220742908"
"SL2.50ch00:10644516-10645812","872","10644516","10645812","1296","1534.31159643","0.844678488394"
"SL2.50ch00:10644553-10646100","893","10644553","10646100","1547","1534.31159643","1.00826976971"
"SL2.50ch00:10651669-10652308","381","10651669","10652308","639","1534.31159643","0.416473421361"
"SL2.50ch00:10651733-10652250","378","10651733","10652250","517","1534.31159643","0.336958934028"
"SL2.50ch00:10653445-10654617","593","10653445","10654617","1172","1534.31159643","0.763860484875"
"SL2.50ch00:10653567-10654616","586","10653567","10654616","1049","1534.31159643","0.683694239449"
"SL2.50ch00:10656054-10657819","630","10656054","10657819","1765","1534.31159643","1.15035303396"
"SL2.50ch00:10656702-10657333","325","10656702","10657333","631","1534.31159643","0.411259356618"
"SL2.50ch00:10659590-10661157","340","10659590","10661157","1567","1534.31159643","1.02130493157"
"SL2.50ch00:10663998-10664883","2924","10663998","10664883","885","1534.31159643","0.576805912214"
"SL2.50ch00:10664107-10664878","2915","10664107","10664878","771","1534.31159643","0.502505489623"
"SL2.50ch00:10665525-10666271","4782","10665525","10666271","746","1534.31159643","0.486211537301"
"SL2.50ch00:10665549-10666165","4781","10665549","10666165","616","1534.31159643","0.401482985224"
"SL2.50ch00:10667219-10669649","17912","10667219","10669649","2430","1534.31159643","1.58377216574"
"SL2.50ch00:10667221-10669653","17912","10667221","10669653","2432","1534.31159643","1.58507568193"
"SL2.50ch00:10672295-10673041","3751","10672295","10673041","746","1534.31159643","0.486211537301"
"SL2.50ch00:10672304-10672930","3749","10672304","10672930","626","1534.31159643","0.408000566153"
"SL2.50ch00:10675322-10676638","4106","10675322","10676638","1316","1534.31159643","0.857713650252"
"SL2.50ch00:10675696-10676599","4048","10675696","10676599","903","1534.31159643","0.588537557886"
"SL2.50ch00:10680469-10686449","48690","10680469","10686449","5980","1534.31159643","3.89751339552"
"SL2.50ch00:10680581-10686405","48474","10680581","10686405","5824","1534.31159643","3.79583913303"
"SL2.50ch00:10687257-10692751","43736","10687257","10692751","5494","1534.31159643","3.58075896238"
"SL2.50ch00:10687260-10692761","43728","10687260","10692761","5501","1534.31159643","3.58532126903"
"SL2.50ch00:10721753-10722752","370","10721753","10722752","999","1534.31159643","0.651106334804"
"SL2.50ch00:10721893-10722560","330","10721893","10722560","667","1534.31159643","0.434722647962"
"SL2.50ch00:10729271-10730740","1288","10729271","10730740","1469","1534.31159643","0.957432638466"
"SL2.50ch00:10729580-10730684","1236","10729580","10730684","1104","1534.31159643","0.719540934558"
"SL2.50ch00:10731598-10733261","1252","10731598","10733261","1663","1534.31159643","1.08387370849"
"SL2.50ch00:10731625-10733902","1366","10731625","10733902","2277","1534.31159643","1.48405317753"
"SL2.50ch00:10734439-10737127","527","10734439","10737127","2688","1534.31159643","1.75192575371"
"SL2.50ch00:10743514-10745178","748","10743514","10745178","1664","1534.31159643","1.08452546658"
"SL2.50ch00:10743570-10745184","747","10743570","10745184","1614","1534.31159643","1.05193756194"
"SL2.50ch00:10746690-10748940","689","10746690","10748940","2250","1534.31159643","1.46645570902"
"SL2.50ch00:10746769-10748824","676","10746769","10748824","2055","1534.31159643","1.3393628809"
"SL2.50ch00:10776565-10777782","445","10776565","10777782","1217","1534.31159643","0.793189599056"
"SL2.50ch00:10776577-10777822","445","10776577","10777822","1245","1534.31159643","0.811438825657"
"SL2.50ch00:10778513-10781161","613","10778513","10781161","2648","1534.31159643","1.72585542999"
"SL2.50ch00:10779975-10780768","260","10779975","10780768","793","1534.31159643","0.516844167667"
"SL2.50ch00:10782742-10784037","417","10782742","10784037","1295","1534.31159643","0.844026730301"
"SL2.50ch00:10783290-10784024","302","10783290","10784024","734","1534.31159643","0.478390440186"
"SL2.50ch00:10788553-10789259","349","10788553","10789259","706","1534.31159643","0.460141213585"
"SL2.50ch00:10788579-10789335","344","10788579","10789335","756","1534.31159643","0.49272911823"
"SL2.50ch00:10793408-10794020","173","10793408","10794020","612","1534.31159643","0.398875952853"
"SL2.50ch00:10793503-10794068","182","10793503","10794068","565","1534.31159643","0.368243322487"
"SL2.50ch00:10798377-10803492","1412","10798377","10803492","5115","1534.31159643","3.33374264517"
"SL2.50ch00:10799123-10801716","718","10799123","10801716","2593","1534.31159643","1.69000873488"
"SL2.50ch00:10802224-10803463","460","10802224","10803463","1239","1534.31159643","0.807528277099"
"SL2.50ch00:10830671-10832340","1533","10830671","10832340","1669","1534.31159643","1.08778425704"
"SL2.50ch00:10830806-10832251","1533","10830806","10832251","1445","1534.31159643","0.941790444236"
"SL2.50ch00:10834870-10835856","892","10834870","10835856","986","1534.31159643","0.642633479596"
"SL2.50ch00:10834926-10835824","892","10834926","10835824","898","1534.31159643","0.585278767421"
"SL2.50ch00:10842008-10842648","240","10842008","10842648","640","1534.31159643","0.417125179454"
"SL2.50ch00:10842053-10842619","240","10842053","10842619","566","1534.31159643","0.36889508058"
"SL2.50ch00:10843914-10845152","446","10843914","10845152","1238","1534.31159643","0.806876519006"
"SL2.50ch00:10843953-10845180","441","10843953","10845180","1227","1534.31159643","0.799707179984"
"SL2.50ch00:10846121-10847059","723","10846121","10847059","938","1534.31159643","0.611349091137"
"SL2.50ch00:10846196-10847084","723","10846196","10847084","888","1534.31159643","0.578761186492"
"SL2.50ch00:10848766-10850022","684","10848766","10850022","1256","1534.31159643","0.818608164678"
"SL2.50ch00:10848805-10849925","679","10848805","10849925","1120","1534.31159643","0.729969064045"
"SL2.50ch00:10854412-10857486","1055","10854412","10857486","3074","1534.31159643","2.00350437757"
"SL2.50ch00:10854918-10857521","966","10854918","10857521","2603","1534.31159643","1.69652631581"
"SL2.50ch00:10910102-10911481","992","10910102","10911481","1379","1534.31159643","0.898774410105"
"SL2.50ch00:10910311-10911494","955","10910311","10911494","1183","1534.31159643","0.771029823897"
"SL2.50ch00:10913428-10914869","484","10913428","10914869","1441","1534.31159643","0.939183411864"
"SL2.50ch00:10914169-10914811","379","10914169","10914811","642","1534.31159643","0.41842869564"
"SL2.50ch00:10917251-10919712","2907","10917251","10919712","2461","1534.31159643","1.60397666662"
"SL2.50ch00:10917300-10919792","2895","10917300","10919792","2492","1534.31159643","1.6241811675"
"SL2.50ch00:10926668-10929216","1387","10926668","10929216","2548","1534.31159643","1.6606796207"
"SL2.50ch00:10926758-10928802","1289","10926758","10928802","2044","1534.31159643","1.33219354188"
"SL2.50ch00:10931044-10933170","962","10931044","10933170","2126","1534.31159643","1.3856377055"
"SL2.50ch00:10931734-10933100","839","10931734","10933100","1366","1534.31159643","0.890301554897"
"SL2.50ch00:10935727-10937883","558","10935727","10937883","2156","1534.31159643","1.40519044829"
"SL2.50ch00:10938577-10943962","1627","10938577","10943962","5385","1534.31159643","3.50971733025"
"SL2.50ch00:10945239-10960714","4027","10945239","10960714","15475","1534.31159643","10.0859564876"
"SL2.50ch00:10963562-10964175","176","10963562","10964175","613","1534.31159643","0.399527710946"
"SL2.50ch00:10971080-10972214","343","10971080","10972214","1134","1534.31159643","0.739093677345"
"SL2.50ch00:10984444-10986807","839","10984444","10986807","2363","1534.31159643","1.54010437352"
"SL2.50ch00:10985206-10986760","731","10985206","10986760","1554","1534.31159643","1.01283207636"
"SL2.50ch00:10990730-10992093","616","10990730","10992093","1363","1534.31159643","0.888346280618"
"SL2.50ch00:10990771-10995810","1563","10990771","10995810","5039","1534.31159643","3.28420903011"
"SL2.50ch00:10994218-10995817","547","10994218","10995817","1599","1534.31159643","1.04216119054"
"SL2.50ch00:10998634-11000359","678","10998634","11000359","1725","1534.31159643","1.12428271025"
"SL2.50ch00:10998654-11000328","678","10998654","11000328","1674","1534.31159643","1.09104304751"
"SL2.50ch00:11004911-11007134","1055","11004911","11007134","2223","1534.31159643","1.44885824051"
"SL2.50ch00:11004923-11006797","943","11004923","11006797","1874","1534.31159643","1.22139466609"
"SL2.50ch00:11012419-11012887","131","11012419","11012887","468","1534.31159643","0.305022787476"
"SL2.50ch00:11016290-11017393","182","11016290","11017393","1103","1534.31159643","0.718889176465"
"SL2.50ch00:11028979-11029941","200","11028979","11029941","962","1534.31159643","0.626991285367"
"SL2.50ch00:11031485-11032090","120","11031485","11032090","605","1534.31159643","0.394313646203"
"SL2.50ch00:11049670-11050591","224","11049670","11050591","921","1534.31159643","0.600269203558"
"SL2.50ch00:11054991-11077454","148148","11054991","11077454","22463","1534.31159643","14.6404420407"
"SL2.50ch00:11055017-11077585","148148","11055017","11077585","22568","1534.31159643","14.7088766405"
"SL2.50ch00:11141791-11146360","1246","11141791","11146360","4569","1534.31159643","2.97788272645"
"SL2.50ch00:11147045-11148514","543","11147045","11148514","1469","1534.31159643","0.957432638466"
"SL2.50ch00:11147182-11148410","524","11147182","11148410","1228","1534.31159643","0.800358938077"
"SL2.50ch00:11154592-11157099","514","11154592","11157099","2507","1534.31159643","1.63395753889"
"SL2.50ch00:11154826-11155353","100","11154826","11155353","527","1534.31159643","0.343476514957"
"SL2.50ch00:11160641-11161016","66","11160641","11161016","375","1534.31159643","0.244409284836"
"SL2.50ch00:11182279-11182999","233","11182279","11182999","720","1534.31159643","0.469265826886"
"SL2.50ch00:11184514-11185940","420","11184514","11185940","1426","1534.31159643","0.929407040471"
"SL2.50ch00:11239906-11240870","325","11239906","11240870","964","1534.31159643","0.628294801553"
"SL2.50ch00:11239935-11240870","325","11239935","11240870","935","1534.31159643","0.609393816859"
"SL2.50ch00:11242494-11243677","395","11242494","11243677","1183","1534.31159643","0.771029823897"
"SL2.50ch00:11242536-11243721","398","11242536","11243721","1185","1534.31159643","0.772333340083"
"SL2.50ch00:11244921-11246560","608","11244921","11246560","1639","1534.31159643","1.06823151426"
"SL2.50ch00:11245111-11246527","584","11245111","11246527","1416","1534.31159643","0.922889459542"
"SL2.50ch00:11251420-11254477","1039","11251420","11254477","3057","1534.31159643","1.99242448999"
"SL2.50ch00:11251474-11254488","1027","11251474","11254488","3014","1534.31159643","1.96439889199"
"SL2.50ch00:11256104-11258743","637","11256104","11258743","2639","1534.31159643","1.71998960715"
"SL2.50ch00:11256374-11257628","402","11256374","11257628","1254","1534.31159643","0.817304648493"
"SL2.50ch00:11295429-11296112","158","11295429","11296112","683","1534.31159643","0.445150777449"
"SL2.50ch00:11297140-11297876","175","11297140","11297876","736","1534.31159643","0.479693956372"
"SL2.50ch00:11297467-11297869","125","11297467","11297869","402","1534.31159643","0.262006753345"
"SL2.50ch00:11301310-11301925","203","11301310","11301925","615","1534.31159643","0.400831227132"
"SL2.50ch00:11301387-11302198","247","11301387","11302198","811","1534.31159643","0.528575813339"
"SL2.50ch00:11302688-11304930","441","11302688","11304930","2242","1534.31159643","1.46124164427"
"SL2.50ch00:11307746-11308433","201","11307746","11308433","687","1534.31159643","0.44775780982"
"SL2.50ch00:11310302-11313701","2079","11310302","11313701","3399","1534.31159643","2.21532575776"
"SL2.50ch00:11311042-11313666","1970","11311042","11313666","2624","1534.31159643","1.71021323576"
"SL2.50ch00:11314480-11315945","1265","11314480","11315945","1465","1534.31159643","0.954825606094"
"SL2.50ch00:11314530-11315863","1258","11314530","11315863","1333","1534.31159643","0.868793537832"
"SL2.50ch00:11316956-11318788","689","11316956","11318788","1832","1534.31159643","1.19402082619"
"SL2.50ch00:11317113-11318869","675","11317113","11318869","1756","1534.31159643","1.14448721113"
"SL2.50ch00:11321897-11325977","1162","11321897","11325977","4080","1534.31159643","2.65917301902"
"SL2.50ch00:11327058-11336556","2300","11327058","11336556","9498","1534.31159643","6.19039836633"
"SL2.50ch00:11337168-11343493","1769","11337168","11343493","6325","1534.31159643","4.12236993757"
"SL2.50ch00:11337773-11339163","473","11337773","11339163","1390","1534.31159643","0.905943749127"
"SL2.50ch00:11343876-11345462","360","11343876","11345462","1586","1534.31159643","1.03368833533"
"SL2.50ch00:11362940-11363777","522","11362940","11363777","837","1534.31159643","0.545521523755"
"SL2.50ch00:11362979-11363782","520","11362979","11363782","803","1534.31159643","0.523361748596"
"SL2.50ch00:11369292-11373961","1396","11369292","11373961","4669","1534.31159643","3.04305853574"
"SL2.50ch00:11373131-11374061","391","11373131","11374061","930","1534.31159643","0.606135026394"
"SL2.50ch00:11377817-11379373","730","11377817","11379373","1556","1534.31159643","1.01413559255"
"SL2.50ch00:11377836-11379479","730","11377836","11379479","1643","1534.31159643","1.07083854663"
"SL2.50ch00:11396266-11398043","899","11396266","11398043","1777","1534.31159643","1.15817413108"
"SL2.50ch00:11396295-11398007","898","11396295","11398007","1712","1534.31159643","1.11580985504"
"SL2.50ch00:11398903-11404492","2551","11398903","11404492","5589","1534.31159643","3.6426759812"
"SL2.50ch00:11398925-11404518","2551","11398925","11404518","5593","1534.31159643","3.64528301357"
"SL2.50ch00:11411150-11412562","896","11411150","11412562","1412","1534.31159643","0.92028242717"
"SL2.50ch00:11411231-11412588","869","11411231","11412588","1357","1534.31159643","0.884435732061"
"SL2.50ch00:11443795-11444573","200","11443795","11444573","778","1534.31159643","0.507067796274"
"SL2.50ch00:11490691-11491635","316","11490691","11491635","944","1534.31159643","0.615259639695"
"SL2.50ch00:11490713-11491534","316","11490713","11491534","821","1534.31159643","0.535093394268"
"SL2.50ch00:11492659-11494444","484","11492659","11494444","1785","1534.31159643","1.16338819582"
"SL2.50ch00:11495655-11497053","608","11495655","11497053","1398","1534.31159643","0.91115781387"
"SL2.50ch00:11495656-11497040","608","11495656","11497040","1384","1534.31159643","0.902033200569"
"SL2.50ch00:11499356-11501332","853","11499356","11501332","1976","1534.31159643","1.28787399156"
"SL2.50ch00:11499356-11501348","853","11499356","11501348","1992","1534.31159643","1.29830212105"
"SL2.50ch00:11501840-11503210","578","11501840","11503210","1370","1534.31159643","0.892908587269"
"SL2.50ch00:11501878-11503235","578","11501878","11503235","1357","1534.31159643","0.884435732061"
"SL2.50ch00:11504335-11505258","506","11504335","11505258","923","1534.31159643","0.601572719744"
"SL2.50ch00:11504386-11505195","506","11504386","11505195","809","1534.31159643","0.527272297154"
"SL2.50ch00:11510011-11512517","603","11510011","11512517","2506","1534.31159643","1.6333057808"
"SL2.50ch00:11516726-11517650","234","11516726","11517650","924","1534.31159643","0.602224477837"
"SL2.50ch00:11534144-11548092","8361","11534144","11548092","13948","1534.31159643","9.09072187973"
"SL2.50ch00:11534489-11535256","280","11534489","11535256","767","1534.31159643","0.499898457252"
"SL2.50ch00:11542527-11545428","2581","11542527","11545428","2901","1534.31159643","1.89075022749"
"SL2.50ch00:11545960-11547723","751","11545960","11547723","1763","1534.31159643","1.14904951778"
"SL2.50ch00:11565406-11566479","232","11565406","11566479","1073","1534.31159643","0.699336433678"
"SL2.50ch00:11569964-11571143","231","11569964","11571143","1179","1534.31159643","0.768422791525"
"SL2.50ch00:11570173-11570575","106","11570173","11570575","402","1534.31159643","0.262006753345"
"SL2.50ch00:11573020-11573805","158","11573020","11573805","785","1534.31159643","0.511630102924"
"SL2.50ch00:11576933-11591013","4778","11576933","11591013","14080","1534.31159643","9.17675394799"
"SL2.50ch00:11577013-11583000","2804","11577013","11583000","5987","1534.31159643","3.90207570217"
"SL2.50ch00:11655359-11656929","2090","11655359","11656929","1570","1534.31159643","1.02326020585"
"SL2.50ch00:11655417-11656972","2076","11655417","11656972","1555","1534.31159643","1.01348383445"
"SL2.50ch00:11658393-11659374","559","11658393","11659374","981","1534.31159643","0.639374689132"
"SL2.50ch00:11658447-11659399","559","11658447","11659399","952","1534.31159643","0.620473704438"
"SL2.50ch00:11685655-11686839","417","11685655","11686839","1184","1534.31159643","0.77168158199"
"SL2.50ch00:11685700-11686817","417","11685700","11686817","1117","1534.31159643","0.728013789766"
"SL2.50ch00:11687539-11689544","955","11687539","11689544","2005","1534.31159643","1.30677497626"
"SL2.50ch00:11687544-11689658","955","11687544","11689658","2114","1534.31159643","1.37781660838"
"SL2.50ch00:11690433-11694263","1335","11690433","11694263","3830","1534.31159643","2.4962334958"
"SL2.50ch00:11690522-11694248","1327","11690522","11694248","3726","1534.31159643","2.42845065413"
"SL2.50ch00:11695274-11695742","182","11695274","11695742","468","1534.31159643","0.305022787476"
"SL2.50ch00:11697453-11698498","525","11697453","11698498","1045","1534.31159643","0.681087207077"
"SL2.50ch00:11697579-11698449","516","11697579","11698449","870","1534.31159643","0.56702954082"
"SL2.50ch00:11736294-11738166","1823","11736294","11738166","1872","1534.31159643","1.2200911499"
"SL2.50ch00:11736370-11738125","1823","11736370","11738125","1755","1534.31159643","1.14383545303"
"SL2.50ch00:11740279-11741152","179","11740279","11741152","873","1534.31159643","0.568984815099"
"SL2.50ch00:11773889-11775693","9610","11773889","11775693","1804","1534.31159643","1.17577159959"
"SL2.50ch00:11773930-11775744","9536","11773930","11775744","1814","1534.31159643","1.18228918051"
"SL2.50ch00:11777422-11778524","7023","11777422","11778524","1102","1534.31159643","0.718237418372"
"SL2.50ch00:11777442-11778421","6950","11777442","11778421","979","1534.31159643","0.638071172946"
"SL2.50ch00:11780867-11786256","25026","11780867","11786256","5389","1534.31159643","3.51232436262"
"SL2.50ch00:11780912-11782044","5939","11780912","11782044","1132","1534.31159643","0.737790161159"
"SL2.50ch00:11782605-11786189","19009","11782605","11786189","3584","1534.31159643","2.33590100494"
"SL2.50ch00:11789557-11790432","301","11789557","11790432","875","1534.31159643","0.570288331285"
"SL2.50ch00:11796774-11810562","92012","11796774","11810562","13788","1534.31159643","8.98644058486"
"SL2.50ch00:11796775-11811812","92188","11796775","11811812","15037","1534.31159643","9.80048644289"
"SL2.50ch00:11811283-11817977","1306","11811283","11817977","6694","1534.31159643","4.36286867385"
"SL2.50ch00:11818814-11820433","424","11818814","11820433","1619","1534.31159643","1.0551963524"
"SL2.50ch00:11851604-11851979","149","11851604","11851979","375","1534.31159643","0.244409284836"
"SL2.50ch00:11855458-11855833","93","11855458","11855833","375","1534.31159643","0.244409284836"
"SL2.50ch00:11857566-11868424","3098","11857566","11868424","10858","1534.31159643","7.07678937267"
"SL2.50ch00:11879807-11880392","123","11879807","11880392","585","1534.31159643","0.381278484345"
"SL2.50ch00:11901041-11902147","271","11901041","11902147","1106","1534.31159643","0.720844450744"
"SL2.50ch00:11919197-11920404","229","11919197","11920404","1207","1534.31159643","0.786672018127"
"SL2.50ch00:11934789-11936007","534","11934789","11936007","1218","1534.31159643","0.793841357148"
"SL2.50ch00:11934833-11935949","526","11934833","11935949","1116","1534.31159643","0.727362031673"
"SL2.50ch00:11944452-11945184","390","11944452","11945184","732","1534.31159643","0.477086924001"
"SL2.50ch00:11944467-11945834","460","11944467","11945834","1367","1534.31159643","0.89095331299"
"SL2.50ch00:11966673-11976948","60879","11966673","11976948","10275","1534.31159643","6.69681440452"
"SL2.50ch00:11966734-11976905","60860","11966734","11976905","10171","1534.31159643","6.62903156285"
"SL2.50ch00:11986921-11988022","878","11986921","11988022","1101","1534.31159643","0.717585660279"
"SL2.50ch00:11986957-11988008","878","11986957","11988008","1051","1534.31159643","0.684997755635"
"SL2.50ch00:11990790-11991712","467","11990790","11991712","922","1534.31159643","0.600920961651"
"SL2.50ch00:11990864-11991745","462","11990864","11991745","881","1534.31159643","0.574198879842"
"SL2.50ch00:11993084-11994653","1679","11993084","11994653","1569","1534.31159643","1.02260844776"
"SL2.50ch00:11993089-11994652","1679","11993089","11994652","1563","1534.31159643","1.0186978992"
"SL2.50ch00:11996143-11996976","815","11996143","11996976","833","1534.31159643","0.542914491383"
"SL2.50ch00:11996180-11996906","811","11996180","11996906","726","1534.31159643","0.473176375443"
"SL2.50ch00:12006317-12016238","88912","12006317","12016238","9921","1534.31159643","6.46609203963"
"SL2.50ch00:12006345-12016217","88906","12006345","12016217","9872","1534.31159643","6.43415589308"
"SL2.50ch00:12039855-12043885","856","12039855","12043885","4030","1534.31159643","2.62658511437"
"SL2.50ch00:12088188-12089621","479","12088188","12089621","1433","1534.31159643","0.933969347121"
"SL2.50ch00:12088241-12089533","465","12088241","12089533","1292","1534.31159643","0.842071456023"
"SL2.50ch00:12090836-12091726","313","12090836","12091726","890","1534.31159643","0.580064702678"
"SL2.50ch00:12090867-12091866","303","12090867","12091866","999","1534.31159643","0.651106334804"
"SL2.50ch00:12128041-12153956","117716","12128041","12153956","25915","1534.31159643","16.8903109774"
"SL2.50ch00:12128092-12154010","117704","12128092","12154010","25918","1534.31159643","16.8922662517"
"SL2.50ch00:12212252-12219919","3162","12212252","12219919","7667","1534.31159643","4.99702929824"
"SL2.50ch00:12248404-12249285","174","12248404","12249285","881","1534.31159643","0.574198879842"
"SL2.50ch00:12265906-12282052","98972","12265906","12282052","16146","1534.31159643","10.5232861679"
"SL2.50ch00:12266755-12282024","98834","12266755","12282024","15269","1534.31159643","9.95169432044"
"SL2.50ch00:12300519-12302423","532","12300519","12302423","1904","1534.31159643","1.24094740888"
"SL2.50ch00:12312461-12319857","1882","12312461","12319857","7396","1534.31159643","4.82040285507"
"SL2.50ch00:12322111-12324059","432","12322111","12324059","1948","1534.31159643","1.26962476496"
"SL2.50ch00:12324604-12326161","452","12324604","12326161","1557","1534.31159643","1.01478735064"
"SL2.50ch00:12324740-12325271","176","12324740","12325271","531","1534.31159643","0.346083547328"
"SL2.50ch00:12349016-12349805","338","12349016","12349805","789","1534.31159643","0.514237135296"
"SL2.50ch00:12355984-12356471","100","12355984","12356471","487","1534.31159643","0.317406191241"
"SL2.50ch00:12441988-12442941","210","12441988","12442941","953","1534.31159643","0.621125462531"
"SL2.50ch00:12492797-12501111","2763","12492797","12501111","8314","1534.31159643","5.41871678434"
"SL2.50ch00:12504563-12505488","240","12504563","12505488","925","1534.31159643","0.60287623593"
"SL2.50ch00:12504566-12506165","328","12504566","12506165","1599","1534.31159643","1.04216119054"
"SL2.50ch00:12561348-12561723","114","12561348","12561723","375","1534.31159643","0.244409284836"
"SL2.50ch00:12569894-12572562","660","12569894","12572562","2668","1534.31159643","1.73889059185"
"SL2.50ch00:12643072-12645845","707","12643072","12645845","2773","1534.31159643","1.8073251916"
"SL2.50ch00:12646403-12647798","417","12646403","12647798","1395","1534.31159643","0.909202539591"
"SL2.50ch00:12704280-12705169","184","12704280","12705169","889","1534.31159643","0.579412944585"
"SL2.50ch00:12738178-12739382","228","12738178","12739382","1204","1534.31159643","0.784716743848"
"SL2.50ch00:12754371-12754746","202","12754371","12754746","375","1534.31159643","0.244409284836"
"SL2.50ch00:12756553-12757552","652","12756553","12757552","999","1534.31159643","0.651106334804"
"SL2.50ch00:12756615-12757494","642","12756615","12757494","879","1534.31159643","0.572895363656"
"SL2.50ch00:12758316-12760172","1808","12758316","12760172","1856","1534.31159643","1.20966302042"
"SL2.50ch00:12758317-12760287","1809","12758317","12760287","1970","1534.31159643","1.28396344301"
"SL2.50ch00:12772510-12779644","2415","12772510","12779644","7134","1534.31159643","4.64964223473"
"SL2.50ch00:12772651-12779661","2404","12772651","12779661","7010","1534.31159643","4.56882423121"
"SL2.50ch00:12781953-12784325","489","12781953","12784325","2372","1534.31159643","1.54597019635"
"SL2.50ch00:12953345-12958549","22024","12953345","12958549","5204","1534.31159643","3.39174911544"
"SL2.50ch00:12953394-12958782","22028","12953394","12958782","5388","1534.31159643","3.51167260453"
"SL2.50ch00:12971641-12972651","245","12971641","12972651","1010","1534.31159643","0.658275673826"
"SL2.50ch00:12976046-12981524","1595","12976046","12981524","5478","1534.31159643","3.57033083289"
"SL2.50ch00:13042994-13043992","331","13042994","13043992","998","1534.31159643","0.650454576711"
"SL2.50ch00:13048685-13050095","332","13048685","13050095","1410","1534.31159643","0.918978910985"
"SL2.50ch00:13050589-13050964","68","13050589","13050964","375","1534.31159643","0.244409284836"
"SL2.50ch00:13052284-13053828","417","13052284","13053828","1544","1534.31159643","1.00631449543"
"SL2.50ch00:13052293-13053790","407","13052293","13053790","1497","1534.31159643","0.975681865067"
"SL2.50ch00:13173739-13179206","2537","13173739","13179206","5467","1534.31159643","3.56316149387"
"SL2.50ch00:13173987-13179068","2504","13173987","13179068","5081","1534.31159643","3.31158287001"
"SL2.50ch00:13219018-13220754","360","13219018","13220754","1736","1534.31159643","1.13145204927"
"SL2.50ch00:13258573-13258948","71","13258573","13258948","375","1534.31159643","0.244409284836"
"SL2.50ch00:13301695-13302466","813","13301695","13302466","771","1534.31159643","0.502505489623"
"SL2.50ch00:13301745-13303148","957","13301745","13303148","1403","1534.31159643","0.914416604334"
"SL2.50ch00:13305430-13306986","473","13305430","13306986","1556","1534.31159643","1.01413559255"
"SL2.50ch00:13306127-13306954","370","13306127","13306954","827","1534.31159643","0.539003942826"
"SL2.50ch00:13374936-13375835","3749","13374936","13375835","899","1534.31159643","0.585930525514"
"SL2.50ch00:13374993-13375822","3745","13374993","13375822","829","1534.31159643","0.540307459012"
"SL2.50ch00:13379464-13380319","5870","13379464","13380319","855","1534.31159643","0.557253169427"
"SL2.50ch00:13379546-13380280","5696","13379546","13380280","734","1534.31159643","0.478390440186"
"SL2.50ch00:13386849-13388170","440","13386849","13388170","1321","1534.31159643","0.860972440717"
"SL2.50ch00:13447403-13448475","235","13447403","13448475","1072","1534.31159643","0.698684675585"
"SL2.50ch00:13460469-13460993","104","13460469","13460993","524","1534.31159643","0.341521240678"
"SL2.50ch00:13492816-13494529","568","13492816","13494529","1713","1534.31159643","1.11646161313"
"SL2.50ch00:13493331-13494493","502","13493331","13494493","1162","1534.31159643","0.757342903946"
"SL2.50ch00:13496795-13498327","638","13496795","13498327","1532","1534.31159643","0.998493398318"
"SL2.50ch00:13496804-13497997","552","13496804","13497997","1193","1534.31159643","0.777547404826"
"SL2.50ch00:13503303-13508274","12864","13503303","13508274","4971","1534.31159643","3.23988947979"
"SL2.50ch00:13503345-13507608","12703","13503345","13507608","4263","1534.31159643","2.77844475002"
"SL2.50ch00:13603324-13608439","26148","13603324","13608439","5115","1534.31159643","3.33374264517"
"SL2.50ch00:13603418-13608360","26147","13603418","13608360","4942","1534.31159643","3.2209884951"
"SL2.50ch00:13689138-13689838","446","13689138","13689838","700","1534.31159643","0.456230665028"
"SL2.50ch00:13689215-13689887","436","13689215","13689887","672","1534.31159643","0.437981438427"
"SL2.50ch00:13690527-13691502","411","13690527","13691502","975","1534.31159643","0.635464140574"
"SL2.50ch00:13764405-13769492","23199","13764405","13769492","5087","1534.31159643","3.31549341857"
"SL2.50ch00:13764739-13769522","23166","13764739","13769522","4783","1534.31159643","3.11735895833"
"SL2.50ch00:14016578-14019015","756","14016578","14019015","2437","1534.31159643","1.58833447239"
"SL2.50ch00:14094989-14095741","224","14094989","14095741","752","1534.31159643","0.490122085858"
"SL2.50ch00:14120397-14121433","474","14120397","14121433","1036","1534.31159643","0.675221384241"
"SL2.50ch00:14120464-14121414","465","14120464","14121414","950","1534.31159643","0.619170188252"
"SL2.50ch00:14123247-14124871","460","14123247","14124871","1624","1534.31159643","1.05845514286"
"SL2.50ch00:14123639-14124892","394","14123639","14124892","1253","1534.31159643","0.8166528904"
"SL2.50ch00:14257651-14258925","239","14257651","14258925","1274","1534.31159643","0.830339810351"
"SL2.50ch00:14287141-14287908","376","14287141","14287908","767","1534.31159643","0.499898457252"
"SL2.50ch00:14287299-14287967","381","14287299","14287967","668","1534.31159643","0.435374406055"
"SL2.50ch00:14290568-14291564","1079","14290568","14291564","996","1534.31159643","0.649151060525"
"SL2.50ch00:14290600-14291614","1079","14290600","14291614","1014","1534.31159643","0.660882706197"
"SL2.50ch00:14292320-14292792","127","14292320","14292792","472","1534.31159643","0.307629819847"
"SL2.50ch00:14299681-14300277","119","14299681","14300277","596","1534.31159643","0.388447823367"
"SL2.50ch00:14314021-14314511","134","14314021","14314511","490","1534.31159643","0.319361465519"
"SL2.50ch00:14314090-14314978","199","14314090","14314978","888","1534.31159643","0.578761186492"
"SL2.50ch00:14316774-14318231","412","14316774","14318231","1457","1534.31159643","0.949611541351"
"SL2.50ch00:14409505-14410967","446","14409505","14410967","1462","1534.31159643","0.952870331815"
"SL2.50ch00:14409706-14410980","413","14409706","14410980","1274","1534.31159643","0.830339810351"
"SL2.50ch00:14437531-14441662","3176","14437531","14441662","4131","1534.31159643","2.69241268176"
"SL2.50ch00:14437552-14441686","3164","14437552","14441686","4134","1534.31159643","2.69436795604"
"SL2.50ch00:14505167-14506310","478","14505167","14506310","1143","1534.31159643","0.744959500181"
"SL2.50ch00:14505245-14506926","625","14505245","14506926","1681","1534.31159643","1.09560535416"
"SL2.50ch00:14507589-14508079","405","14507589","14508079","490","1534.31159643","0.319361465519"
"SL2.50ch00:14510907-14511410","227","14510907","14511410","503","1534.31159643","0.327834320727"
"SL2.50ch00:14510996-14511371","219","14510996","14511371","375","1534.31159643","0.244409284836"
"SL2.50ch00:14514668-14515895","321","14514668","14515895","1227","1534.31159643","0.799707179984"
"SL2.50ch00:14514736-14515408","238","14514736","14515408","672","1534.31159643","0.437981438427"
"SL2.50ch00:14520230-14525038","1186","14520230","14525038","4808","1534.31159643","3.13365291065"
"SL2.50ch00:14545956-14550551","39891","14545956","14550551","4595","1534.31159643","2.99482843686"
"SL2.50ch00:14545963-14550341","39883","14545963","14550341","4378","1534.31159643","2.8533969307"
"SL2.50ch00:14558944-14559319","67","14558944","14559319","375","1534.31159643","0.244409284836"
"SL2.50ch00:14561327-14562517","227","14561327","14562517","1190","1534.31159643","0.775592130547"
"SL2.50ch00:14571931-14572899","278","14571931","14572899","968","1534.31159643","0.630901833924"
"SL2.50ch00:14575076-14576030","332","14575076","14576030","954","1534.31159643","0.621777220624"
"SL2.50ch00:14635309-14636138","240","14635309","14636138","829","1534.31159643","0.540307459012"
"SL2.50ch00:14637586-14637961","67","14637586","14637961","375","1534.31159643","0.244409284836"
"SL2.50ch00:14644994-14645671","163","14644994","14645671","677","1534.31159643","0.441240228891"
"SL2.50ch00:14648440-14648944","154","14648440","14648944","504","1534.31159643","0.32848607882"
"SL2.50ch00:14656365-14657036","166","14656365","14657036","671","1534.31159643","0.437329680334"
"SL2.50ch00:14662175-14662732","126","14662175","14662732","557","1534.31159643","0.363029257744"
"SL2.50ch00:14665278-14665926","166","14665278","14665926","648","1534.31159643","0.422339244197"
"SL2.50ch00:14665313-14665877","164","14665313","14665877","564","1534.31159643","0.367591564394"
"SL2.50ch00:14670501-14675782","15804","14670501","14675782","5281","1534.31159643","3.44193448859"
"SL2.50ch00:14670522-14675771","15804","14670522","14675771","5249","1534.31159643","3.42107822962"
"SL2.50ch00:14677217-14679031","2252","14677217","14679031","1814","1534.31159643","1.18228918051"
"SL2.50ch00:14677253-14679141","2262","14677253","14679141","1888","1534.31159643","1.23051927939"
"SL2.50ch00:14696361-14697794","477","14696361","14697794","1433","1534.31159643","0.933969347121"
"SL2.50ch00:14763890-14767757","899","14763890","14767757","3867","1534.31159643","2.52034854523"
"SL2.50ch00:14796450-14797304","450","14796450","14797304","854","1534.31159643","0.556601411334"
"SL2.50ch00:14801775-14802268","161","14801775","14802268","493","1534.31159643","0.321316739798"
"SL2.50ch00:14801812-14802187","160","14801812","14802187","375","1534.31159643","0.244409284836"
"SL2.50ch00:14804036-14805741","1859","14804036","14805741","1705","1534.31159643","1.11124754839"
"SL2.50ch00:14804047-14805761","1859","14804047","14805761","1714","1534.31159643","1.11711337123"
"SL2.50ch00:14887886-14889159","360","14887886","14889159","1273","1534.31159643","0.829688052258"
"SL2.50ch00:14959706-14961350","510","14959706","14961350","1644","1534.31159643","1.07149030472"
"SL2.50ch00:14962620-14963671","604","14962620","14963671","1051","1534.31159643","0.684997755635"
"SL2.50ch00:14962621-14963717","604","14962621","14963717","1096","1534.31159643","0.714326869815"
"SL2.50ch00:14992372-14993724","290","14992372","14993724","1352","1534.31159643","0.881176941597"
"SL2.50ch00:14994688-14996344","395","14994688","14996344","1656","1534.31159643","1.07931140184"
"SL2.50ch00:14999654-15000532","355","14999654","15000532","878","1534.31159643","0.572243605563"
"SL2.50ch00:14999679-15000674","354","14999679","15000674","995","1534.31159643","0.648499302432"
"SL2.50ch00:15070855-15071640","200","15070855","15071640","785","1534.31159643","0.511630102924"
"SL2.50ch00:15134766-15135403","130","15134766","15135403","637","1534.31159643","0.415169905175"
"SL2.50ch00:15136958-15137695","163","15136958","15137695","737","1534.31159643","0.480345714465"
"SL2.50ch00:15138696-15139752","434","15138696","15139752","1056","1534.31159643","0.688256546099"
"SL2.50ch00:15142584-15146512","1552","15142584","15146512","3928","1534.31159643","2.5601057889"
"SL2.50ch00:15144506-15146445","896","15144506","15146445","1939","1534.31159643","1.26375894213"
"SL2.50ch00:15289995-15291411","360","15289995","15291411","1416","1534.31159643","0.922889459542"
"SL2.50ch00:15290061-15291623","381","15290061","15291623","1562","1534.31159643","1.0180461411"
"SL2.50ch00:15292978-15293623","159","15292978","15293623","645","1534.31159643","0.420383969918"
"SL2.50ch00:15313988-15314494","117","15313988","15314494","506","1534.31159643","0.329789595006"
"SL2.50ch00:15316587-15317171","157","15316587","15317171","584","1534.31159643","0.380626726252"
"SL2.50ch00:15321351-15322481","740","15321351","15322481","1130","1534.31159643","0.736486644973"
"SL2.50ch00:15321397-15322339","740","15321397","15322339","942","1534.31159643","0.613956123509"
"SL2.50ch00:15324295-15325261","698","15324295","15325261","966","1534.31159643","0.629598317738"
"SL2.50ch00:15324356-15325273","697","15324356","15325273","917","1534.31159643","0.597662171186"
"SL2.50ch00:15345089-15346312","357","15345089","15346312","1223","1534.31159643","0.797100147613"
"SL2.50ch00:15348029-15348863","766","15348029","15348863","834","1534.31159643","0.543566249476"
"SL2.50ch00:15348054-15348898","766","15348054","15348898","844","1534.31159643","0.550083830405"
"SL2.50ch00:15360589-15361715","466","15360589","15361715","1126","1534.31159643","0.733879612602"
"SL2.50ch00:15360750-15361620","466","15360750","15361620","870","1534.31159643","0.56702954082"
"SL2.50ch00:15363027-15364516","484","15363027","15364516","1489","1534.31159643","0.970467800323"
"SL2.50ch00:15385655-15387683","407","15385655","15387683","2028","1534.31159643","1.32176541239"
"SL2.50ch00:15450306-15451191","174","15450306","15451191","885","1534.31159643","0.576805912214"
"SL2.50ch00:15452774-15453783","407","15452774","15453783","1009","1534.31159643","0.657623915733"
"SL2.50ch00:15452872-15453851","415","15452872","15453851","979","1534.31159643","0.638071172946"
"SL2.50ch00:15473228-15477148","2082","15473228","15477148","3920","1534.31159643","2.55489172416"
"SL2.50ch00:15473356-15477106","2082","15473356","15477106","3750","1534.31159643","2.44409284836"
"SL2.50ch00:15526084-15526576","99","15526084","15526576","492","1534.31159643","0.320664981705"
"SL2.50ch00:15534724-15536198","2988","15534724","15536198","1474","1534.31159643","0.96069142893"
"SL2.50ch00:15534728-15536278","2988","15534728","15536278","1550","1534.31159643","1.01022504399"
"SL2.50ch00:15538066-15542541","27203","15538066","15542541","4475","1534.31159643","2.91661746571"
"SL2.50ch00:15538082-15542586","27203","15538082","15542586","4504","1534.31159643","2.93551845041"
"SL2.50ch00:15813963-15814651","458","15813963","15814651","688","1534.31159643","0.448409567913"
"SL2.50ch00:15813982-15814619","458","15813982","15814619","637","1534.31159643","0.415169905175"
"SL2.50ch00:15816197-15816760","148","15816197","15816760","563","1534.31159643","0.366939806301"
"SL2.50ch00:15864409-15865185","207","15864409","15865185","776","1534.31159643","0.505764280088"
"SL2.50ch00:15877069-15880573","1611","15877069","15880573","3504","1534.31159643","2.28376035751"
"SL2.50ch00:15877180-15880658","1597","15877180","15880658","3478","1534.31159643","2.2668146471"
"SL2.50ch00:15884540-15887881","714","15884540","15887881","3341","1534.31159643","2.17752378837"
"SL2.50ch00:15902889-15903811","256","15902889","15903811","922","1534.31159643","0.600920961651"
"SL2.50ch00:15905703-15906313","281","15905703","15906313","610","1534.31159643","0.397572436667"
"SL2.50ch00:15905756-15906358","277","15905756","15906358","602","1534.31159643","0.392358371924"
"SL2.50ch00:15917581-15920900","848","15917581","15920900","3319","1534.31159643","2.16318511032"
"SL2.50ch00:15961446-15961917","173","15961446","15961917","471","1534.31159643","0.306978061754"
"SL2.50ch00:15963788-15964915","451","15963788","15964915","1127","1534.31159643","0.734531370695"
"SL2.50ch00:15964462-15964952","333","15964462","15964952","490","1534.31159643","0.319361465519"
"SL2.50ch00:15997704-16001211","1421","15997704","16001211","3507","1534.31159643","2.28571563179"
"SL2.50ch00:16026783-16030116","1702","16026783","16030116","3333","1534.31159643","2.17230972363"
"SL2.50ch00:16026828-16030185","1694","16026828","16030185","3357","1534.31159643","2.18795191785"
"SL2.50ch00:16051815-16055485","25059","16051815","16055485","3670","1534.31159643","2.39195220093"
"SL2.50ch00:16051850-16055438","25059","16051850","16055438","3588","1534.31159643","2.33850803731"
"SL2.50ch00:16145175-16146605","258","16145175","16146605","1430","1534.31159643","0.932014072843"
"SL2.50ch00:16180766-16184283","20158","16180766","16184283","3517","1534.31159643","2.29223321272"
"SL2.50ch00:16180773-16184261","20106","16180773","16184261","3488","1534.31159643","2.27333222802"
"SL2.50ch00:16195117-16198253","873","16195117","16198253","3136","1534.31159643","2.04391337932"
"SL2.50ch00:16243371-16243856","91","16243371","16243856","485","1534.31159643","0.316102675055"
"SL2.50ch00:16246848-16247320","150","16246848","16247320","472","1534.31159643","0.307629819847"
"SL2.50ch00:16302660-16303035","79","16302660","16303035","375","1534.31159643","0.244409284836"
"SL2.50ch00:16310899-16312329","840","16310899","16312329","1430","1534.31159643","0.932014072843"
"SL2.50ch00:16310933-16312394","838","16310933","16312394","1461","1534.31159643","0.952218573722"
"SL2.50ch00:16313954-16314469","232","16313954","16314469","515","1534.31159643","0.335655417842"
"SL2.50ch00:16313979-16314448","232","16313979","16314448","469","1534.31159643","0.305674545569"
"SL2.50ch00:16384258-16388143","1268","16384258","16388143","3885","1534.31159643","2.5320801909"
"SL2.50ch00:16390456-16390831","69","16390456","16390831","375","1534.31159643","0.244409284836"
"SL2.50ch00:16397852-16401510","17411","16397852","16401510","3658","1534.31159643","2.38413110382"
"SL2.50ch00:16397959-16401520","17408","16397959","16401520","3561","1534.31159643","2.32091056881"
"SL2.50ch00:16531803-16534845","1074","16531803","16534845","3042","1534.31159643","1.98264811859"
"SL2.50ch00:16548958-16549602","195","16548958","16549602","644","1534.31159643","0.419732211826"
"SL2.50ch00:16562327-16565754","1461","16562327","16565754","3427","1534.31159643","2.23357498436"
"SL2.50ch00:16562526-16565671","1445","16562526","16565671","3145","1534.31159643","2.04977920216"
"SL2.50ch00:16636903-16639894","9504","16636903","16639894","2991","1534.31159643","1.94940845585"
"SL2.50ch00:16636951-16639807","9388","16636951","16639807","2856","1534.31159643","1.86142111331"
"SL2.50ch00:16661189-16666628","1738","16661189","16666628","5439","1534.31159643","3.54491226727"
"SL2.50ch00:16797300-16797965","163","16797300","16797965","665","1534.31159643","0.433419131776"
"SL2.50ch00:16901241-16904600","2866","16901241","16904600","3359","1534.31159643","2.18925543404"
"SL2.50ch00:16901244-16904630","2866","16901244","16904630","3386","1534.31159643","2.20685290255"
"SL2.50ch00:16950123-16951238","657","16950123","16951238","1115","1534.31159643","0.72671027358"
"SL2.50ch00:16950220-16951183","657","16950220","16951183","963","1534.31159643","0.62764304346"
"SL2.50ch00:16952572-16953439","544","16952572","16953439","867","1534.31159643","0.565074266542"
"SL2.50ch00:16952601-16953386","544","16952601","16953386","785","1534.31159643","0.511630102924"
"SL2.50ch00:16962948-16963999","999","16962948","16963999","1051","1534.31159643","0.684997755635"
"SL2.50ch00:16963037-16964051","997","16963037","16964051","1014","1534.31159643","0.660882706197"
"SL2.50ch00:16965773-16966395","525","16965773","16966395","622","1534.31159643","0.405393533782"
"SL2.50ch00:16965798-16966412","525","16965798","16966412","614","1534.31159643","0.400179469039"
"SL2.50ch00:17011555-17014738","1165","17011555","17014738","3183","1534.31159643","2.07454600969"
"SL2.50ch00:17011559-17012573","391","17011559","17012573","1014","1534.31159643","0.660882706197"
"SL2.50ch00:17013165-17014373","573","17013165","17014373","1208","1534.31159643","0.787323776219"
"SL2.50ch00:17108285-17108956","159","17108285","17108956","671","1534.31159643","0.437329680334"
"SL2.50ch00:17155453-17158858","18909","17155453","17158858","3405","1534.31159643","2.21923630631"
"SL2.50ch00:17155518-17158822","18906","17155518","17158822","3304","1534.31159643","2.15340873893"
"SL2.50ch00:17231414-17234424","1171","17231414","17234424","3010","1534.31159643","1.96179185962"
"SL2.50ch00:17232073-17233272","572","17232073","17233272","1199","1534.31159643","0.781457953383"
"SL2.50ch00:17297353-17300479","1122","17297353","17300479","3126","1534.31159643","2.0373957984"
"SL2.50ch00:17347262-17350306","1381","17347262","17350306","3044","1534.31159643","1.98395163478"
"SL2.50ch00:17347394-17350094","1332","17347394","17350094","2700","1534.31159643","1.75974685082"
"SL2.50ch00:17458431-17461337","1272","17458431","17461337","2906","1534.31159643","1.89400901796"
"SL2.50ch00:17458519-17461249","1246","17458519","17461249","2730","1534.31159643","1.77929959361"
"SL2.50ch00:17522838-17525278","7002","17522838","17525278","2440","1534.31159643","1.59028974667"
"SL2.50ch00:17522877-17525089","6949","17522877","17525089","2212","1534.31159643","1.44168890149"
"SL2.50ch00:17634706-17637644","3488","17634706","17637644","2938","1534.31159643","1.91486527693"
"SL2.50ch00:17634719-17637657","3488","17634719","17637657","2938","1534.31159643","1.91486527693"
"SL2.50ch00:17652904-17654436","538","17652904","17654436","1532","1534.31159643","0.998493398318"
"SL2.50ch00:17676871-17678777","352","17676871","17678777","1906","1534.31159643","1.24225092506"
"SL2.50ch00:17745760-17747595","320","17745760","17747595","1835","1534.31159643","1.19597610047"
"SL2.50ch00:17769299-17772197","1135","17769299","17772197","2898","1534.31159643","1.88879495322"
"SL2.50ch00:17769615-17772018","1066","17769615","17772018","2403","1534.31159643","1.56617469723"
"SL2.50ch00:17840045-17843138","16331","17840045","17843138","3093","1534.31159643","2.01588778133"
"SL2.50ch00:17840185-17843265","16356","17840185","17843265","3080","1534.31159643","2.00741492612"
"SL2.50ch00:17905540-17907366","341","17905540","17907366","1826","1534.31159643","1.19011027763"
"SL2.50ch00:18009693-18011842","512","18009693","18011842","2149","1534.31159643","1.40062814164"
"SL2.50ch00:18038596-18041304","691","18038596","18041304","2708","1534.31159643","1.76496091556"
"SL2.50ch00:18047321-18054356","4654","18047321","18054356","7035","1534.31159643","4.58511818353"
"SL2.50ch00:18049820-18050552","1139","18049820","18050552","732","1534.31159643","0.477086924001"
"SL2.50ch00:18051280-18053653","2627","18051280","18053653","2373","1534.31159643","1.54662195444"
"SL2.50ch00:18116521-18121684","2406","18116521","18121684","5163","1534.31159643","3.36502703363"
"SL2.50ch00:18118169-18120210","1168","18118169","18120210","2041","1534.31159643","1.3302382676"
"SL2.50ch00:18193929-18194470","112","18193929","18194470","541","1534.31159643","0.352601128257"
"SL2.50ch00:18228173-18230903","1201","18228173","18230903","2730","1534.31159643","1.77929959361"
"SL2.50ch00:18228196-18232576","1519","18228196","18232576","4380","1534.31159643","2.85470044689"
"SL2.50ch00:18254468-18256503","561","18254468","18256503","2035","1534.31159643","1.32632771905"
"SL2.50ch00:18254666-18256425","521","18254666","18256425","1759","1534.31159643","1.14644248541"
"SL2.50ch00:1830139-1830734","108","1830139","1830734","595","1534.31159643","0.387796065274"
"SL2.50ch00:18315727-18318694","8617","18315727","18318694","2967","1534.31159643","1.93376626163"
"SL2.50ch00:18315918-18318654","8614","18315918","18318654","2736","1534.31159643","1.78321014217"
"SL2.50ch00:18352239-18355419","20721","18352239","18355419","3180","1534.31159643","2.07259073541"
"SL2.50ch00:18352393-18355388","20714","18352393","18355388","2995","1534.31159643","1.95201548823"
"SL2.50ch00:1836924-1838142","238","1836924","1838142","1218","1534.31159643","0.793841357148"
"SL2.50ch00:18372252-18372987","158","18372252","18372987","735","1534.31159643","0.479042198279"
"SL2.50ch00:18432610-18433394","353","18432610","18433394","784","1534.31159643","0.510978344831"
"SL2.50ch00:18432644-18433447","354","18432644","18433447","803","1534.31159643","0.523361748596"
"SL2.50ch00:18444937-18445406","167","18444937","18445406","469","1534.31159643","0.305674545569"
"SL2.50ch00:18489945-18491175","783","18489945","18491175","1230","1534.31159643","0.801662454263"
"SL2.50ch00:18490219-18491195","734","18490219","18491195","976","1534.31159643","0.636115898667"
"SL2.50ch00:18581801-18582319","125","18581801","18582319","518","1534.31159643","0.337610692121"
"SL2.50ch00:18581886-18583006","223","18581886","18583006","1120","1534.31159643","0.729969064045"
"SL2.50ch00:18649038-18651648","920","18649038","18651648","2610","1534.31159643","1.70108862246"
"SL2.50ch00:18776724-18779463","1653","18776724","18779463","2739","1534.31159643","1.78516541644"
"SL2.50ch00:18776886-18779460","1653","18776886","18779460","2574","1534.31159643","1.67762533112"
"SL2.50ch00:1883241-1883777","141","1883241","1883777","536","1534.31159643","0.349342337793"
"SL2.50ch00:18865873-18866449","146","18865873","18866449","576","1534.31159643","0.375412661509"
"SL2.50ch00:18867384-18867973","136","18867384","18867973","589","1534.31159643","0.383885516716"
"SL2.50ch00:18909152-18911104","500","18909152","18911104","1952","1534.31159643","1.27223179733"
"SL2.50ch00:19091722-19094319","1794","19091722","19094319","2597","1534.31159643","1.69261576725"
"SL2.50ch00:19091741-19094360","1791","19091741","19094360","2619","1534.31159643","1.7069544453"
"SL2.50ch00:19120479-19124133","13805","19120479","19124133","3654","1534.31159643","2.38152407145"
"SL2.50ch00:19120488-19123280","13675","19120488","19123280","2792","1534.31159643","1.81970859537"
"SL2.50ch00:19155843-19156218","84","19155843","19156218","375","1534.31159643","0.244409284836"
"SL2.50ch00:19180993-19181586","131","19180993","19181586","593","1534.31159643","0.386492549088"
"SL2.50ch00:19308101-19310396","1116","19308101","19310396","2295","1534.31159643","1.4957848232"
"SL2.50ch00:19308172-19311107","1185","19308172","19311107","2935","1534.31159643","1.91291000265"
"SL2.50ch00:19321130-19323261","478","19321130","19323261","2131","1534.31159643","1.38889649596"
"SL2.50ch00:19374797-19377125","917","19374797","19377125","2328","1534.31159643","1.51729284026"
"SL2.50ch00:19374876-19377056","895","19374876","19377056","2180","1534.31159643","1.42083264252"
"SL2.50ch00:19408083-19410487","1282","19408083","19410487","2404","1534.31159643","1.56682645532"
"SL2.50ch00:19408199-19410489","1253","19408199","19410489","2290","1534.31159643","1.49252603273"
"SL2.50ch00:19415732-19418158","739","19415732","19418158","2426","1534.31159643","1.58116513337"
"SL2.50ch00:19613012-19615919","38261","19613012","19615919","2907","1534.31159643","1.89466077605"
"SL2.50ch00:19613176-19615825","38233","19613176","19615825","2649","1534.31159643","1.72650718808"
"SL2.50ch00:19656464-19656866","1919","19656464","19656866","402","1534.31159643","0.262006753345"
"SL2.50ch00:19703176-19705907","3272","19703176","19705907","2731","1534.31159643","1.7799513517"
"SL2.50ch00:19703304-19705795","3245","19703304","19705795","2491","1534.31159643","1.62352940941"
"SL2.50ch00:19810081-19812489","1722","19810081","19812489","2408","1534.31159643","1.5694334877"
"SL2.50ch00:19810215-19812401","1721","19810215","19812401","2186","1534.31159643","1.42474319107"
"SL2.50ch00:19862505-19864234","329","19862505","19864234","1729","1534.31159643","1.12688974262"
"SL2.50ch00:19915870-19918441","11403","19915870","19918441","2571","1534.31159643","1.67567005684"
"SL2.50ch00:19915931-19918385","11403","19915931","19918385","2454","1534.31159643","1.59941435997"
"SL2.50ch00:19964876-19967243","6707","19964876","19967243","2367","1534.31159643","1.54271140589"
"SL2.50ch00:19964877-19967210","6707","19964877","19967210","2333","1534.31159643","1.52055163073"
"SL2.50ch00:19980390-19980765","96","19980390","19980765","375","1534.31159643","0.244409284836"
"SL2.50ch00:19987604-19989029","586","19987604","19989029","1425","1534.31159643","0.928755282378"
"SL2.50ch00:19987776-19988410","380","19987776","19988410","634","1534.31159643","0.413214630897"
"SL2.50ch00:20025559-20028106","1090","20025559","20028106","2547","1534.31159643","1.66002786261"
"SL2.50ch00:20025779-20028021","1083","20025779","20028021","2242","1534.31159643","1.46124164427"
"SL2.50ch00:20087085-20087673","131","20087085","20087673","588","1534.31159643","0.383233758623"
"SL2.50ch00:20105409-20107747","724","20105409","20107747","2338","1534.31159643","1.52381042119"
"SL2.50ch00:20154072-20154447","80","20154072","20154447","375","1534.31159643","0.244409284836"
"SL2.50ch00:20160747-20163181","4747","20160747","20163181","2434","1534.31159643","1.58637919811"
"SL2.50ch00:20160753-20164220","4906","20160753","20164220","3467","1534.31159643","2.25964530807"
"SL2.50ch00:20274369-20275198","168","20274369","20275198","829","1534.31159643","0.540307459012"
"SL2.50ch00:20292130-20292754","610","20292130","20292754","624","1534.31159643","0.406697049968"
"SL2.50ch00:20292136-20292792","604","20292136","20292792","656","1534.31159643","0.42755330894"
"SL2.50ch00:20365202-20366162","488","20365202","20366162","960","1534.31159643","0.625687769181"
"SL2.50ch00:20365252-20366596","583","20365252","20366596","1344","1534.31159643","0.875962876853"
"SL2.50ch00:20415259-20416048","154","20415259","20416048","789","1534.31159643","0.514237135296"
"SL2.50ch00:20426279-20428437","600","20426279","20428437","2158","1534.31159643","1.40649396447"
"SL2.50ch00:20491822-20493794","1016","20491822","20493794","1972","1534.31159643","1.28526695919"
"SL2.50ch00:20491861-20493799","999","20491861","20493799","1938","1534.31159643","1.26310718403"
"SL2.50ch00:20541255-20542338","244","20541255","20542338","1083","1534.31159643","0.705854014607"
"SL2.50ch00:20624146-20626211","444","20624146","20626211","2065","1534.31159643","1.34588046183"
"SL2.50ch00:20749039-20749529","2394","20749039","20749529","490","1534.31159643","0.319361465519"
"SL2.50ch00:20777892-20780054","750","20777892","20780054","2162","1534.31159643","1.40910099684"
"SL2.50ch00:20777928-20780073","749","20777928","20780073","2145","1534.31159643","1.39802110926"
"SL2.50ch00:20830117-20830945","1106","20830117","20830945","828","1534.31159643","0.539655700919"
"SL2.50ch00:20831384-20832346","1379","20831384","20832346","962","1534.31159643","0.626991285367"
"SL2.50ch00:20864130-20866078","567","20864130","20866078","1948","1534.31159643","1.26962476496"
"SL2.50ch00:20877605-20879666","469","20877605","20879666","2061","1534.31159643","1.34327342946"
"SL2.50ch00:20882046-20884435","4086","20882046","20884435","2389","1534.31159643","1.55705008393"
"SL2.50ch00:20882211-20884411","4048","20882211","20884411","2200","1534.31159643","1.43386780437"
"SL2.50ch00:20906990-20907526","223","20906990","20907526","536","1534.31159643","0.349342337793"
"SL2.50ch00:20907076-20907657","228","20907076","20907657","581","1534.31159643","0.378671451973"
"SL2.50ch00:20997901-20998276","77","20997901","20998276","375","1534.31159643","0.244409284836"
"SL2.50ch00:21017370-21018552","289","21017370","21018552","1182","1534.31159643","0.770378065804"
"SL2.50ch00:21068452-21068922","105","21068452","21068922","470","1534.31159643","0.306326303662"
"SL2.50ch00:21112860-21114851","512","21112860","21114851","1991","1534.31159643","1.29765036296"
"SL2.50ch00:21135383-21137048","374","21135383","21137048","1665","1534.31159643","1.08517722467"
"SL2.50ch00:21140175-21141383","264","21140175","21141383","1208","1534.31159643","0.787323776219"
"SL2.50ch00:21146047-21148307","5112","21146047","21148307","2260","1534.31159643","1.47297328995"
"SL2.50ch00:21146234-21148270","5104","21146234","21148270","2036","1534.31159643","1.32697947714"
"SL2.50ch00:2114778-2115273","104","2114778","2115273","495","1534.31159643","0.322620255984"
"SL2.50ch00:21175156-21176844","507","21175156","21176844","1688","1534.31159643","1.10016766081"
"SL2.50ch00:21199214-21203993","2070","21199214","21203993","4779","1534.31159643","3.11475192595"
"SL2.50ch00:21260908-21263725","697","21260908","21263725","2817","1534.31159643","1.83600254769"
"SL2.50ch00:21271895-21273771","492","21271895","21273771","1876","1534.31159643","1.22269818227"
"SL2.50ch00:21272346-21273820","386","21272346","21273820","1474","1534.31159643","0.96069142893"
"SL2.50ch00:21287473-21289324","406","21287473","21289324","1851","1534.31159643","1.20640422995"
"SL2.50ch00:21346188-21348062","382","21346188","21348062","1874","1534.31159643","1.22139466609"
"SL2.50ch00:21458881-21460878","2129","21458881","21460878","1997","1534.31159643","1.30156091152"
"SL2.50ch00:21459024-21459995","1642","21459024","21459995","971","1534.31159643","0.632857108203"
"SL2.50ch00:21473169-21473936","240","21473169","21473936","767","1534.31159643","0.499898457252"
"SL2.50ch00:2151036-2151770","340","2151036","2151770","734","1534.31159643","0.478390440186"
"SL2.50ch00:2151057-2151741","334","2151057","2151741","684","1534.31159643","0.445802535541"
"SL2.50ch00:2152489-2152891","131","2152489","2152891","402","1534.31159643","0.262006753345"
"SL2.50ch00:21534339-21536482","9849","21534339","21536482","2143","1534.31159643","1.39671759308"
"SL2.50ch00:21534363-21537085","9940","21534363","21537085","2722","1534.31159643","1.77408552887"
"SL2.50ch00:21544987-21546892","931","21544987","21546892","1905","1534.31159643","1.24159916697"
"SL2.50ch00:21545035-21546976","947","21545035","21546976","1941","1534.31159643","1.26506245831"
"SL2.50ch00:2157345-2158512","285","2157345","2158512","1167","1534.31159643","0.760601694411"
"SL2.50ch00:21609018-21609938","2552","21609018","21609938","920","1534.31159643","0.599617445465"
"SL2.50ch00:21609031-21609863","2546","21609031","21609863","832","1534.31159643","0.54226273329"
"SL2.50ch00:21610783-21611254","361","21610783","21611254","471","1534.31159643","0.306978061754"
"SL2.50ch00:2165440-2166114","192","2165440","2166114","674","1534.31159643","0.439284954612"
"SL2.50ch00:2165627-2166029","171","2165627","2166029","402","1534.31159643","0.262006753345"
"SL2.50ch00:21668893-21669745","193","21668893","21669745","852","1534.31159643","0.555297895148"
"SL2.50ch00:21692017-21694258","13112","21692017","21694258","2241","1534.31159643","1.46058988618"
"SL2.50ch00:21692070-21694331","13114","21692070","21694331","2261","1534.31159643","1.47362504804"
"SL2.50ch00:21703332-21704354","298","21703332","21704354","1022","1534.31159643","0.666096770941"
"SL2.50ch00:21747207-21748979","615","21747207","21748979","1772","1534.31159643","1.15491534061"
"SL2.50ch00:21747247-21748966","609","21747247","21748966","1719","1534.31159643","1.12037216169"
"SL2.50ch00:21751352-21752240","211","21751352","21752240","888","1534.31159643","0.578761186492"
"SL2.50ch00:21763890-21765924","809","21763890","21765924","2034","1534.31159643","1.32567596095"
"SL2.50ch00:21763905-21765944","809","21763905","21765944","2039","1534.31159643","1.32893475142"
"SL2.50ch00:21774465-21776250","656","21774465","21776250","1785","1534.31159643","1.16338819582"
"SL2.50ch00:21774521-21776451","670","21774521","21776451","1930","1534.31159643","1.25789311929"
"SL2.50ch00:2348499-2348989","127","2348499","2348989","490","1534.31159643","0.319361465519"
"SL2.50ch00:2742385-2742760","85","2742385","2742760","375","1534.31159643","0.244409284836"
"SL2.50ch00:2919366-2920938","492","2919366","2920938","1572","1534.31159643","1.02456372203"
"SL2.50ch00:4157735-4160963","6964","4157735","4160963","3228","1534.31159643","2.10387512387"
"SL2.50ch00:4157848-4160945","6964","4157848","4160945","3097","1534.31159643","2.0184948137"
"SL2.50ch00:4161576-4164455","2535","4161576","4164455","2879","1534.31159643","1.87641154945"
"SL2.50ch00:4161731-4164605","2511","4161731","4164605","2874","1534.31159643","1.87315275899"
"SL2.50ch00:4167825-4177058","6507","4167825","4177058","9233","1534.31159643","6.01768247172"
"SL2.50ch00:4167834-4176955","6507","4167834","4176955","9121","1534.31159643","5.94468556531"
"SL2.50ch00:4197207-4198392","15318","4197207","4198392","1185","1534.31159643","0.772333340083"
"SL2.50ch00:4276977-4277379","2515","4276977","4277379","402","1534.31159643","0.262006753345"
"SL2.50ch00:4773375-4774141","158","4773375","4774141","766","1534.31159643","0.499246699159"
"SL2.50ch00:5602034-5602409","74","5602034","5602409","375","1534.31159643","0.244409284836"
"SL2.50ch00:5616669-5620459","967","5616669","5620459","3790","1534.31159643","2.47016317208"
"SL2.50ch00:5642165-5643281","276","5642165","5643281","1116","1534.31159643","0.727362031673"
"SL2.50ch00:5659910-5662237","451","5659910","5662237","2327","1534.31159643","1.51664108217"
"SL2.50ch00:5662920-5664620","380","5662920","5664620","1700","1534.31159643","1.10798875792"
"SL2.50ch00:5670417-5671518","499","5670417","5671518","1101","1534.31159643","0.717585660279"
"SL2.50ch00:5670439-5671502","481","5670439","5671502","1063","1534.31159643","0.692818852749"
"SL2.50ch00:5679179-5680540","343","5679179","5680540","1361","1534.31159643","0.887042764433"
"SL2.50ch00:5688585-5688960","81","5688585","5688960","375","1534.31159643","0.244409284836"
"SL2.50ch00:5695677-5696236","109","5695677","5696236","559","1534.31159643","0.364332773929"
"SL2.50ch00:5702468-5702843","67","5702468","5702843","375","1534.31159643","0.244409284836"
"SL2.50ch00:5732107-5733246","221","5732107","5733246","1139","1534.31159643","0.74235246781"
"SL2.50ch00:6142753-6143436","132","6142753","6143436","683","1534.31159643","0.445150777449"
"SL2.50ch00:7117964-7119699","420","7117964","7119699","1735","1534.31159643","1.13080029118"
"SL2.50ch00:7130210-7132708","432","7130210","7132708","2498","1534.31159643","1.62809171606"
"SL2.50ch00:7367820-7369727","1194","7367820","7369727","1907","1534.31159643","1.24290268315"
"SL2.50ch00:7367872-7369698","1194","7367872","7369698","1826","1534.31159643","1.19011027763"
"SL2.50ch00:7371640-7372542","674","7371640","7372542","902","1534.31159643","0.587885799793"
"SL2.50ch00:7371735-7372618","628","7371735","7372618","883","1534.31159643","0.575502396028"
"SL2.50ch00:7384065-7384798","228","7384065","7384798","733","1534.31159643","0.477738682093"
"SL2.50ch00:7397012-7399682","483","7397012","7399682","2670","1534.31159643","1.74019410803"
"SL2.50ch00:7401785-7404433","578","7401785","7404433","2648","1534.31159643","1.72585542999"
"SL2.50ch00:7416709-7434427","8465","7416709","7434427","17718","1534.31159643","11.5478498899"
"SL2.50ch00:7416807-7433524","8271","7416807","7433524","16717","1534.31159643","10.895440039"
"SL2.50ch00:7439145-7440035","414","7439145","7440035","890","1534.31159643","0.580064702678"
"SL2.50ch00:7439325-7440043","391","7439325","7440043","718","1534.31159643","0.4679623107"
"SL2.50ch00:7445572-7446525","343","7445572","7446525","953","1534.31159643","0.621125462531"
"SL2.50ch00:7445981-7446383","195","7445981","7446383","402","1534.31159643","0.262006753345"
"SL2.50ch00:7446992-7448000","293","7446992","7448000","1008","1534.31159643","0.65697215764"
"SL2.50ch00:7447280-7447799","209","7447280","7447799","519","1534.31159643","0.338262450213"
"SL2.50ch00:7450965-7451996","392","7450965","7451996","1031","1534.31159643","0.671962593777"
"SL2.50ch00:7451097-7452137","411","7451097","7452137","1040","1534.31159643","0.677828416613"
"SL2.50ch00:7460262-7460761","143","7460262","7460761","499","1534.31159643","0.325227288356"
"SL2.50ch00:7471507-7476253","1378","7471507","7476253","4746","1534.31159643","3.09324390889"
"SL2.50ch00:7479522-7487142","1774","7479522","7487142","7620","1534.31159643","4.96639666787"
"SL2.50ch00:7490725-7500229","2429","7490725","7500229","9504","1534.31159643","6.19430891489"
"SL2.50ch00:7491792-7492302","127","7491792","7492302","510","1534.31159643","0.332396627377"
"SL2.50ch00:7498586-7501310","720","7498586","7501310","2724","1534.31159643","1.77538904505"
"SL2.50ch00:7500620-7506914","1519","7500620","7506914","6294","1534.31159643","4.10216543669"
"SL2.50ch00:7509669-7510801","189","7509669","7510801","1132","1534.31159643","0.737790161159"
"SL2.50ch00:7541050-7541518","102","7541050","7541518","468","1534.31159643","0.305022787476"
"SL2.50ch00:7579530-7579932","429","7579530","7579932","402","1534.31159643","0.262006753345"
"SL2.50ch00:7590284-7591139","158","7590284","7591139","855","1534.31159643","0.557253169427"
"SL2.50ch00:7606252-7607258","206","7606252","7607258","1006","1534.31159643","0.655668641454"
"SL2.50ch00:7616018-7616990","184","7616018","7616990","972","1534.31159643","0.633508866296"
"SL2.50ch00:7620526-7621681","204","7620526","7621681","1155","1534.31159643","0.752780597296"
"SL2.50ch00:7656885-7660433","825","7656885","7660433","3548","1534.31159643","2.3124377136"
"SL2.50ch00:7661081-7669795","2237","7661081","7669795","8714","1534.31159643","5.6794200215"
"SL2.50ch00:7662946-7664855","425","7662946","7664855","1909","1534.31159643","1.24420619934"
"SL2.50ch00:7672626-7673795","224","7672626","7673795","1169","1534.31159643","0.761905210596"
"SL2.50ch00:7691533-7692347","184","7691533","7692347","814","1534.31159643","0.530531087618"
"SL2.50ch00:7713420-7713893","104","7713420","7713893","473","1534.31159643","0.30828157794"
"SL2.50ch00:7719006-7719514","109","7719006","7719514","508","1534.31159643","0.331093111192"
"SL2.50ch00:7721181-7722021","336","7721181","7722021","840","1534.31159643","0.547476798033"
"SL2.50ch00:7721239-7722046","333","7721239","7722046","807","1534.31159643","0.525968780968"
"SL2.50ch00:7730321-7731140","178","7730321","7731140","819","1534.31159643","0.533789878083"
"SL2.50ch00:7739489-7740197","147","7739489","7740197","708","1534.31159643","0.461444729771"
"SL2.50ch00:7754040-7755275","225","7754040","7755275","1235","1534.31159643","0.804921244728"
"SL2.50ch00:7756901-7757369","89","7756901","7757369","468","1534.31159643","0.305022787476"
"SL2.50ch00:7766690-7769066","405","7766690","7769066","2376","1534.31159643","1.54857722872"
"SL2.50ch00:7785059-7785575","114","7785059","7785575","516","1534.31159643","0.336307175935"
"SL2.50ch00:7799390-7806858","3161","7799390","7806858","7468","1534.31159643","4.86732943775"
"SL2.50ch00:7799454-7806901","3161","7799454","7806901","7447","1534.31159643","4.8536425178"
"SL2.50ch00:7809268-7810269","284","7809268","7810269","1001","1534.31159643","0.65240985099"
"SL2.50ch00:7809711-7810220","137","7809711","7810220","509","1534.31159643","0.331744869285"
"SL2.50ch00:7814168-7815414","353","7814168","7815414","1246","1534.31159643","0.81209058375"
"SL2.50ch00:7818076-7820680","1122","7818076","7820680","2604","1534.31159643","1.6971780739"
"SL2.50ch00:7818077-7820656","1122","7818077","7820656","2579","1534.31159643","1.68088412158"
"SL2.50ch00:7828668-7844046","4278","7828668","7844046","15378","1534.31159643","10.0227359526"
"SL2.50ch00:7831950-7832440","148","7831950","7832440","490","1534.31159643","0.319361465519"
"SL2.50ch00:7844567-7847469","787","7844567","7847469","2902","1534.31159643","1.89140198559"
"SL2.50ch00:7851428-7857297","1655","7851428","7857297","5869","1534.31159643","3.82516824721"
"SL2.50ch00:7851906-7852308","113","7851906","7852308","402","1534.31159643","0.262006753345"
"SL2.50ch00:7859979-7865114","1387","7859979","7865114","5135","1534.31159643","3.34677780703"
"SL2.50ch00:7874772-7875536","159","7874772","7875536","764","1534.31159643","0.497943182973"
"SL2.50ch00:7905436-7905913","102","7905436","7905913","477","1534.31159643","0.310888610312"
"SL2.50ch00:7908163-7909949","442","7908163","7909949","1786","1534.31159643","1.16403995391"
"SL2.50ch00:7908165-7909400","339","7908165","7909400","1235","1534.31159643","0.804921244728"
"SL2.50ch00:7919055-7921461","502","7919055","7921461","2406","1534.31159643","1.56812997151"
"SL2.50ch00:7954819-7956468","314","7954819","7956468","1649","1534.31159643","1.07474909519"
"SL2.50ch00:7957368-7958191","177","7957368","7958191","823","1534.31159643","0.536396910454"
"SL2.50ch00:7973260-7973939","203","7973260","7973939","679","1534.31159643","0.442543745077"
"SL2.50ch00:7981859-7984915","911","7981859","7984915","3056","1534.31159643","1.99177273189"
"SL2.50ch00:7982159-7984055","665","7982159","7984055","1896","1534.31159643","1.23573334413"
"SL2.50ch00:7992271-7995759","1518","7992271","7995759","3488","1534.31159643","2.27333222802"
"SL2.50ch00:7992524-7995740","1443","7992524","7995740","3216","1534.31159643","2.09605402676"
"SL2.50ch00:7997016-7999653","1045","7997016","7999653","2637","1534.31159643","1.71868609097"
"SL2.50ch00:7997057-7999598","1042","7997057","7999598","2541","1534.31159643","1.65611731405"
"SL2.50ch00:8003886-8008250","1503","8003886","8008250","4364","1534.31159643","2.8442723174"
"SL2.50ch00:8211804-8213494","352","8211804","8213494","1690","1534.31159643","1.101471177"
"SL2.50ch00:8212114-8213523","272","8212114","8213523","1409","1534.31159643","0.918327152892"
"SL2.50ch00:8214780-8216483","358","8214780","8216483","1703","1534.31159643","1.1099440322"
"SL2.50ch00:8217389-8218215","246","8217389","8218215","826","1534.31159643","0.538352184733"
"SL2.50ch00:8220196-8221074","199","8220196","8221074","878","1534.31159643","0.572243605563"
"SL2.50ch00:8220554-8221120","123","8220554","8221120","566","1534.31159643","0.36889508058"
"SL2.50ch00:8226789-8228144","367","8226789","8228144","1355","1534.31159643","0.883132215875"
"SL2.50ch00:8233982-8234357","66","8233982","8234357","375","1534.31159643","0.244409284836"
"SL2.50ch00:8239256-8240215","416","8239256","8240215","959","1534.31159643","0.625036011088"
"SL2.50ch00:8239274-8240172","404","8239274","8240172","898","1534.31159643","0.585278767421"
"SL2.50ch00:8248125-8248879","160","8248125","8248879","754","1534.31159643","0.491425602044"
"SL2.50ch00:8250390-8251656","276","8250390","8251656","1266","1534.31159643","0.825125745607"
"SL2.50ch00:8260930-8261559","140","8260930","8261559","629","1534.31159643","0.409955840432"
"SL2.50ch00:8261046-8261677","139","8261046","8261677","631","1534.31159643","0.411259356618"
"SL2.50ch00:8266511-8267478","180","8266511","8267478","967","1534.31159643","0.630250075831"
"SL2.50ch00:8273174-8273882","266","8273174","8273882","708","1534.31159643","0.461444729771"
"SL2.50ch00:8274395-8275043","187","8274395","8275043","648","1534.31159643","0.422339244197"
"SL2.50ch00:8277960-8278553","179","8277960","8278553","593","1534.31159643","0.386492549088"
"SL2.50ch00:8286018-8286917","171","8286018","8286917","899","1534.31159643","0.585930525514"
"SL2.50ch00:8298046-8298525","119","8298046","8298525","479","1534.31159643","0.312192126498"
"SL2.50ch00:8299213-8299793","112","8299213","8299793","580","1534.31159643","0.37801969388"
"SL2.50ch00:8301750-8302320","121","8301750","8302320","570","1534.31159643","0.371502112951"
"SL2.50ch00:8308284-8309413","391","8308284","8309413","1129","1534.31159643","0.735834886881"
"SL2.50ch00:8308600-8309348","321","8308600","8309348","748","1534.31159643","0.487515053487"
"SL2.50ch00:8331144-8331519","71","8331144","8331519","375","1534.31159643","0.244409284836"
"SL2.50ch00:8336537-8338456","425","8336537","8338456","1919","1534.31159643","1.25072378027"
"SL2.50ch00:8348334-8349071","1182","8348334","8349071","737","1534.31159643","0.480345714465"
"SL2.50ch00:8352081-8353231","1702","8352081","8353231","1150","1534.31159643","0.749521806831"
"SL2.50ch00:836408-837180","150","836408","837180","772","1534.31159643","0.503157247716"
"SL2.50ch00:8364149-8364752","158","8364149","8364752","603","1534.31159643","0.393010130017"
"SL2.50ch00:8365580-8366246","200","8365580","8366246","666","1534.31159643","0.434070889869"
"SL2.50ch00:8373200-8375003","537","8373200","8375003","1803","1534.31159643","1.17511984149"
"SL2.50ch00:8374224-8374875","326","8374224","8374875","651","1534.31159643","0.424294518476"
"SL2.50ch00:8394451-8395726","326","8394451","8395726","1275","1534.31159643","0.830991568444"
"SL2.50ch00:8397545-8398231","157","8397545","8398231","686","1534.31159643","0.447106051727"
"SL2.50ch00:8404971-8405493","178","8404971","8405493","522","1534.31159643","0.340217724492"
"SL2.50ch00:8404993-8412933","1991","8404993","8412933","7940","1534.31159643","5.1749592576"
"SL2.50ch00:8409657-8412449","833","8409657","8412449","2792","1534.31159643","1.81970859537"
"SL2.50ch00:8594402-8594804","132","8594402","8594804","402","1534.31159643","0.262006753345"
"SL2.50ch00:8607635-8611922","1239","8607635","8611922","4287","1534.31159643","2.79408694425"
"SL2.50ch00:8609667-8611866","837","8609667","8611866","2199","1534.31159643","1.43321604628"
"SL2.50ch00:8613760-8615936","884","8613760","8615936","2176","1534.31159643","1.41822561014"
"SL2.50ch00:8613780-8619919","2051","8613780","8619919","6139","1534.31159643","4.00114293229"
"SL2.50ch00:8620542-8625317","1684","8620542","8625317","4775","1534.31159643","3.11214489358"
"SL2.50ch00:8620596-8621086","111","8620596","8621086","490","1534.31159643","0.319361465519"
"SL2.50ch00:8621586-8625260","1430","8621586","8625260","3674","1534.31159643","2.3945592333"
"SL2.50ch00:8634140-8638967","1799","8634140","8638967","4827","1534.31159643","3.14603631441"
"SL2.50ch00:8634193-8644031","3350","8634193","8644031","9838","1534.31159643","6.41199611792"
"SL2.50ch00:8657336-8658287","214","8657336","8658287","951","1534.31159643","0.619821946345"
"SL2.50ch00:8665300-8665958","176","8665300","8665958","658","1534.31159643","0.428856825126"
"SL2.50ch00:8678644-8679455","141","8678644","8679455","811","1534.31159643","0.528575813339"
"SL2.50ch00:8682052-8684502","489","8682052","8684502","2450","1534.31159643","1.5968073276"
"SL2.50ch00:8697189-8697564","76","8697189","8697564","375","1534.31159643","0.244409284836"
"SL2.50ch00:8718456-8719765","264","8718456","8719765","1309","1534.31159643","0.853151343602"
"SL2.50ch00:8733678-8734341","305","8733678","8734341","663","1534.31159643","0.432115615591"
"SL2.50ch00:8733739-8735102","472","8733739","8735102","1363","1534.31159643","0.888346280618"
"SL2.50ch00:8949347-8949856","122","8949347","8949856","509","1534.31159643","0.331744869285"
"SL2.50ch00:8965032-8967276","429","8965032","8967276","2244","1534.31159643","1.46254516046"
"SL2.50ch00:8966600-8967244","149","8966600","8967244","644","1534.31159643","0.419732211826"
"SL2.50ch00:8968460-8969183","157","8968460","8969183","723","1534.31159643","0.471221101164"
"SL2.50ch00:8968508-8969014","141","8968508","8969014","506","1534.31159643","0.329789595006"
"SL2.50ch00:8976506-8978957","614","8976506","8978957","2451","1534.31159643","1.59745908569"
"SL2.50ch00:8987330-8987898","139","8987330","8987898","568","1534.31159643","0.370198596765"
"SL2.50ch00:9004251-9006882","466","9004251","9006882","2631","1534.31159643","1.71477554241"
"SL2.50ch00:9007593-9008123","96","9007593","9008123","530","1534.31159643","0.345431789235"
"SL2.50ch00:9015056-9015699","306","9015056","9015699","643","1534.31159643","0.419080453733"
"SL2.50ch00:9015108-9015777","301","9015108","9015777","669","1534.31159643","0.436026164148"
"SL2.50ch00:9017736-9019183","382","9017736","9019183","1447","1534.31159643","0.943093960422"
"SL2.50ch00:9030365-9032047","522","9030365","9032047","1682","1534.31159643","1.09625711225"
"SL2.50ch00:9031514-9032021","229","9031514","9032021","507","1534.31159643","0.330441353099"
"SL2.50ch00:9035254-9036052","199","9035254","9036052","798","1534.31159643","0.520102958132"
"SL2.50ch00:9039219-9040022","143","9039219","9040022","803","1534.31159643","0.523361748596"
"SL2.50ch00:9046167-9047924","721","9046167","9047924","1757","1534.31159643","1.14513896922"
"SL2.50ch00:9046176-9047912","721","9046176","9047912","1736","1534.31159643","1.13145204927"
"SL2.50ch00:9049665-9051627","1235","9049665","9051627","1962","1534.31159643","1.27874937826"
"SL2.50ch00:9049695-9051709","1235","9049695","9051709","2014","1534.31159643","1.31264079909"
"SL2.50ch00:9055371-9056476","343","9055371","9056476","1105","1534.31159643","0.720192692651"
"SL2.50ch00:9055408-9056471","343","9055408","9056471","1063","1534.31159643","0.692818852749"
"SL2.50ch00:9058126-9062340","2640","9058126","9062340","4214","1534.31159643","2.74650860347"
"SL2.50ch00:9058131-9062430","2640","9058131","9062430","4299","1534.31159643","2.80190804136"
"SL2.50ch00:9068649-9071610","1662","9068649","9071610","2961","1534.31159643","1.92985571307"
"SL2.50ch00:9068703-9071632","1659","9068703","9071632","2929","1534.31159643","1.90899945409"
"SL2.50ch00:9078187-9081426","1103","9078187","9081426","3239","1534.31159643","2.11104446289"
"SL2.50ch00:9078187-9081497","1108","9078187","9081497","3310","1534.31159643","2.15731928749"
"SL2.50ch00:9090083-9091282","533","9090083","9091282","1199","1534.31159643","0.781457953383"
"SL2.50ch00:9090109-9091331","532","9090109","9091331","1222","1534.31159643","0.79644838952"
"SL2.50ch00:9096292-9103662","1634","9096292","9103662","7370","1534.31159643","4.80345714465"
"SL2.50ch00:9109805-9110738","180","9109805","9110738","933","1534.31159643","0.608090300673"
"SL2.50ch00:9239207-9242470","780","9239207","9242470","3263","1534.31159643","2.12668665712"
"SL2.50ch00:9244498-9247637","749","9244498","9247637","3139","1534.31159643","2.0458686536"
"SL2.50ch00:9254917-9256554","512","9254917","9256554","1637","1534.31159643","1.06692799807"
"SL2.50ch00:9254982-9256545","508","9254982","9256545","1563","1534.31159643","1.0186978992"
"SL2.50ch00:9259001-9260385","359","9259001","9260385","1384","1534.31159643","0.902033200569"
"SL2.50ch00:9261165-9262649","397","9261165","9262649","1484","1534.31159643","0.967209009859"
"SL2.50ch00:9271885-9272489","118","9271885","9272489","604","1534.31159643","0.39366188811"
"SL2.50ch00:9278565-9279331","148","9278565","9279331","766","1534.31159643","0.499246699159"
"SL2.50ch00:9302677-9303951","229","9302677","9303951","1274","1534.31159643","0.830339810351"
"SL2.50ch00:930971-931346","89","930971","931346","375","1534.31159643","0.244409284836"
"SL2.50ch00:9316406-9316781","80","9316406","9316781","375","1534.31159643","0.244409284836"
"SL2.50ch00:9324487-9325533","187","9324487","9325533","1046","1534.31159643","0.68173896517"
"SL2.50ch00:9326434-9326903","102","9326434","9326903","469","1534.31159643","0.305674545569"
"SL2.50ch00:9337835-9338504","154","9337835","9338504","669","1534.31159643","0.436026164148"
"SL2.50ch00:9342636-9344852","537","9342636","9344852","2216","1534.31159643","1.44429593386"
"SL2.50ch00:9351642-9353215","308","9351642","9353215","1573","1534.31159643","1.02521548013"
"SL2.50ch00:9352340-9352978","123","9352340","9352978","638","1534.31159643","0.415821663268"
"SL2.50ch00:9366834-9367623","241","9366834","9367623","789","1534.31159643","0.514237135296"
"SL2.50ch00:9369235-9370606","314","9369235","9370606","1371","1534.31159643","0.893560345362"
"SL2.50ch00:9383843-9384333","63","9383843","9384333","490","1534.31159643","0.319361465519"
"SL2.50ch00:9405612-9406254","138","9405612","9406254","642","1534.31159643","0.41842869564"
"SL2.50ch00:9408014-9410178","551","9408014","9410178","2164","1534.31159643","1.41040451303"
"SL2.50ch00:9413239-9417348","1202","9413239","9417348","4109","1534.31159643","2.67807400371"
"SL2.50ch00:9414793-9417223","834","9414793","9417223","2430","1534.31159643","1.58377216574"
"SL2.50ch00:9418288-9423072","1254","9418288","9423072","4784","1534.31159643","3.11801071642"
"SL2.50ch00:9421065-9423040","542","9421065","9423040","1975","1534.31159643","1.28722223347"
"SL2.50ch00:9423714-9427876","1582","9423714","9427876","4162","1534.31159643","2.71261718264"
"SL2.50ch00:9425705-9427662","1004","9425705","9427662","1957","1534.31159643","1.2754905878"
"SL2.50ch00:9432720-9435921","826","9432720","9435921","3201","1534.31159643","2.08627765536"
"SL2.50ch00:9441532-9442005","152","9441532","9442005","473","1534.31159643","0.30828157794"
"SL2.50ch00:9450055-9458167","2175","9450055","9458167","8112","1534.31159643","5.28706164958"
"SL2.50ch00:9453165-9458132","1484","9453165","9458132","4967","1534.31159643","3.23728244742"
"SL2.50ch00:9459682-9461136","286","9459682","9461136","1454","1534.31159643","0.947656267072"
"SL2.50ch00:9469103-9469726","367","9469103","9469726","623","1534.31159643","0.406045291875"
"SL2.50ch00:9469151-9469553","362","9469151","9469553","402","1534.31159643","0.262006753345"
"SL2.50ch00:9472005-9474716","769","9472005","9474716","2711","1534.31159643","1.76691618984"
"SL2.50ch00:9472134-9472624","186","9472134","9472624","490","1534.31159643","0.319361465519"
"SL2.50ch00:9477989-9485776","2755","9477989","9485776","7787","1534.31159643","5.07524026939"
"SL2.50ch00:9480354-9481499","649","9480354","9481499","1145","1534.31159643","0.746263016367"
"SL2.50ch00:9481943-9484278","895","9481943","9484278","2335","1534.31159643","1.52185514691"
"SL2.50ch00:9499005-9501565","575","9499005","9501565","2560","1534.31159643","1.66850071782"
"SL2.50ch00:9563160-9565723","532","9563160","9565723","2563","1534.31159643","1.67045599209"
"SL2.50ch00:9564596-9565633","232","9564596","9565633","1037","1534.31159643","0.675873142334"
"SL2.50ch00:9571890-9574712","657","9571890","9574712","2822","1534.31159643","1.83926133815"
"SL2.50ch00:9574103-9574879","218","9574103","9574879","776","1534.31159643","0.505764280088"
"SL2.50ch00:9588291-9589618","473","9588291","9589618","1327","1534.31159643","0.864882989274"
"SL2.50ch00:9588353-9589343","406","9588353","9589343","990","1534.31159643","0.645240511968"
"SL2.50ch00:9598709-9599994","284","9598709","9599994","1285","1534.31159643","0.837509149372"
"SL2.50ch00:9600734-9601870","252","9600734","9601870","1136","1534.31159643","0.740397193531"
"SL2.50ch00:9607833-9610848","692","9607833","9610848","3015","1534.31159643","1.96505065008"
"SL2.50ch00:9610195-9610685","166","9610195","9610685","490","1534.31159643","0.319361465519"
"SL2.50ch00:9619046-9619554","118","9619046","9619554","508","1534.31159643","0.331093111192"
"SL2.50ch00:9619197-9619572","93","9619197","9619572","375","1534.31159643","0.244409284836"
"SL2.50ch00:9621331-9625049","1345","9621331","9625049","3718","1534.31159643","2.42323658939"
"SL2.50ch00:9621350-9621936","198","9621350","9621936","586","1534.31159643","0.381930242438"
"SL2.50ch00:9622732-9623510","502","9622732","9623510","778","1534.31159643","0.507067796274"
"SL2.50ch00:9626009-9628452","682","9626009","9628452","2443","1534.31159643","1.59224502095"
"SL2.50ch00:9626103-9628743","720","9626103","9628743","2640","1534.31159643","1.72064136525"
"SL2.50ch00:9629835-9630325","173","9629835","9630325","490","1534.31159643","0.319361465519"
"SL2.50ch00:9629835-9630333","173","9629835","9630333","498","1534.31159643","0.324575530263"
"SL2.50ch00:9643147-9643651","130","9643147","9643651","504","1534.31159643","0.32848607882"
"SL2.50ch00:9715123-9716924","312","9715123","9716924","1801","1534.31159643","1.17381632531"
"SL2.50ch00:9722305-9729386","2644","9722305","9729386","7081","1534.31159643","4.6150990558"
"SL2.50ch00:9722376-9729263","2608","9722376","9729263","6887","1534.31159643","4.48865798578"
"SL2.50ch00:9745483-9746285","144","9745483","9746285","802","1534.31159643","0.522709990503"
"SL2.50ch00:9753018-9755103","611","9753018","9755103","2085","1534.31159643","1.35891562369"
"SL2.50ch00:9753212-9754492","386","9753212","9754492","1280","1534.31159643","0.834250358908"
"SL2.50ch00:9757267-9760747","866","9757267","9760747","3480","1534.31159643","2.26811816328"
"SL2.50ch00:9771910-9776224","1972","9771910","9776224","4314","1534.31159643","2.81168441276"
"SL2.50ch00:9771946-9776178","1970","9771946","9776178","4232","1534.31159643","2.75824024914"
"SL2.50ch00:9781174-9782758","363","9781174","9782758","1584","1534.31159643","1.03238481915"
"SL2.50ch00:9781229-9782608","340","9781229","9782608","1379","1534.31159643","0.898774410105"
"SL2.50ch00:9784466-9784841","83","9784466","9784841","375","1534.31159643","0.244409284836"
"SL2.50ch00:9788332-9788851","271","9788332","9788851","519","1534.31159643","0.338262450213"
"SL2.50ch00:9788349-9788819","268","9788349","9788819","470","1534.31159643","0.306326303662"
"SL2.50ch00:9790540-9791015","138","9790540","9791015","475","1534.31159643","0.309585094126"
"SL2.50ch00:9790548-9791053","140","9790548","9791053","505","1534.31159643","0.329137836913"
"SL2.50ch00:9794301-9796006","3193","9794301","9796006","1705","1534.31159643","1.11124754839"
"SL2.50ch00:9801994-9804879","793","9801994","9804879","2885","1534.31159643","1.88032209801"
"SL2.50ch00:9813087-9815757","619","9813087","9815757","2670","1534.31159643","1.74019410803"
"SL2.50ch00:9816688-9818251","255","9816688","9818251","1563","1534.31159643","1.0186978992"
"SL2.50ch00:9833349-9834217","8535","9833349","9834217","868","1534.31159643","0.565726024634"
"SL2.50ch00:9834909-9836656","911","9834909","9836656","1747","1534.31159643","1.13862138829"
"SL2.50ch00:9834961-9836717","902","9834961","9836717","1756","1534.31159643","1.14448721113"
"SL2.50ch00:9837927-9838984","411","9837927","9838984","1057","1534.31159643","0.688908304192"
"SL2.50ch00:9837935-9838982","411","9837935","9838982","1047","1534.31159643","0.682390723263"
"SL2.50ch00:9862018-9862746","377","9862018","9862746","728","1534.31159643","0.474479891629"
"SL2.50ch00:9863675-9864396","275","9863675","9864396","721","1534.31159643","0.469917584979"
"SL2.50ch00:9864924-9865938","291","9864924","9865938","1014","1534.31159643","0.660882706197"
"SL2.50ch00:9880979-9881624","116","9880979","9881624","645","1534.31159643","0.420383969918"
"SL2.50ch00:9954273-9959938","1460","9954273","9959938","5665","1534.31159643","3.69220959626"
"SL2.50ch00:9963859-9971474","2159","9963859","9971474","7615","1534.31159643","4.96313787741"
"SL2.50ch00:9963863-9967780","1063","9963863","9967780","3917","1534.31159643","2.55293644988"
"SL2.50ch00:9972925-9982340","2527","9972925","9982340","9415","1534.31159643","6.13630244462"
"SL2.50ch00:9983544-9987670","1248","9983544","9987670","4126","1534.31159643","2.68915389129"
"SL2.50ch00:9987060-9987601","266","9987060","9987601","541","1534.31159643","0.352601128257"
"SL2.50ch00:9990015-9993899","1145","9990015","9993899","3884","1534.31159643","2.53142843281"
"SL2.50ch00:9990037-9993723","1108","9990037","9993723","3686","1534.31159643","2.40238033042"
"SL2.50ch00:9995340-9995715","79","9995340","9995715","375","1534.31159643","0.244409284836"
"SL2.50ch00:9998688-10000097","384","9998688","10000097","1409","1534.31159643","0.918327152892"
"SL2.50ch00:9998871-10002252","1066","9998871","10002252","3381","1534.31159643","2.20359411208"
"SL2.50ch01:11968793-11969168","82","11968793","11969168","375","1534.31159643","0.244409284836"
"SL2.50ch01:1333557-1333932","105","1333557","1333932","375","1534.31159643","0.244409284836"
"SL2.50ch01:13846783-13847447","187","13846783","13847447","664","1534.31159643","0.432767373684"
"SL2.50ch01:14004258-14005349","199","14004258","14005349","1091","1534.31159643","0.71106807935"
"SL2.50ch01:14800828-14801745","161","14800828","14801745","917","1534.31159643","0.597662171186"
"SL2.50ch01:14955717-14956237","112","14955717","14956237","520","1534.31159643","0.338914208306"
"SL2.50ch01:15605657-15606264","464","15605657","15606264","607","1534.31159643","0.395617162388"
"SL2.50ch01:15605717-15606285","455","15605717","15606285","568","1534.31159643","0.370198596765"
"SL2.50ch01:15796659-15797469","148","15796659","15797469","810","1534.31159643","0.527924055246"
"SL2.50ch01:1839676-1903415","5456283","1839676","1903415","63739","1534.31159643","41.5424090832"
"SL2.50ch01:1839708-1903437","5456285","1839708","1903437","63729","1534.31159643","41.5358915022"
"SL2.50ch01:18586438-18586913","102","18586438","18586913","475","1534.31159643","0.309585094126"
"SL2.50ch01:18783900-18784595","129","18783900","18784595","695","1534.31159643","0.452971874563"
"SL2.50ch01:19716069-19718334","502","19716069","19718334","2265","1534.31159643","1.47623208041"
"SL2.50ch01:20285362-20286126","161","20285362","20286126","764","1534.31159643","0.497943182973"
"SL2.50ch01:20757843-20758451","125","20757843","20758451","608","1534.31159643","0.396268920481"
"SL2.50ch01:21238823-21239198","73","21238823","21239198","375","1534.31159643","0.244409284836"
"SL2.50ch01:21401232-21401847","185","21401232","21401847","615","1534.31159643","0.400831227132"
"SL2.50ch01:21722889-21724486","269","21722889","21724486","1597","1534.31159643","1.04085767436"
"SL2.50ch01:21754167-21754542","81","21754167","21754542","375","1534.31159643","0.244409284836"
"SL2.50ch01:22438896-22440095","228","22438896","22440095","1199","1534.31159643","0.781457953383"
"SL2.50ch01:22596222-22597075","319","22596222","22597075","853","1534.31159643","0.555949653241"
"SL2.50ch01:22848489-22848989","128","22848489","22848989","500","1534.31159643","0.325879046448"
"SL2.50ch01:23606727-23608043","274","23606727","23608043","1316","1534.31159643","0.857713650252"
"SL2.50ch01:23877807-23878380","125","23877807","23878380","573","1534.31159643","0.37345738723"
"SL2.50ch01:23892015-23893041","209","23892015","23893041","1026","1534.31159643","0.668703803312"
"SL2.50ch01:23894853-23895255","1388","23894853","23895255","402","1534.31159643","0.262006753345"
"SL2.50ch01:23933813-23939761","5467","23933813","23939761","5948","1534.31159643","3.87665713655"
"SL2.50ch01:23940972-23943685","14814","23940972","23943685","2713","1534.31159643","1.76821970603"
"SL2.50ch01:23941259-23943022","14623","23941259","23943022","1763","1534.31159643","1.14904951778"
"SL2.50ch01:23946758-23950271","743","23946758","23950271","3513","1534.31159643","2.28962618035"
"SL2.50ch01:23951916-23953495","613","23951916","23953495","1579","1534.31159643","1.02912602868"
"SL2.50ch01:23965380-23966367","3936","23965380","23966367","987","1534.31159643","0.643285237689"
"SL2.50ch01:23965510-23966276","3920","23965510","23966276","766","1534.31159643","0.499246699159"
"SL2.50ch01:24228570-24229146","219","24228570","24229146","576","1534.31159643","0.375412661509"
"SL2.50ch01:24233826-24236083","781","24233826","24236083","2257","1534.31159643","1.47101801567"
"SL2.50ch01:24272581-24273438","173","24272581","24273438","857","1534.31159643","0.558556685613"
"SL2.50ch01:24513175-24513796","116","24513175","24513796","621","1534.31159643","0.404741775689"
"SL2.50ch01:25132342-25132816","109","25132342","25132816","474","1534.31159643","0.308933336033"
"SL2.50ch01:25672237-25672612","70","25672237","25672612","375","1534.31159643","0.244409284836"
"SL2.50ch01:26210581-26211494","207","26210581","26211494","913","1534.31159643","0.595055138815"
"SL2.50ch01:26525089-26525905","167","26525089","26525905","816","1534.31159643","0.531834603804"
"SL2.50ch01:27417575-27417977","1042","27417575","27417977","402","1534.31159643","0.262006753345"
"SL2.50ch01:27884750-27885367","885","27884750","27885367","617","1534.31159643","0.402134743317"
"SL2.50ch01:27918114-27918598","90","27918114","27918598","484","1534.31159643","0.315450916962"
"SL2.50ch01:28028813-28030120","261","28028813","28030120","1307","1534.31159643","0.851847827416"
"SL2.50ch01:28492826-28493201","75","28492826","28493201","375","1534.31159643","0.244409284836"
"SL2.50ch01:28711042-28711946","166","28711042","28711946","904","1534.31159643","0.589189315979"
"SL2.50ch01:30279147-30279522","71","30279147","30279522","375","1534.31159643","0.244409284836"
"SL2.50ch01:30784789-30785164","80","30784789","30785164","375","1534.31159643","0.244409284836"
"SL2.50ch01:30948965-30949340","66","30948965","30949340","375","1534.31159643","0.244409284836"
"SL2.50ch01:31146127-31146596","121","31146127","31146596","469","1534.31159643","0.305674545569"
"SL2.50ch01:31224586-31224961","66","31224586","31224961","375","1534.31159643","0.244409284836"
"SL2.50ch01:32339044-32339563","104","32339044","32339563","519","1534.31159643","0.338262450213"
"SL2.50ch01:36643814-36645093","222","36643814","36645093","1279","1534.31159643","0.833598600815"
"SL2.50ch01:36888348-36897964","4530","36888348","36897964","9616","1534.31159643","6.2673058213"
"SL2.50ch01:36888550-36896089","4164","36888550","36896089","7539","1534.31159643","4.91360426235"
"SL2.50ch01:36942610-36944092","392","36942610","36944092","1482","1534.31159643","0.965905493673"
"SL2.50ch01:36950295-36952356","420","36950295","36952356","2061","1534.31159643","1.34327342946"
"SL2.50ch01:36984575-36988502","2172","36984575","36988502","3927","1534.31159643","2.55945403081"
"SL2.50ch01:36985927-36986829","1560","36985927","36986829","902","1534.31159643","0.587885799793"
"SL2.50ch01:39121062-39124230","850","39121062","39124230","3168","1534.31159643","2.0647696383"
"SL2.50ch01:39121411-39123115","618","39121411","39123115","1704","1534.31159643","1.1105957903"
"SL2.50ch01:39132048-39134342","1548","39132048","39134342","2294","1534.31159643","1.49513306511"
"SL2.50ch01:39132427-39133966","1371","39132427","39133966","1539","1534.31159643","1.00305570497"
"SL2.50ch01:39135164-39136515","918","39135164","39136515","1351","1534.31159643","0.880525183504"
"SL2.50ch01:39135319-39138487","1429","39135319","39138487","3168","1534.31159643","2.0647696383"
"SL2.50ch01:39137229-39137719","147","39137229","39137719","490","1534.31159643","0.319361465519"
"SL2.50ch01:39475355-39475730","69","39475355","39475730","375","1534.31159643","0.244409284836"
"SL2.50ch01:39769273-39770042","462","39769273","39770042","769","1534.31159643","0.501201973438"
"SL2.50ch01:39769424-39770132","464","39769424","39770132","708","1534.31159643","0.461444729771"
"SL2.50ch01:40219084-40219617","96","40219084","40219617","533","1534.31159643","0.347387063514"
"SL2.50ch01:40523400-40524312","196","40523400","40524312","912","1534.31159643","0.594403380722"
"SL2.50ch01:40714692-40715168","96","40714692","40715168","476","1534.31159643","0.310236852219"
"SL2.50ch01:41711237-41712006","267","41711237","41712006","769","1534.31159643","0.501201973438"
"SL2.50ch01:41729414-41731149","564","41729414","41731149","1735","1534.31159643","1.13080029118"
"SL2.50ch01:41729550-41731227","542","41729550","41731227","1677","1534.31159643","1.09299832179"
"SL2.50ch01:41733216-41734775","372","41733216","41734775","1559","1534.31159643","1.01609086683"
"SL2.50ch01:41752923-41754182","307","41752923","41754182","1259","1534.31159643","0.820563438957"
"SL2.50ch01:42324376-42325644","329","42324376","42325644","1268","1534.31159643","0.826429261793"
"SL2.50ch01:42379624-42380407","191","42379624","42380407","783","1534.31159643","0.510326586738"
"SL2.50ch01:43039383-43039917","1111","43039383","43039917","534","1534.31159643","0.348038821607"
"SL2.50ch01:43482173-43482803","143","43482173","43482803","630","1534.31159643","0.410607598525"
"SL2.50ch01:43544852-43546071","204","43544852","43546071","1219","1534.31159643","0.794493115241"
"SL2.50ch01:43647943-43648446","593","43647943","43648446","503","1534.31159643","0.327834320727"
"SL2.50ch01:44093707-44094177","97","44093707","44094177","470","1534.31159643","0.306326303662"
"SL2.50ch01:44352450-44352945","98","44352450","44352945","495","1534.31159643","0.322620255984"
"SL2.50ch01:44466800-44467490","180","44466800","44467490","690","1534.31159643","0.449713084099"
"SL2.50ch01:44528814-44530884","584","44528814","44530884","2070","1534.31159643","1.3491392523"
"SL2.50ch01:44562367-44563066","145","44562367","44563066","699","1534.31159643","0.455578906935"
"SL2.50ch01:44575856-44577434","272","44575856","44577434","1578","1534.31159643","1.02847427059"
"SL2.50ch01:44607595-44608224","118","44607595","44608224","629","1534.31159643","0.409955840432"
"SL2.50ch01:44630655-44631224","137","44630655","44631224","569","1534.31159643","0.370850354858"
"SL2.50ch01:44768402-44769003","118","44768402","44769003","601","1534.31159643","0.391706613831"
"SL2.50ch01:44787657-44789122","432","44787657","44789122","1465","1534.31159643","0.954825606094"
"SL2.50ch01:44799513-44802631","721","44799513","44802631","3118","1534.31159643","2.03218173365"
"SL2.50ch01:44830568-44831831","387","44830568","44831831","1263","1534.31159643","0.823170471329"
"SL2.50ch01:44835507-44836244","177","44835507","44836244","737","1534.31159643","0.480345714465"
"SL2.50ch01:44860994-44861698","155","44860994","44861698","704","1534.31159643","0.458837697399"
"SL2.50ch01:44881547-44882473","224","44881547","44882473","926","1534.31159643","0.603527994023"
"SL2.50ch01:44921478-44922958","381","44921478","44922958","1480","1534.31159643","0.964601977487"
"SL2.50ch01:45009193-45009837","7056","45009193","45009837","644","1534.31159643","0.419732211826"
"SL2.50ch01:45009318-45009860","7044","45009318","45009860","542","1534.31159643","0.35325288635"
"SL2.50ch01:45271114-45271901","182","45271114","45271901","787","1534.31159643","0.51293361911"
"SL2.50ch01:45275571-45277585","550","45275571","45277585","2014","1534.31159643","1.31264079909"
"SL2.50ch01:45421617-45422175","128","45421617","45422175","558","1534.31159643","0.363681015836"
"SL2.50ch01:45785334-45785953","118","45785334","45785953","619","1534.31159643","0.403438259503"
"SL2.50ch01:46733816-46734218","1076","46733816","46734218","402","1534.31159643","0.262006753345"
"SL2.50ch01:47302941-47303609","122","47302941","47303609","668","1534.31159643","0.435374406055"
"SL2.50ch01:47843874-47844682","150","47843874","47844682","808","1534.31159643","0.526620539061"
"SL2.50ch01:51312742-51313340","164","51312742","51313340","598","1534.31159643","0.389751339552"
"SL2.50ch01:51977574-51978650","180","51977574","51978650","1076","1534.31159643","0.701291707957"
"SL2.50ch01:52231429-52231804","82","52231429","52231804","375","1534.31159643","0.244409284836"
"SL2.50ch01:5240388-5241007","303","5240388","5241007","619","1534.31159643","0.403438259503"
"SL2.50ch01:52675696-52676071","81","52675696","52676071","375","1534.31159643","0.244409284836"
"SL2.50ch01:53022792-53023167","83","53022792","53023167","375","1534.31159643","0.244409284836"
"SL2.50ch01:5319741-5323511","945","5319741","5323511","3770","1534.31159643","2.45712801022"
"SL2.50ch01:53392224-53392843","8082","53392224","53392843","619","1534.31159643","0.403438259503"
"SL2.50ch01:53935855-53936602","161","53935855","53936602","747","1534.31159643","0.486863295394"
"SL2.50ch01:54049261-54049783","698","54049261","54049783","522","1534.31159643","0.340217724492"
"SL2.50ch01:54133256-54134212","194","54133256","54134212","956","1534.31159643","0.623080736809"
"SL2.50ch01:54528867-54529492","298","54528867","54529492","625","1534.31159643","0.407348808061"
"SL2.50ch01:55579446-55580280","1734","55579446","55580280","834","1534.31159643","0.543566249476"
"SL2.50ch01:55579536-55580384","1718","55579536","55580384","848","1534.31159643","0.552690862777"
"SL2.50ch01:56248997-56249783","1775","56248997","56249783","786","1534.31159643","0.512281861017"
"SL2.50ch01:56249071-56249793","1767","56249071","56249793","722","1534.31159643","0.470569343072"
"SL2.50ch01:56405661-56406036","76","56405661","56406036","375","1534.31159643","0.244409284836"
"SL2.50ch01:56566648-56567141","96","56566648","56567141","493","1534.31159643","0.321316739798"
"SL2.50ch01:57183204-57183715","629","57183204","57183715","511","1534.31159643","0.33304838547"
"SL2.50ch01:57530071-57530641","107","57530071","57530641","570","1534.31159643","0.371502112951"
"SL2.50ch01:57613255-57613833","117","57613255","57613833","578","1534.31159643","0.376716177694"
"SL2.50ch01:57705080-57705611","123","57705080","57705611","531","1534.31159643","0.346083547328"
"SL2.50ch01:59085623-59086899","199","59085623","59086899","1276","1534.31159643","0.831643326536"
"SL2.50ch01:59207040-59207799","364","59207040","59207799","759","1534.31159643","0.494684392509"
"SL2.50ch01:59207200-59207602","326","59207200","59207602","402","1534.31159643","0.262006753345"
"SL2.50ch01:59546577-59547710","194","59546577","59547710","1133","1534.31159643","0.738441919252"
"SL2.50ch01:59582778-59583153","77","59582778","59583153","375","1534.31159643","0.244409284836"
"SL2.50ch01:60202970-60203452","107","60202970","60203452","482","1534.31159643","0.314147400776"
"SL2.50ch01:60368274-60368881","119","60368274","60368881","607","1534.31159643","0.395617162388"
"SL2.50ch01:60369345-60370336","409","60369345","60370336","991","1534.31159643","0.645892270061"
"SL2.50ch01:60876675-60878871","877","60876675","60878871","2196","1534.31159643","1.431260772"
"SL2.50ch01:61418471-61419574","281","61418471","61419574","1103","1534.31159643","0.718889176465"
"SL2.50ch01:61861994-61862396","529","61861994","61862396","402","1534.31159643","0.262006753345"
"SL2.50ch01:63257005-63257380","80","63257005","63257380","375","1534.31159643","0.244409284836"
"SL2.50ch01:63798114-63798876","329","63798114","63798876","762","1534.31159643","0.496639666787"
"SL2.50ch01:63798218-63798943","321","63798218","63798943","725","1534.31159643","0.47252461735"
"SL2.50ch01:63800315-63800787","187","63800315","63800787","472","1534.31159643","0.307629819847"
"SL2.50ch01:63802289-63803112","197","63802289","63803112","823","1534.31159643","0.536396910454"
"SL2.50ch01:63802614-63803443","221","63802614","63803443","829","1534.31159643","0.540307459012"
"SL2.50ch01:64254168-64255162","167","64254168","64255162","994","1534.31159643","0.647847544339"
"SL2.50ch01:64585552-64585927","178","64585552","64585927","375","1534.31159643","0.244409284836"
"SL2.50ch01:64640118-64640608","1960","64640118","64640608","490","1534.31159643","0.319361465519"
"SL2.50ch01:65152545-65152920","113","65152545","65152920","375","1534.31159643","0.244409284836"
"SL2.50ch01:65651673-65652479","8591","65651673","65652479","806","1534.31159643","0.525317022875"
"SL2.50ch01:65651778-65652467","8579","65651778","65652467","689","1534.31159643","0.449061326006"
"SL2.50ch01:65923481-65923856","80","65923481","65923856","375","1534.31159643","0.244409284836"
"SL2.50ch01:66009140-66010629","628","66009140","66010629","1489","1534.31159643","0.970467800323"
"SL2.50ch01:66013118-66014447","444","66013118","66014447","1329","1534.31159643","0.86618650546"
"SL2.50ch01:66014831-66016152","378","66014831","66016152","1321","1534.31159643","0.860972440717"
"SL2.50ch01:66329272-66329889","714","66329272","66329889","617","1534.31159643","0.402134743317"
"SL2.50ch01:66433437-66434185","306","66433437","66434185","748","1534.31159643","0.487515053487"
"SL2.50ch01:66433540-66434069","296","66433540","66434069","529","1534.31159643","0.344780031142"
"SL2.50ch01:66435134-66435509","76","66435134","66435509","375","1534.31159643","0.244409284836"
"SL2.50ch01:66780954-66782239","1805","66780954","66782239","1285","1534.31159643","0.837509149372"
"SL2.50ch01:68660527-68661179","126","68660527","68661179","652","1534.31159643","0.424946276569"
"SL2.50ch01:69305195-69305570","83","69305195","69305570","375","1534.31159643","0.244409284836"
"SL2.50ch01:7029801-7030523","1056","7029801","7030523","722","1534.31159643","0.470569343072"
"SL2.50ch01:7029828-7030891","1136","7029828","7030891","1063","1534.31159643","0.692818852749"
"SL2.50ch01:7080086-7082148","843","7080086","7082148","2062","1534.31159643","1.34392518755"
"SL2.50ch01:71108669-71109044","100","71108669","71109044","375","1534.31159643","0.244409284836"
"SL2.50ch01:72633593-72634365","756","72633593","72634365","772","1534.31159643","0.503157247716"
"SL2.50ch01:72633669-72634317","744","72633669","72634317","648","1534.31159643","0.422339244197"
"SL2.50ch01:75968814-75971781","603","75968814","75971781","2967","1534.31159643","1.93376626163"
"SL2.50ch01:75984810-75985326","102","75984810","75985326","516","1534.31159643","0.336307175935"
"SL2.50ch01:76143294-76143669","319","76143294","76143669","375","1534.31159643","0.244409284836"
"SL2.50ch01:76143304-76143706","318","76143304","76143706","402","1534.31159643","0.262006753345"
"SL2.50ch01:76425822-76427320","335","76425822","76427320","1498","1534.31159643","0.97633362316"
"SL2.50ch01:76744000-76744402","303","76744000","76744402","402","1534.31159643","0.262006753345"
"SL2.50ch01:77468331-77468816","117","77468331","77468816","485","1534.31159643","0.316102675055"
"SL2.50ch01:77501311-77502448","362","77501311","77502448","1137","1534.31159643","0.741048951624"
"SL2.50ch01:77505244-77506629","428","77505244","77506629","1385","1534.31159643","0.902684958662"
"SL2.50ch01:77505657-77506721","354","77505657","77506721","1064","1534.31159643","0.693470610842"
"SL2.50ch01:77533649-77534576","198","77533649","77534576","927","1534.31159643","0.604179752115"
"SL2.50ch01:7787425-7787910","108","7787425","7787910","485","1534.31159643","0.316102675055"
"SL2.50ch01:78119873-78120346","164","78119873","78120346","473","1534.31159643","0.30828157794"
"SL2.50ch01:81032985-81033935","172","81032985","81033935","950","1534.31159643","0.619170188252"
"SL2.50ch01:82436085-82436621","708","82436085","82436621","536","1534.31159643","0.349342337793"
"SL2.50ch01:82806754-82807425","403","82806754","82807425","671","1534.31159643","0.437329680334"
"SL2.50ch01:82806872-82807274","380","82806872","82807274","402","1534.31159643","0.262006753345"
"SL2.50ch01:84251027-84251694","166","84251027","84251694","667","1534.31159643","0.434722647962"
"SL2.50ch01:84251071-84251473","131","84251071","84251473","402","1534.31159643","0.262006753345"
"SL2.50ch01:84341173-84342133","200","84341173","84342133","960","1534.31159643","0.625687769181"
"SL2.50ch01:84679640-84680042","982","84679640","84680042","402","1534.31159643","0.262006753345"
"SL2.50ch01:84936667-84937457","275","84936667","84937457","790","1534.31159643","0.514888893389"
"SL2.50ch01:8530445-8530913","134","8530445","8530913","468","1534.31159643","0.305022787476"
"SL2.50ch01:86035393-86035891","777","86035393","86035891","498","1534.31159643","0.324575530263"
"SL2.50ch01:86035464-86035866","777","86035464","86035866","402","1534.31159643","0.262006753345"
"SL2.50ch01:86711724-86712214","3902","86711724","86712214","490","1534.31159643","0.319361465519"
"SL2.50ch01:87072349-87072839","2574","87072349","87072839","490","1534.31159643","0.319361465519"
"SL2.50ch01:88104703-88105201","1624","88104703","88105201","498","1534.31159643","0.324575530263"
"SL2.50ch01:88104741-88105143","1621","88104741","88105143","402","1534.31159643","0.262006753345"
"SL2.50ch01:9006356-9006889","4470","9006356","9006889","533","1534.31159643","0.347387063514"
"SL2.50ch01:9006400-9006869","4468","9006400","9006869","469","1534.31159643","0.305674545569"
"SL2.50ch01:90133335-90133970","2107","90133335","90133970","635","1534.31159643","0.41386638899"
"SL2.50ch01:90133432-90133987","2105","90133432","90133987","555","1534.31159643","0.361725741558"
"SL2.50ch01:90236888-90237263","149","90236888","90237263","375","1534.31159643","0.244409284836"
"SL2.50ch01:91495592-91496198","6698","91495592","91496198","606","1534.31159643","0.394965404296"
"SL2.50ch01:91495694-91496165","6680","91495694","91496165","471","1534.31159643","0.306978061754"
"SL2.50ch01:92021047-92021422","416","92021047","92021422","375","1534.31159643","0.244409284836"
"SL2.50ch01:92021082-92021484","420","92021082","92021484","402","1534.31159643","0.262006753345"
"SL2.50ch01:93670523-93671719","1717","93670523","93671719","1196","1534.31159643","0.779502679105"
"SL2.50ch01:95967350-95968207","170","95967350","95968207","857","1534.31159643","0.558556685613"
"SL2.50ch01:96015003-96015710","156","96015003","96015710","707","1534.31159643","0.460792971678"
"SL2.50ch01:96868547-96870464","1746","96868547","96870464","1917","1534.31159643","1.24942026408"
"SL2.50ch01:96868557-96870445","1743","96868557","96870445","1888","1534.31159643","1.23051927939"
"SL2.50ch01:96871095-96871701","293","96871095","96871701","606","1534.31159643","0.394965404296"
"SL2.50ch01:96871136-96871759","283","96871136","96871759","623","1534.31159643","0.406045291875"
"SL2.50ch01:97436361-97437546","221","97436361","97437546","1185","1534.31159643","0.772333340083"
"SL2.50ch01:98472738-98473567","237","98472738","98473567","829","1534.31159643","0.540307459012"
"SL2.50ch01:98476541-98477971","292","98476541","98477971","1430","1534.31159643","0.932014072843"
"SL2.50ch01:98479579-98481098","536","98479579","98481098","1519","1534.31159643","0.99002054311"
"SL2.50ch01:98480121-98480973","410","98480121","98480973","852","1534.31159643","0.555297895148"
"SL2.50ch01:98481486-98482344","315","98481486","98482344","858","1534.31159643","0.559208443706"
"SL2.50ch01:98483991-98484676","148","98483991","98484676","685","1534.31159643","0.446454293634"
"SL2.50ch01:98485526-98487170","467","98485526","98487170","1644","1534.31159643","1.07149030472"
"SL2.50ch01:98486269-98487226","355","98486269","98487226","957","1534.31159643","0.623732494902"
"SL2.50ch01:98492162-98492745","121","98492162","98492745","583","1534.31159643","0.379974968159"
"SL2.50ch01:98497795-98499816","458","98497795","98499816","2021","1534.31159643","1.31720310574"
"SL2.50ch01:98502870-98505066","602","98502870","98505066","2196","1534.31159643","1.431260772"
"SL2.50ch01:98506241-98507449","323","98506241","98507449","1208","1534.31159643","0.787323776219"
"SL2.50ch01:98530529-98530904","67","98530529","98530904","375","1534.31159643","0.244409284836"
"SL2.50ch01:98534714-98535186","164","98534714","98535186","472","1534.31159643","0.307629819847"
"SL2.50ch02:12835422-12844334","2486","12835422","12844334","8912","1534.31159643","5.8084681239"
"SL2.50ch02:12837047-12837537","145","12837047","12837537","490","1534.31159643","0.319361465519"
"SL2.50ch02:12839395-12841119","615","12839395","12841119","1724","1534.31159643","1.12363095215"
"SL2.50ch02:12845732-12848615","617","12845732","12848615","2883","1534.31159643","1.87901858182"
"SL2.50ch02:12849964-12857765","1795","12849964","12857765","7801","1534.31159643","5.08436488269"
"SL2.50ch02:12857016-12857524","115","12857016","12857524","508","1534.31159643","0.331093111192"
"SL2.50ch02:12859088-12865286","2106","12859088","12865286","6198","1534.31159643","4.03959665977"
"SL2.50ch02:12859505-12861268","556","12859505","12861268","1763","1534.31159643","1.14904951778"
"SL2.50ch02:12867166-12867870","275","12867166","12867870","704","1534.31159643","0.458837697399"
"SL2.50ch02:12887587-12888561","307","12887587","12888561","974","1534.31159643","0.634812382482"
"SL2.50ch02:12893940-12895344","263","12893940","12895344","1404","1534.31159643","0.915068362427"
"SL2.50ch02:12916048-12916423","73","12916048","12916423","375","1534.31159643","0.244409284836"
"SL2.50ch02:12918386-12918857","111","12918386","12918857","471","1534.31159643","0.306978061754"
"SL2.50ch02:12971206-12972987","551","12971206","12972987","1781","1534.31159643","1.16078116345"
"SL2.50ch02:12984908-12985517","117","12984908","12985517","609","1534.31159643","0.396920678574"
"SL2.50ch02:12992985-12996740","815","12992985","12996740","3755","1534.31159643","2.44735163883"
"SL2.50ch02:13002876-13017983","4277","13002876","13017983","15107","1534.31159643","9.84610950939"
"SL2.50ch02:13011188-13011678","118","13011188","13011678","490","1534.31159643","0.319361465519"
"SL2.50ch02:13018370-13020320","365","13018370","13020320","1950","1534.31159643","1.27092828115"
"SL2.50ch02:13022290-13022759","144","13022290","13022759","469","1534.31159643","0.305674545569"
"SL2.50ch02:13324451-13325032","121","13324451","13325032","581","1534.31159643","0.378671451973"
"SL2.50ch02:13773308-13773989","134","13773308","13773989","681","1534.31159643","0.443847261263"
"SL2.50ch02:13775643-13776112","335","13775643","13776112","469","1534.31159643","0.305674545569"
"SL2.50ch02:13778190-13780818","4390","13778190","13780818","2628","1534.31159643","1.71282026813"
"SL2.50ch02:13779945-13780790","3601","13779945","13780790","845","1534.31159643","0.550735588498"
"SL2.50ch02:13782935-13786345","8267","13782935","13786345","3410","1534.31159643","2.22249509678"
"SL2.50ch02:13783300-13784253","4806","13783300","13784253","953","1534.31159643","0.621125462531"
"SL2.50ch02:13784750-13786256","3344","13784750","13786256","1506","1534.31159643","0.981547687903"
"SL2.50ch02:13787281-13788760","1930","13787281","13788760","1479","1534.31159643","0.963950219394"
"SL2.50ch02:13787342-13787846","1657","13787342","13787846","504","1534.31159643","0.32848607882"
"SL2.50ch02:13815682-13816263","128","13815682","13816263","581","1534.31159643","0.378671451973"
"SL2.50ch02:13823738-13824140","1015","13823738","13824140","402","1534.31159643","0.262006753345"
"SL2.50ch02:13827392-13830284","5916","13827392","13830284","2892","1534.31159643","1.88488440466"
"SL2.50ch02:13830876-13833335","9379","13830876","13833335","2459","1534.31159643","1.60267315043"
"SL2.50ch02:13831055-13833195","9329","13831055","13833195","2140","1534.31159643","1.3947623188"
"SL2.50ch02:13845192-13845567","77","13845192","13845567","375","1534.31159643","0.244409284836"
"SL2.50ch02:13856709-13857306","143","13856709","13857306","597","1534.31159643","0.389099581459"
"SL2.50ch02:13874382-13884371","3032","13874382","13884371","9989","1534.31159643","6.51041158995"
"SL2.50ch02:15331834-15332350","447","15331834","15332350","516","1534.31159643","0.336307175935"
"SL2.50ch02:15517466-15518274","161","15517466","15518274","808","1534.31159643","0.526620539061"
"SL2.50ch02:16006591-16007127","108","16006591","16007127","536","1534.31159643","0.349342337793"
"SL2.50ch02:16075026-16075401","86","16075026","16075401","375","1534.31159643","0.244409284836"
"SL2.50ch02:16311701-16312340","126","16311701","16312340","639","1534.31159643","0.416473421361"
"SL2.50ch02:16345463-16346083","153","16345463","16346083","620","1534.31159643","0.404090017596"
"SL2.50ch02:17880673-17881075","614","17880673","17881075","402","1534.31159643","0.262006753345"
"SL2.50ch02:17882122-17882944","2128","17882122","17882944","822","1534.31159643","0.535745152361"
"SL2.50ch02:17882135-17883066","2147","17882135","17883066","931","1534.31159643","0.606786784487"
"SL2.50ch02:18090629-18091004","85","18090629","18091004","375","1534.31159643","0.244409284836"
"SL2.50ch02:18224749-18225264","108","18224749","18225264","515","1534.31159643","0.335655417842"
"SL2.50ch02:18810320-18811397","174","18810320","18811397","1077","1534.31159643","0.70194346605"
"SL2.50ch02:19051008-19051611","247","19051008","19051611","603","1534.31159643","0.393010130017"
"SL2.50ch02:19051111-19052172","348","19051111","19052172","1061","1534.31159643","0.691515336564"
"SL2.50ch02:19905226-19906826","442","19905226","19906826","1600","1534.31159643","1.04281294864"
"SL2.50ch02:19905311-19906897","432","19905311","19906897","1586","1534.31159643","1.03368833533"
"SL2.50ch02:19910002-19910488","96","19910002","19910488","486","1534.31159643","0.316754433148"
"SL2.50ch02:204024-204568","94","204024","204568","544","1534.31159643","0.354556402536"
"SL2.50ch02:20737516-20737918","507","20737516","20737918","402","1534.31159643","0.262006753345"
"SL2.50ch02:21344067-21345092","175","21344067","21345092","1025","1534.31159643","0.668052045219"
"SL2.50ch02:21625130-21625719","110","21625130","21625719","589","1534.31159643","0.383885516716"
"SL2.50ch02:22404775-22405265","2016","22404775","22405265","490","1534.31159643","0.319361465519"
"SL2.50ch02:22601520-22602086","151","22601520","22602086","566","1534.31159643","0.36889508058"
"SL2.50ch02:22880692-22881067","98","22880692","22881067","375","1534.31159643","0.244409284836"
"SL2.50ch02:22974418-22975445","228","22974418","22975445","1027","1534.31159643","0.669355561405"
"SL2.50ch02:23767749-23768837","1101","23767749","23768837","1088","1534.31159643","0.709112805072"
"SL2.50ch02:23767937-23768454","985","23767937","23768454","517","1534.31159643","0.336958934028"
"SL2.50ch02:24225306-24226515","221","24225306","24226515","1209","1534.31159643","0.787975534312"
"SL2.50ch02:24431561-24431936","77","24431561","24431936","375","1534.31159643","0.244409284836"
"SL2.50ch02:24490615-24495350","12414","24490615","24495350","4735","1534.31159643","3.08607456987"
"SL2.50ch02:24490717-24495399","12395","24490717","24495399","4682","1534.31159643","3.05153139094"
"SL2.50ch02:24495838-24496615","2126","24495838","24496615","777","1534.31159643","0.506416038181"
"SL2.50ch02:24495847-24496680","2123","24495847","24496680","833","1534.31159643","0.542914491383"
"SL2.50ch02:24497794-24498386","556","24497794","24498386","592","1534.31159643","0.385840790995"
"SL2.50ch02:24497811-24498433","561","24497811","24498433","622","1534.31159643","0.405393533782"
"SL2.50ch02:24507107-24507677","546","24507107","24507677","570","1534.31159643","0.371502112951"
"SL2.50ch02:24507171-24507681","540","24507171","24507681","510","1534.31159643","0.332396627377"
"SL2.50ch02:24512833-24514517","4957","24512833","24514517","1684","1534.31159643","1.09756062844"
"SL2.50ch02:24512869-24514609","4957","24512869","24514609","1740","1534.31159643","1.13405908164"
"SL2.50ch02:24527438-24528628","9476","24527438","24528628","1190","1534.31159643","0.775592130547"
"SL2.50ch02:24531697-24533162","2011","24531697","24533162","1465","1534.31159643","0.954825606094"
"SL2.50ch02:24531846-24533095","1988","24531846","24533095","1249","1534.31159643","0.814045858028"
"SL2.50ch02:2472631-2473594","177","2472631","2473594","963","1534.31159643","0.62764304346"
"SL2.50ch02:24948187-24952494","975","24948187","24952494","4307","1534.31159643","2.80712210611"
"SL2.50ch02:24968218-24970878","570","24968218","24970878","2660","1534.31159643","1.73367652711"
"SL2.50ch02:24972522-24980040","1487","24972522","24980040","7518","1534.31159643","4.8999173424"
"SL2.50ch02:25007683-25009561","390","25007683","25009561","1878","1534.31159643","1.22400169846"
"SL2.50ch02:25019877-25021322","311","25019877","25021322","1445","1534.31159643","0.941790444236"
"SL2.50ch02:2908971-2909728","1863","2908971","2909728","757","1534.31159643","0.493380876323"
"SL2.50ch02:2909039-2909571","1845","2909039","2909571","532","1534.31159643","0.346735305421"
"SL2.50ch02:30278301-30278676","147","30278301","30278676","375","1534.31159643","0.244409284836"
"SL2.50ch02:30497755-30498245","1875","30497755","30498245","490","1534.31159643","0.319361465519"
"SL2.50ch02:3104901-3105509","105","3104901","3105509","608","1534.31159643","0.396268920481"
"SL2.50ch02:31141327-31141892","121","31141327","31141892","565","1534.31159643","0.368243322487"
"SL2.50ch02:32963098-32963473","285","32963098","32963473","375","1534.31159643","0.244409284836"
"SL2.50ch02:36474207-36479398","1776","36474207","36479398","5191","1534.31159643","3.38327626023"
"SL2.50ch02:36475738-36476228","328","36475738","36476228","490","1534.31159643","0.319361465519"
"SL2.50ch02:3680327-3680702","74","3680327","3680702","375","1534.31159643","0.244409284836"
"SL2.50ch02:37743070-37743472","2028","37743070","37743472","402","1534.31159643","0.262006753345"
"SL2.50ch02:3888235-3889008","148","3888235","3889008","773","1534.31159643","0.503809005809"
"SL2.50ch02:41500716-41501118","516","41500716","41501118","402","1534.31159643","0.262006753345"
"SL2.50ch02:41500716-41501214","523","41500716","41501214","498","1534.31159643","0.324575530263"
"SL2.50ch02:41778656-41779031","96","41778656","41779031","375","1534.31159643","0.244409284836"
"SL2.50ch02:42082520-42083785","232","42082520","42083785","1265","1534.31159643","0.824473987515"
"SL2.50ch02:4424955-4425541","116","4424955","4425541","586","1534.31159643","0.381930242438"
"SL2.50ch02:44549031-44549818","17276","44549031","44549818","787","1534.31159643","0.51293361911"
"SL2.50ch02:44549066-44549818","17273","44549066","44549818","752","1534.31159643","0.490122085858"
"SL2.50ch02:44818411-44819137","23912","44818411","44819137","726","1534.31159643","0.473176375443"
"SL2.50ch02:44818489-44819236","23919","44818489","44819236","747","1534.31159643","0.486863295394"
"SL2.50ch02:45767419-45767794","86","45767419","45767794","375","1534.31159643","0.244409284836"
"SL2.50ch02:47579957-47580442","92","47579957","47580442","485","1534.31159643","0.316102675055"
"SL2.50ch02:48371617-48372130","377","48371617","48372130","513","1534.31159643","0.334351901656"
"SL2.50ch02:48371737-48372139","370","48371737","48372139","402","1534.31159643","0.262006753345"
"SL2.50ch02:48732880-48734093","240","48732880","48734093","1213","1534.31159643","0.790582566684"
"SL2.50ch02:49308269-49308885","5856","49308269","49308885","616","1534.31159643","0.401482985224"
"SL2.50ch02:49904144-49904854","241","49904144","49904854","710","1534.31159643","0.462748245957"
"SL2.50ch02:49904256-49904658","212","49904256","49904658","402","1534.31159643","0.262006753345"
"SL2.50ch02:52487679-52488250","184","52487679","52488250","571","1534.31159643","0.372153871044"
"SL2.50ch02:5257369-5258616","215","5257369","5258616","1247","1534.31159643","0.812742341842"
"SL2.50ch02:5752523-5752994","164","5752523","5752994","471","1534.31159643","0.306978061754"
"SL2.50ch02:6346335-6346803","192","6346335","6346803","468","1534.31159643","0.305022787476"
"SL2.50ch02:6347821-6348597","281","6347821","6348597","776","1534.31159643","0.505764280088"
"SL2.50ch02:7361323-7361843","116","7361323","7361843","520","1534.31159643","0.338914208306"
"SL2.50ch02:741592-742197","121","741592","742197","605","1534.31159643","0.394313646203"
"SL2.50ch02:7704925-7705300","82","7704925","7705300","375","1534.31159643","0.244409284836"
"SL2.50ch02:7741868-7742243","79","7741868","7742243","375","1534.31159643","0.244409284836"
"SL2.50ch02:7752404-7752779","86","7752404","7752779","375","1534.31159643","0.244409284836"
"SL2.50ch02:7957709-7958084","73","7957709","7958084","375","1534.31159643","0.244409284836"
"SL2.50ch02:9251221-9251828","2788","9251221","9251828","607","1534.31159643","0.395617162388"
"SL2.50ch02:9406540-9419289","5074","9406540","9419289","12749","1534.31159643","8.30926392634"
"SL2.50ch02:9407426-9419237","4912","9407426","9419237","11811","1534.31159643","7.69791483521"
"SL2.50ch02:9423911-9427218","1467","9423911","9427218","3307","1534.31159643","2.15536401321"
"SL2.50ch02:9423918-9427366","1478","9423918","9427366","3448","1534.31159643","2.24726190431"
"SL2.50ch02:9446878-9450512","686","9446878","9450512","3634","1534.31159643","2.36848890959"
"SL2.50ch02:9459090-9460766","390","9459090","9460766","1676","1534.31159643","1.0923465637"
"SL2.50ch02:9470431-9471176","140","9470431","9471176","745","1534.31159643","0.485559779208"
"SL2.50ch02:9477116-9477890","153","9477116","9477890","774","1534.31159643","0.504460763902"
"SL2.50ch02:9503321-9504323","177","9503321","9504323","1002","1534.31159643","0.653061609083"
"SL2.50ch02:9534345-9535131","194","9534345","9535131","786","1534.31159643","0.512281861017"
"SL2.50ch02:9536410-9537326","196","9536410","9537326","916","1534.31159643","0.597010413094"
"SL2.50ch02:9548043-9549156","204","9548043","9549156","1113","1534.31159643","0.725406757394"
"SL2.50ch02:9565411-9566675","289","9565411","9566675","1264","1534.31159643","0.823822229422"
"SL2.50ch02:9639480-9639855","79","9639480","9639855","375","1534.31159643","0.244409284836"
"SL2.50ch02:9655132-9656369","217","9655132","9656369","1237","1534.31159643","0.806224760913"
"SL2.50ch02:9671401-9671960","110","9671401","9671960","559","1534.31159643","0.364332773929"
"SL2.50ch02:9676056-9676756","161","9676056","9676756","700","1534.31159643","0.456230665028"
"SL2.50ch02:9683072-9683701","173","9683072","9683701","629","1534.31159643","0.409955840432"
"SL2.50ch02:9689807-9690988","202","9689807","9690988","1181","1534.31159643","0.769726307711"
"SL2.50ch02:9717024-9717746","150","9717024","9717746","722","1534.31159643","0.470569343072"
"SL2.50ch03:11058702-11059077","82","11058702","11059077","375","1534.31159643","0.244409284836"
"SL2.50ch03:11213472-11214074","122","11213472","11214074","602","1534.31159643","0.392358371924"
"SL2.50ch03:11743641-11748395","1218","11743641","11748395","4754","1534.31159643","3.09845797363"
"SL2.50ch03:11747775-11748446","178","11747775","11748446","671","1534.31159643","0.437329680334"
"SL2.50ch03:12265197-12265680","92","12265197","12265680","483","1534.31159643","0.314799158869"
"SL2.50ch03:12965029-12965619","137","12965029","12965619","590","1534.31159643","0.384537274809"
"SL2.50ch03:13255889-13257488","305","13255889","13257488","1599","1534.31159643","1.04216119054"
"SL2.50ch03:13269637-13270807","221","13269637","13270807","1170","1534.31159643","0.762556968689"
"SL2.50ch03:13285827-13286202","78","13285827","13286202","375","1534.31159643","0.244409284836"
"SL2.50ch03:13310956-13311988","190","13310956","13311988","1032","1534.31159643","0.67261435187"
"SL2.50ch03:13318237-13320243","737","13318237","13320243","2006","1534.31159643","1.30742673435"
"SL2.50ch03:13321597-13325545","959","13321597","13325545","3948","1534.31159643","2.57314095076"
"SL2.50ch03:13328728-13330066","218","13328728","13330066","1338","1534.31159643","0.872052328296"
"SL2.50ch03:13343373-13345685","578","13343373","13345685","2312","1534.31159643","1.50686471078"
"SL2.50ch03:13345017-13345645","305","13345017","13345645","628","1534.31159643","0.409304082339"
"SL2.50ch03:13361926-13363313","721","13361926","13363313","1387","1534.31159643","0.903988474848"
"SL2.50ch03:13361959-13363237","721","13361959","13363237","1278","1534.31159643","0.832946842722"
"SL2.50ch03:13366705-13367423","196","13366705","13367423","718","1534.31159643","0.4679623107"
"SL2.50ch03:13368070-13372262","1381","13368070","13372262","4192","1534.31159643","2.73216992542"
"SL2.50ch03:13369009-13372265","1155","13369009","13372265","3256","1534.31159643","2.12212435047"
"SL2.50ch03:15952990-15954350","727","15952990","15954350","1360","1534.31159643","0.88639100634"
"SL2.50ch03:15953216-15954272","678","15953216","15954272","1056","1534.31159643","0.688256546099"
"SL2.50ch03:15955742-15957552","849","15955742","15957552","1810","1534.31159643","1.17968214814"
"SL2.50ch03:15955776-15957621","849","15955776","15957621","1845","1534.31159643","1.20249368139"
"SL2.50ch03:15958733-15960416","590","15958733","15960416","1683","1534.31159643","1.09690887035"
"SL2.50ch03:15958738-15960952","677","15958738","15960952","2214","1534.31159643","1.44299241767"
"SL2.50ch03:15969076-15970080","1399","15969076","15970080","1004","1534.31159643","0.654365125268"
"SL2.50ch03:15969145-15973104","2810","15969145","15973104","3959","1534.31159643","2.58031028978"
"SL2.50ch03:15971377-15973118","1197","15971377","15973118","1741","1534.31159643","1.13471083973"
"SL2.50ch03:15974157-15977428","3166","15974157","15977428","3271","1534.31159643","2.13190072187"
"SL2.50ch03:15974161-15974663","279","15974161","15974663","502","1534.31159643","0.327182562634"
"SL2.50ch03:15975168-15977466","2799","15975168","15977466","2298","1534.31159643","1.49774009748"
"SL2.50ch03:16287134-16287937","153","16287134","16287937","803","1534.31159643","0.523361748596"
"SL2.50ch03:16289540-16291454","446","16289540","16291454","1914","1534.31159643","1.2474649898"
"SL2.50ch03:16290921-16291424","191","16290921","16291424","503","1534.31159643","0.327834320727"
"SL2.50ch03:16295263-16296034","146","16295263","16296034","771","1534.31159643","0.502505489623"
"SL2.50ch03:16306709-16308124","295","16306709","16308124","1415","1534.31159643","0.922237701449"
"SL2.50ch03:16483504-16484101","125","16483504","16484101","597","1534.31159643","0.389099581459"
"SL2.50ch03:16813607-16814233","820","16813607","16814233","626","1534.31159643","0.408000566153"
"SL2.50ch03:17787362-17788004","126","17787362","17788004","642","1534.31159643","0.41842869564"
"SL2.50ch03:1788130-1789325","220","1788130","1789325","1195","1534.31159643","0.778850921012"
"SL2.50ch03:19394122-19395508","288","19394122","19395508","1386","1534.31159643","0.903336716755"
"SL2.50ch03:20102977-20103352","113","20102977","20103352","375","1534.31159643","0.244409284836"
"SL2.50ch03:20151953-20152438","104","20151953","20152438","485","1534.31159643","0.316102675055"
"SL2.50ch03:20391278-20392186","183","20391278","20392186","908","1534.31159643","0.59179634835"
"SL2.50ch03:20430092-20431061","157","20430092","20431061","969","1534.31159643","0.631553592017"
"SL2.50ch03:20510377-20510956","210","20510377","20510956","579","1534.31159643","0.377367935787"
"SL2.50ch03:22923191-22923755","221","22923191","22923755","564","1534.31159643","0.367591564394"
"SL2.50ch03:23544067-23545151","616","23544067","23545151","1084","1534.31159643","0.7065057727"
"SL2.50ch03:23694522-23695413","3107","23694522","23695413","891","1534.31159643","0.580716460771"
"SL2.50ch03:23694553-23695405","3107","23694553","23695405","852","1534.31159643","0.555297895148"
"SL2.50ch03:23696909-23697471","1242","23696909","23697471","562","1534.31159643","0.366288048208"
"SL2.50ch03:23696923-23697463","1241","23696923","23697463","540","1534.31159643","0.351949370164"
"SL2.50ch03:24895811-24896734","195","24895811","24896734","923","1534.31159643","0.601572719744"
"SL2.50ch03:25794916-25795551","7272","25794916","25795551","635","1534.31159643","0.41386638899"
"SL2.50ch03:25795072-25795633","7267","25795072","25795633","561","1534.31159643","0.365636290115"
"SL2.50ch03:27306822-27307351","121","27306822","27307351","529","1534.31159643","0.344780031142"
"SL2.50ch03:28416380-28416853","96","28416380","28416853","473","1534.31159643","0.30828157794"
"SL2.50ch03:29465861-29466440","127","29465861","29466440","579","1534.31159643","0.377367935787"
"SL2.50ch03:29582486-29582986","93","29582486","29582986","500","1534.31159643","0.325879046448"
"SL2.50ch03:29750176-29750777","145","29750176","29750777","601","1534.31159643","0.391706613831"
"SL2.50ch03:30364137-30369932","10502","30364137","30369932","5795","1534.31159643","3.77693814834"
"SL2.50ch03:30365354-30369827","10293","30365354","30369827","4473","1534.31159643","2.91531394953"
"SL2.50ch03:30568857-30569547","134","30568857","30569547","690","1534.31159643","0.449713084099"
"SL2.50ch03:30712542-30712917","66","30712542","30712917","375","1534.31159643","0.244409284836"
"SL2.50ch03:30751607-30751982","67","30751607","30751982","375","1534.31159643","0.244409284836"
"SL2.50ch03:31454419-31455482","164","31454419","31455482","1063","1534.31159643","0.692818852749"
"SL2.50ch03:31622098-31623811","650","31622098","31623811","1713","1534.31159643","1.11646161313"
"SL2.50ch03:31622181-31623823","649","31622181","31623823","1642","1534.31159643","1.07018678854"
"SL2.50ch03:3174757-3175259","335","3174757","3175259","502","1534.31159643","0.327182562634"
"SL2.50ch03:32171095-32172287","10082","32171095","32172287","1192","1534.31159643","0.776895646733"
"SL2.50ch03:32171131-32172275","10081","32171131","32172275","1144","1534.31159643","0.745611258274"
"SL2.50ch03:32831365-32831740","68","32831365","32831740","375","1534.31159643","0.244409284836"
"SL2.50ch03:33136306-33137004","25313","33136306","33137004","698","1534.31159643","0.454927148842"
"SL2.50ch03:33136487-33137099","25303","33136487","33137099","612","1534.31159643","0.398875952853"
"SL2.50ch03:33137645-33140600","104158","33137645","33140600","2955","1534.31159643","1.92594516451"
"SL2.50ch03:33277703-33278173","184","33277703","33278173","470","1534.31159643","0.306326303662"
"SL2.50ch03:33529669-33530151","83","33529669","33530151","482","1534.31159643","0.314147400776"
"SL2.50ch03:34590893-34593313","2351","34590893","34593313","2420","1534.31159643","1.57725458481"
"SL2.50ch03:34591050-34593046","2272","34591050","34593046","1996","1534.31159643","1.30090915342"
"SL2.50ch03:34595117-34595977","1559","34595117","34595977","860","1534.31159643","0.560511959891"
"SL2.50ch03:34595186-34597006","1730","34595186","34597006","1820","1534.31159643","1.18619972907"
"SL2.50ch03:34597521-34598361","1684","34597521","34598361","840","1534.31159643","0.547476798033"
"SL2.50ch03:34597534-34598433","1689","34597534","34598433","899","1534.31159643","0.585930525514"
"SL2.50ch03:34599973-34601583","7512","34599973","34601583","1610","1534.31159643","1.04933052956"
"SL2.50ch03:34600055-34601530","7499","34600055","34601530","1475","1534.31159643","0.961343187023"
"SL2.50ch03:34606036-34609039","7958","34606036","34609039","3003","1534.31159643","1.95722955297"
"SL2.50ch03:34606216-34608819","7914","34606216","34608819","2603","1534.31159643","1.69652631581"
"SL2.50ch03:36149961-36150437","125","36149961","36150437","476","1534.31159643","0.310236852219"
"SL2.50ch03:36366203-36366578","68","36366203","36366578","375","1534.31159643","0.244409284836"
"SL2.50ch03:36590703-36591078","70","36590703","36591078","375","1534.31159643","0.244409284836"
"SL2.50ch03:37388243-37388966","1833","37388243","37388966","723","1534.31159643","0.471221101164"
"SL2.50ch03:37388255-37389163","1862","37388255","37389163","908","1534.31159643","0.59179634835"
"SL2.50ch03:37574696-37575071","87","37574696","37575071","375","1534.31159643","0.244409284836"
"SL2.50ch03:37822705-37823364","144","37822705","37823364","659","1534.31159643","0.429508583219"
"SL2.50ch03:38127483-38128156","131","38127483","38128156","673","1534.31159643","0.43863319652"
"SL2.50ch03:38361197-38362150","157","38361197","38362150","953","1534.31159643","0.621125462531"
"SL2.50ch03:38719280-38719655","69","38719280","38719655","375","1534.31159643","0.244409284836"
"SL2.50ch03:39625938-39626421","113","39625938","39626421","483","1534.31159643","0.314799158869"
"SL2.50ch03:39746103-39747589","543","39746103","39747589","1486","1534.31159643","0.968512526045"
"SL2.50ch03:40280870-40281693","157","40280870","40281693","823","1534.31159643","0.536396910454"
"SL2.50ch03:40663941-40664707","148","40663941","40664707","766","1534.31159643","0.499246699159"
"SL2.50ch03:407239-407963","189","407239","407963","724","1534.31159643","0.471872859257"
"SL2.50ch03:41347339-41347855","1623","41347339","41347855","516","1534.31159643","0.336307175935"
"SL2.50ch03:41525316-41529259","892","41525316","41529259","3943","1534.31159643","2.56988216029"
"SL2.50ch03:42823297-42823934","3206","42823297","42823934","637","1534.31159643","0.415169905175"
"SL2.50ch03:43238956-43239331","91","43238956","43239331","375","1534.31159643","0.244409284836"
"SL2.50ch03:43439997-43440467","96","43439997","43440467","470","1534.31159643","0.306326303662"
"SL2.50ch03:44111907-44114461","33488","44111907","44114461","2554","1534.31159643","1.66459016926"
"SL2.50ch03:44111993-44114489","33476","44111993","44114489","2496","1534.31159643","1.62678819987"
"SL2.50ch03:44115827-44117012","35182","44115827","44117012","1185","1534.31159643","0.772333340083"
"SL2.50ch03:44115862-44117038","35105","44115862","44117038","1176","1534.31159643","0.766467517247"
"SL2.50ch03:44452735-44453445","269","44452735","44453445","710","1534.31159643","0.462748245957"
"SL2.50ch03:44456798-44458035","469","44456798","44458035","1237","1534.31159643","0.806224760913"
"SL2.50ch03:44459174-44460260","216","44459174","44460260","1086","1534.31159643","0.707809288886"
"SL2.50ch03:44888615-44888990","67","44888615","44888990","375","1534.31159643","0.244409284836"
"SL2.50ch03:45065945-45066556","130","45065945","45066556","611","1534.31159643","0.39822419476"
"SL2.50ch03:45136597-45137264","112","45136597","45137264","667","1534.31159643","0.434722647962"
"SL2.50ch03:45289744-45290119","70","45289744","45290119","375","1534.31159643","0.244409284836"
"SL2.50ch03:45379356-45381522","596","45379356","45381522","2166","1534.31159643","1.41170802921"
"SL2.50ch03:46522492-46523088","122","46522492","46523088","596","1534.31159643","0.388447823367"
"SL2.50ch03:47014584-47015543","179","47014584","47015543","959","1534.31159643","0.625036011088"
"SL2.50ch03:48906516-48909745","1606","48906516","48909745","3229","1534.31159643","2.10452688196"
"SL2.50ch03:48907463-48908286","989","48907463","48908286","823","1534.31159643","0.536396910454"
"SL2.50ch03:49590590-49590965","85","49590590","49590965","375","1534.31159643","0.244409284836"
"SL2.50ch03:49931866-49932241","73","49931866","49932241","375","1534.31159643","0.244409284836"
"SL2.50ch03:50412262-50412732","106","50412262","50412732","470","1534.31159643","0.306326303662"
"SL2.50ch03:50954079-50954793","142","50954079","50954793","714","1534.31159643","0.465355278328"
"SL2.50ch03:51201915-51202653","146","51201915","51202653","738","1534.31159643","0.480997472558"
"SL2.50ch03:51702327-51702992","3136","51702327","51702992","665","1534.31159643","0.433419131776"
"SL2.50ch03:51702481-51703095","3110","51702481","51703095","614","1534.31159643","0.400179469039"
"SL2.50ch03:52270878-52272691","382","52270878","52272691","1813","1534.31159643","1.18163742242"
"SL2.50ch03:52274986-52275969","171","52274986","52275969","983","1534.31159643","0.640678205318"
"SL2.50ch03:52597401-52597803","248","52597401","52597803","402","1534.31159643","0.262006753345"
"SL2.50ch03:53569746-53570307","280","53569746","53570307","561","1534.31159643","0.365636290115"
"SL2.50ch03:53623667-53624356","670","53623667","53624356","689","1534.31159643","0.449061326006"
"SL2.50ch03:53627832-53628544","2833","53627832","53628544","712","1534.31159643","0.464051762143"
"SL2.50ch03:53627858-53628621","2833","53627858","53628621","763","1534.31159643","0.49729142488"
"SL2.50ch03:53931373-53932658","572","53931373","53932658","1285","1534.31159643","0.837509149372"
"SL2.50ch03:54169559-54172842","929","54169559","54172842","3283","1534.31159643","2.13972181898"
"SL2.50ch03:54169580-54172792","920","54169580","54172792","3212","1534.31159643","2.09344699438"
"SL2.50ch03:54176340-54177266","399","54176340","54177266","926","1534.31159643","0.603527994023"
"SL2.50ch03:54176397-54177355","409","54176397","54177355","958","1534.31159643","0.624384252995"
"SL2.50ch03:54180801-54182640","668","54180801","54182640","1839","1534.31159643","1.19858313284"
"SL2.50ch03:56488540-56490509","8933","56488540","56490509","1969","1534.31159643","1.28331168491"
"SL2.50ch03:56488743-56490395","8894","56488743","56490395","1652","1534.31159643","1.07670436947"
"SL2.50ch03:57120790-57121298","98","57120790","57121298","508","1534.31159643","0.331093111192"
"SL2.50ch03:60836717-60839032","452","60836717","60839032","2315","1534.31159643","1.50881998506"
"SL2.50ch03:60887178-60887935","183","60887178","60887935","757","1534.31159643","0.493380876323"
"SL2.50ch03:62569594-62569996","458","62569594","62569996","402","1534.31159643","0.262006753345"
"SL2.50ch03:6454447-6455012","226","6454447","6455012","565","1534.31159643","0.368243322487"
"SL2.50ch03:64832472-64835555","590","64832472","64835555","3083","1534.31159643","2.0093702004"
"SL2.50ch03:64925071-64929301","927","64925071","64929301","4230","1534.31159643","2.75693673295"
"SL2.50ch03:65838849-65839411","562","65838849","65839411","562","1534.31159643","0.366288048208"
"SL2.50ch03:67851346-67851836","7041","67851346","67851836","490","1534.31159643","0.319361465519"
"SL2.50ch03:67851421-67851889","7041","67851421","67851889","468","1534.31159643","0.305022787476"
"SL2.50ch03:6883156-6883946","227","6883156","6883946","790","1534.31159643","0.514888893389"
"SL2.50ch03:6919095-6919569","94","6919095","6919569","474","1534.31159643","0.308933336033"
"SL2.50ch03:6921518-6922643","301","6921518","6922643","1125","1534.31159643","0.733227854509"
"SL2.50ch03:6947130-6948891","498","6947130","6948891","1761","1534.31159643","1.14774600159"
"SL2.50ch03:6950630-6953393","920","6950630","6953393","2763","1534.31159643","1.80080761067"
"SL2.50ch03:6965441-6966808","435","6965441","6966808","1367","1534.31159643","0.89095331299"
"SL2.50ch03:70528807-70529413","806","70528807","70529413","606","1534.31159643","0.394965404296"
"SL2.50ch03:7105723-7106192","320","7105723","7106192","469","1534.31159643","0.305674545569"
"SL2.50ch03:7108873-7110202","315","7108873","7110202","1329","1534.31159643","0.86618650546"
"SL2.50ch04:11167865-11168494","1340","11167865","11168494","629","1534.31159643","0.409955840432"
"SL2.50ch04:11568536-11569010","221","11568536","11569010","474","1534.31159643","0.308933336033"
"SL2.50ch04:12134891-12135381","96","12134891","12135381","490","1534.31159643","0.319361465519"
"SL2.50ch04:12536113-12537064","291","12536113","12537064","951","1534.31159643","0.619821946345"
"SL2.50ch04:12545616-12546288","172","12545616","12546288","672","1534.31159643","0.437981438427"
"SL2.50ch04:12547228-12547707","119","12547228","12547707","479","1534.31159643","0.312192126498"
"SL2.50ch04:13811031-13811873","157","13811031","13811873","842","1534.31159643","0.548780314219"
"SL2.50ch04:14454669-14455748","257","14454669","14455748","1079","1534.31159643","0.703246982236"
"SL2.50ch04:14534431-14535267","184","14534431","14535267","836","1534.31159643","0.544869765662"
"SL2.50ch04:14616344-14616913","170","14616344","14616913","569","1534.31159643","0.370850354858"
"SL2.50ch04:14677241-14677991","171","14677241","14677991","750","1534.31159643","0.488818569673"
"SL2.50ch04:14685626-14686434","202","14685626","14686434","808","1534.31159643","0.526620539061"
"SL2.50ch04:14715454-14716627","288","14715454","14716627","1173","1534.31159643","0.764512242968"
"SL2.50ch04:14729594-14730907","392","14729594","14730907","1313","1534.31159643","0.855758375974"
"SL2.50ch04:14738542-14739013","119","14738542","14739013","471","1534.31159643","0.306978061754"
"SL2.50ch04:14742352-14743858","424","14742352","14743858","1506","1534.31159643","0.981547687903"
"SL2.50ch04:14755876-14756951","257","14755876","14756951","1075","1534.31159643","0.700639949864"
"SL2.50ch04:14768565-14769960","366","14768565","14769960","1395","1534.31159643","0.909202539591"
"SL2.50ch04:14807941-14809954","485","14807941","14809954","2013","1534.31159643","1.311989041"
"SL2.50ch04:14813993-14814806","182","14813993","14814806","813","1534.31159643","0.529879329525"
"SL2.50ch04:14834142-14836881","769","14834142","14836881","2739","1534.31159643","1.78516541644"
"SL2.50ch04:14841334-14841876","107","14841334","14841876","542","1534.31159643","0.35325288635"
"SL2.50ch04:14842574-14844001","347","14842574","14844001","1427","1534.31159643","0.930058798564"
"SL2.50ch04:14985947-14986465","98","14985947","14986465","518","1534.31159643","0.337610692121"
"SL2.50ch04:15038494-15039297","295","15038494","15039297","803","1534.31159643","0.523361748596"
"SL2.50ch04:15038500-15041316","869","15038500","15041316","2816","1534.31159643","1.8353507896"
"SL2.50ch04:15417417-15418005","110","15417417","15418005","588","1534.31159643","0.383233758623"
"SL2.50ch04:15958079-15958454","76","15958079","15958454","375","1534.31159643","0.244409284836"
"SL2.50ch04:17160851-17161555","210","17160851","17161555","704","1534.31159643","0.458837697399"
"SL2.50ch04:17249218-17250111","187","17249218","17250111","893","1534.31159643","0.582019976957"
"SL2.50ch04:17251619-17251994","90","17251619","17251994","375","1534.31159643","0.244409284836"
"SL2.50ch04:18560488-18561075","2732","18560488","18561075","587","1534.31159643","0.38258200053"
"SL2.50ch04:18560554-18561096","2728","18560554","18561096","542","1534.31159643","0.35325288635"
"SL2.50ch04:19878321-19878696","91","19878321","19878696","375","1534.31159643","0.244409284836"
"SL2.50ch04:20399812-20400187","81","20399812","20400187","375","1534.31159643","0.244409284836"
"SL2.50ch04:20722013-20722494","98","20722013","20722494","481","1534.31159643","0.313495642683"
"SL2.50ch04:20773780-20774549","184","20773780","20774549","769","1534.31159643","0.501201973438"
"SL2.50ch04:21059530-21059905","84","21059530","21059905","375","1534.31159643","0.244409284836"
"SL2.50ch04:21369111-21369486","80","21369111","21369486","375","1534.31159643","0.244409284836"
"SL2.50ch04:21474510-21475246","156","21474510","21475246","736","1534.31159643","0.479693956372"
"SL2.50ch04:21979423-21979950","139","21979423","21979950","527","1534.31159643","0.343476514957"
"SL2.50ch04:24046018-24046963","234","24046018","24046963","945","1534.31159643","0.615911397788"
"SL2.50ch04:248030-248432","295","248030","248432","402","1534.31159643","0.262006753345"
"SL2.50ch04:25230288-25230780","106","25230288","25230780","492","1534.31159643","0.320664981705"
"SL2.50ch04:26075214-26075689","114","26075214","26075689","475","1534.31159643","0.309585094126"
"SL2.50ch04:26395424-26397215","362","26395424","26397215","1791","1534.31159643","1.16729874438"
"SL2.50ch04:26620940-26622083","206","26620940","26622083","1143","1534.31159643","0.744959500181"
"SL2.50ch04:26655663-26657240","332","26655663","26657240","1577","1534.31159643","1.0278225125"
"SL2.50ch04:26669361-26671911","700","26669361","26671911","2550","1534.31159643","1.66198313689"
"SL2.50ch04:26674539-26675115","158","26674539","26675115","576","1534.31159643","0.375412661509"
"SL2.50ch04:26705733-26708543","518","26705733","26708543","2810","1534.31159643","1.83144024104"
"SL2.50ch04:26707198-26708153","191","26707198","26708153","955","1534.31159643","0.622428978717"
"SL2.50ch04:26712301-26716719","947","26712301","26716719","4418","1534.31159643","2.87946725442"
"SL2.50ch04:26717448-26722901","1212","26717448","26722901","5453","1534.31159643","3.55403688057"
"SL2.50ch04:26721964-26722601","165","26721964","26722601","637","1534.31159643","0.415169905175"
"SL2.50ch04:26757403-26764442","1342","26757403","26764442","7039","1534.31159643","4.5877252159"
"SL2.50ch04:26778881-26785520","1382","26778881","26785520","6639","1534.31159643","4.32702197874"
"SL2.50ch04:26795859-26796448","157","26795859","26796448","589","1534.31159643","0.383885516716"
"SL2.50ch04:26825939-26827886","408","26825939","26827886","1947","1534.31159643","1.26897300687"
"SL2.50ch04:26834101-26837317","628","26834101","26837317","3216","1534.31159643","2.09605402676"
"SL2.50ch04:26837800-26842030","987","26837800","26842030","4230","1534.31159643","2.75693673295"
"SL2.50ch04:26842476-26843087","130","26842476","26843087","611","1534.31159643","0.39822419476"
"SL2.50ch04:27596327-27597043","137","27596327","27597043","716","1534.31159643","0.466658794514"
"SL2.50ch04:28236598-28236973","78","28236598","28236973","375","1534.31159643","0.244409284836"
"SL2.50ch04:28522434-28523268","166","28522434","28523268","834","1534.31159643","0.543566249476"
"SL2.50ch04:28683585-28684526","185","28683585","28684526","941","1534.31159643","0.613304365416"
"SL2.50ch04:28706517-28706892","80","28706517","28706892","375","1534.31159643","0.244409284836"
"SL2.50ch04:28822623-28823312","125","28822623","28823312","689","1534.31159643","0.449061326006"
"SL2.50ch04:29184607-29186133","251","29184607","29186133","1526","1534.31159643","0.994582849761"
"SL2.50ch04:30142865-30143540","500","30142865","30143540","675","1534.31159643","0.439936712705"
"SL2.50ch04:31278302-31278785","103","31278302","31278785","483","1534.31159643","0.314799158869"
"SL2.50ch04:31286822-31287586","7887","31286822","31287586","764","1534.31159643","0.497943182973"
"SL2.50ch04:31286912-31287515","7874","31286912","31287515","603","1534.31159643","0.393010130017"
"SL2.50ch04:31883443-31883818","66","31883443","31883818","375","1534.31159643","0.244409284836"
"SL2.50ch04:32073532-32073907","69","32073532","32073907","375","1534.31159643","0.244409284836"
"SL2.50ch04:32664006-32664594","141","32664006","32664594","588","1534.31159643","0.383233758623"
"SL2.50ch04:33195737-33196632","173","33195737","33196632","895","1534.31159643","0.583323493143"
"SL2.50ch04:33411788-33412553","1021","33411788","33412553","765","1534.31159643","0.498594941066"
"SL2.50ch04:33411857-33412482","1008","33411857","33412482","625","1534.31159643","0.407348808061"
"SL2.50ch04:33600068-33600848","1156","33600068","33600848","780","1534.31159643","0.50837131246"
"SL2.50ch04:33600221-33600711","1130","33600221","33600711","490","1534.31159643","0.319361465519"
"SL2.50ch04:33964712-33965872","2867","33964712","33965872","1160","1534.31159643","0.75603938776"
"SL2.50ch04:33966316-33967439","2607","33966316","33967439","1123","1534.31159643","0.731924338323"
"SL2.50ch04:35556262-35557403","231","35556262","35557403","1141","1534.31159643","0.743655983995"
"SL2.50ch04:35724231-35724606","67","35724231","35724606","375","1534.31159643","0.244409284836"
"SL2.50ch04:36421237-36421612","74","36421237","36421612","375","1534.31159643","0.244409284836"
"SL2.50ch04:37931966-37932599","111","37931966","37932599","633","1534.31159643","0.412562872804"
"SL2.50ch04:4062224-4062839","575","4062224","4062839","615","1534.31159643","0.400831227132"
"SL2.50ch04:4062368-4062840","561","4062368","4062840","472","1534.31159643","0.307629819847"
"SL2.50ch04:40873440-40873972","108","40873440","40873972","532","1534.31159643","0.346735305421"
"SL2.50ch04:41198237-41199273","538","41198237","41199273","1036","1534.31159643","0.675221384241"
"SL2.50ch04:41198767-41199169","441","41198767","41199169","402","1534.31159643","0.262006753345"
"SL2.50ch04:41209844-41211136","409","41209844","41211136","1292","1534.31159643","0.842071456023"
"SL2.50ch04:41210288-41210690","237","41210288","41210690","402","1534.31159643","0.262006753345"
"SL2.50ch04:41212108-41212910","1431","41212108","41212910","802","1534.31159643","0.522709990503"
"SL2.50ch04:41212181-41214051","1818","41212181","41214051","1870","1534.31159643","1.21878763372"
"SL2.50ch04:42479013-42479482","84","42479013","42479482","469","1534.31159643","0.305674545569"
"SL2.50ch04:42564984-42565487","436","42564984","42565487","503","1534.31159643","0.327834320727"
"SL2.50ch04:42863763-42864367","336","42863763","42864367","604","1534.31159643","0.39366188811"
"SL2.50ch04:42863868-42864270","311","42863868","42864270","402","1534.31159643","0.262006753345"
"SL2.50ch04:43245790-43246413","832","43245790","43246413","623","1534.31159643","0.406045291875"
"SL2.50ch04:4481891-4482361","201","4481891","4482361","470","1534.31159643","0.306326303662"
"SL2.50ch04:4481981-4482383","191","4481981","4482383","402","1534.31159643","0.262006753345"
"SL2.50ch04:45285911-45287297","275","45285911","45287297","1386","1534.31159643","0.903336716755"
"SL2.50ch04:48279789-48280361","335","48279789","48280361","572","1534.31159643","0.372805629137"
"SL2.50ch04:49036971-49038698","332","49036971","49038698","1727","1534.31159643","1.12558622643"
"SL2.50ch04:49143558-49143933","64","49143558","49143933","375","1534.31159643","0.244409284836"
"SL2.50ch04:49645104-49645946","237","49645104","49645946","842","1534.31159643","0.548780314219"
"SL2.50ch04:50234340-50234809","276","50234340","50234809","469","1534.31159643","0.305674545569"
"SL2.50ch04:50472460-50472835","79","50472460","50472835","375","1534.31159643","0.244409284836"
"SL2.50ch04:51278355-51279207","177","51278355","51279207","852","1534.31159643","0.555297895148"
"SL2.50ch04:51485000-51485853","190","51485000","51485853","853","1534.31159643","0.555949653241"
"SL2.50ch04:51635479-51636070","109","51635479","51636070","591","1534.31159643","0.385189032902"
"SL2.50ch04:53908837-53910787","495","53908837","53910787","1950","1534.31159643","1.27092828115"
"SL2.50ch04:54906279-54907178","165","54906279","54907178","899","1534.31159643","0.585930525514"
"SL2.50ch04:55562801-55563366","196","55562801","55563366","565","1534.31159643","0.368243322487"
"SL2.50ch04:55565029-55568902","1190","55565029","55568902","3873","1534.31159643","2.52425909379"
"SL2.50ch04:56149404-56149902","387","56149404","56149902","498","1534.31159643","0.324575530263"
"SL2.50ch04:56149433-56149923","369","56149433","56149923","490","1534.31159643","0.319361465519"
"SL2.50ch04:58235758-58236265","1969","58235758","58236265","507","1534.31159643","0.330441353099"
"SL2.50ch04:64832233-64832635","1369","64832233","64832635","402","1534.31159643","0.262006753345"
"SL2.50ch04:65387298-65387815","1720","65387298","65387815","517","1534.31159643","0.336958934028"
"SL2.50ch04:6910496-6910986","1686","6910496","6910986","490","1534.31159643","0.319361465519"
"SL2.50ch04:7364261-7369138","994","7364261","7369138","4877","1534.31159643","3.17862421906"
"SL2.50ch04:7371892-7377121","1143","7371892","7377121","5229","1534.31159643","3.40804306776"
"SL2.50ch04:7380735-7382481","388","7380735","7382481","1746","1534.31159643","1.1379696302"
"SL2.50ch04:7382991-7384030","212","7382991","7384030","1039","1534.31159643","0.67717665852"
"SL2.50ch04:7386752-7387485","171","7386752","7387485","733","1534.31159643","0.477738682093"
"SL2.50ch04:7459635-7460520","203","7459635","7460520","885","1534.31159643","0.576805912214"
"SL2.50ch05:10221775-10222463","167","10221775","10222463","688","1534.31159643","0.448409567913"
"SL2.50ch05:11785098-11785615","1095","11785098","11785615","517","1534.31159643","0.336958934028"
"SL2.50ch05:12450271-12450772","95","12450271","12450772","501","1534.31159643","0.326530804541"
"SL2.50ch05:124759-125269","592","124759","125269","510","1534.31159643","0.332396627377"
"SL2.50ch05:124783-125158","586","124783","125158","375","1534.31159643","0.244409284836"
"SL2.50ch05:14605812-14607111","22150","14605812","14607111","1299","1534.31159643","0.846633762673"
"SL2.50ch05:14606104-14607177","22107","14606104","14607177","1073","1534.31159643","0.699336433678"
"SL2.50ch05:14690339-14690813","85","14690339","14690813","474","1534.31159643","0.308933336033"
"SL2.50ch05:16694334-16695352","202","16694334","16695352","1018","1534.31159643","0.663489738569"
"SL2.50ch05:16723083-16723458","87","16723083","16723458","375","1534.31159643","0.244409284836"
"SL2.50ch05:16979697-16980582","210","16979697","16980582","885","1534.31159643","0.576805912214"
"SL2.50ch05:17037597-17038067","125","17037597","17038067","470","1534.31159643","0.306326303662"
"SL2.50ch05:17039214-17042071","529","17039214","17042071","2857","1534.31159643","1.86207287141"
"SL2.50ch05:17047401-17049149","421","17047401","17049149","1748","1534.31159643","1.13927314638"
"SL2.50ch05:17049999-17051202","303","17049999","17051202","1203","1534.31159643","0.784064985755"
"SL2.50ch05:17051674-17053585","371","17051674","17053585","1911","1534.31159643","1.24550971553"
"SL2.50ch05:17159967-17160908","200","17159967","17160908","941","1534.31159643","0.613304365416"
"SL2.50ch05:17351314-17351783","122","17351314","17351783","469","1534.31159643","0.305674545569"
"SL2.50ch05:17385040-17386799","322","17385040","17386799","1759","1534.31159643","1.14644248541"
"SL2.50ch05:17470266-17470748","97","17470266","17470748","482","1534.31159643","0.314147400776"
"SL2.50ch05:18101997-18104616","457","18101997","18104616","2619","1534.31159643","1.7069544453"
"SL2.50ch05:18552024-18552965","180","18552024","18552965","941","1534.31159643","0.613304365416"
"SL2.50ch05:19596372-19596747","92","19596372","19596747","375","1534.31159643","0.244409284836"
"SL2.50ch05:1959664-1960304","130","1959664","1960304","640","1534.31159643","0.417125179454"
"SL2.50ch05:19600676-19604409","902","19600676","19604409","3733","1534.31159643","2.43301296078"
"SL2.50ch05:19605239-19606212","232","19605239","19606212","973","1534.31159643","0.634160624389"
"SL2.50ch05:19607655-19608710","197","19607655","19608710","1055","1534.31159643","0.687604788006"
"SL2.50ch05:19639952-19645121","1190","19639952","19645121","5169","1534.31159643","3.36893758218"
"SL2.50ch05:19649748-19655004","979","19649748","19655004","5256","1534.31159643","3.42564053627"
"SL2.50ch05:19672296-19678999","1392","19672296","19678999","6703","1534.31159643","4.36873449669"
"SL2.50ch05:19691784-19692791","179","19691784","19692791","1007","1534.31159643","0.656320399547"
"SL2.50ch05:19710141-19716979","1434","19710141","19716979","6838","1534.31159643","4.45672183923"
"SL2.50ch05:19834195-19835596","275","19834195","19835596","1401","1534.31159643","0.913113088149"
"SL2.50ch05:19838872-19840504","321","19838872","19840504","1632","1534.31159643","1.06366920761"
"SL2.50ch05:19852665-19856166","845","19852665","19856166","3501","1534.31159643","2.28180508323"
"SL2.50ch05:19856497-19856899","94","19856497","19856899","402","1534.31159643","0.262006753345"
"SL2.50ch05:20464725-20465198","110","20464725","20465198","473","1534.31159643","0.30828157794"
"SL2.50ch05:20931305-20931870","123","20931305","20931870","565","1534.31159643","0.368243322487"
"SL2.50ch05:2203006-2203774","2723","2203006","2203774","768","1534.31159643","0.500550215345"
"SL2.50ch05:2203064-2203696","2711","2203064","2203696","632","1534.31159643","0.411911114711"
"SL2.50ch05:23493368-23493743","163","23493368","23493743","375","1534.31159643","0.244409284836"
"SL2.50ch05:24103540-24104273","158","24103540","24104273","733","1534.31159643","0.477738682093"
"SL2.50ch05:24361724-24362496","1738","24361724","24362496","772","1534.31159643","0.503157247716"
"SL2.50ch05:24361765-24362394","1726","24361765","24362394","629","1534.31159643","0.409955840432"
"SL2.50ch05:25812465-25813284","9084","25812465","25813284","819","1534.31159643","0.533789878083"
"SL2.50ch05:25812610-25813324","9070","25812610","25813324","714","1534.31159643","0.465355278328"
"SL2.50ch05:26626503-26626905","2003","26626503","26626905","402","1534.31159643","0.262006753345"
"SL2.50ch05:26632661-26633731","232","26632661","26633731","1070","1534.31159643","0.6973811594"
"SL2.50ch05:27250714-27251089","80","27250714","27251089","375","1534.31159643","0.244409284836"
"SL2.50ch05:27332290-27332780","198","27332290","27332780","490","1534.31159643","0.319361465519"
"SL2.50ch05:27332339-27332714","198","27332339","27332714","375","1534.31159643","0.244409284836"
"SL2.50ch05:28102352-28102954","136","28102352","28102954","602","1534.31159643","0.392358371924"
"SL2.50ch05:28301241-28302022","9502","28301241","28302022","781","1534.31159643","0.509023070552"
"SL2.50ch05:28301334-28301960","9493","28301334","28301960","626","1534.31159643","0.408000566153"
"SL2.50ch05:29407450-29407825","75","29407450","29407825","375","1534.31159643","0.244409284836"
"SL2.50ch05:29577080-29577455","85","29577080","29577455","375","1534.31159643","0.244409284836"
"SL2.50ch05:30101233-30101608","83","30101233","30101608","375","1534.31159643","0.244409284836"
"SL2.50ch05:30135085-30135988","160","30135085","30135988","903","1534.31159643","0.588537557886"
"SL2.50ch05:30137680-30138917","430","30137680","30138917","1237","1534.31159643","0.806224760913"
"SL2.50ch05:30137755-30138678","385","30137755","30138678","923","1534.31159643","0.601572719744"
"SL2.50ch05:30147666-30148456","353","30147666","30148456","790","1534.31159643","0.514888893389"
"SL2.50ch05:30149749-30150226","146","30149749","30150226","477","1534.31159643","0.310888610312"
"SL2.50ch05:30155193-30155675","115","30155193","30155675","482","1534.31159643","0.314147400776"
"SL2.50ch05:30156832-30157338","388","30156832","30157338","506","1534.31159643","0.329789595006"
"SL2.50ch05:30156848-30157316","383","30156848","30157316","468","1534.31159643","0.305022787476"
"SL2.50ch05:31170466-31171574","209","31170466","31171574","1108","1534.31159643","0.72214796693"
"SL2.50ch05:31776383-31776892","1429","31776383","31776892","509","1534.31159643","0.331744869285"
"SL2.50ch05:32634842-32635820","199","32634842","32635820","978","1534.31159643","0.637419414853"
"SL2.50ch05:33142930-33143667","132","33142930","33143667","737","1534.31159643","0.480345714465"
"SL2.50ch05:34059111-34059601","2596","34059111","34059601","490","1534.31159643","0.319361465519"
"SL2.50ch05:34096133-34097461","15274","34096133","34097461","1328","1534.31159643","0.865534747367"
"SL2.50ch05:34096262-34097363","15257","34096262","34097363","1101","1534.31159643","0.717585660279"
"SL2.50ch05:34099408-34100973","88110","34099408","34100973","1565","1534.31159643","1.02000141538"
"SL2.50ch05:34099468-34100859","88095","34099468","34100859","1391","1534.31159643","0.90659550722"
"SL2.50ch05:35698420-35699648","2415","35698420","35699648","1228","1534.31159643","0.800358938077"
"SL2.50ch05:35698569-35699548","2412","35698569","35699548","979","1534.31159643","0.638071172946"
"SL2.50ch05:36600134-36600509","68","36600134","36600509","375","1534.31159643","0.244409284836"
"SL2.50ch05:36816130-36816505","83","36816130","36816505","375","1534.31159643","0.244409284836"
"SL2.50ch05:36962613-36963103","1457","36962613","36963103","490","1534.31159643","0.319361465519"
"SL2.50ch05:36962627-36963125","1459","36962627","36963125","498","1534.31159643","0.324575530263"
"SL2.50ch05:37476736-37477111","73","37476736","37477111","375","1534.31159643","0.244409284836"
"SL2.50ch05:40067674-40069045","1158","40067674","40069045","1371","1534.31159643","0.893560345362"
"SL2.50ch05:40068113-40069049","1081","40068113","40069049","936","1534.31159643","0.610045574951"
"SL2.50ch05:41165357-41165846","116","41165357","41165846","489","1534.31159643","0.318709707427"
"SL2.50ch05:41940526-41940901","70","41940526","41940901","375","1534.31159643","0.244409284836"
"SL2.50ch05:41976040-41976415","78","41976040","41976415","375","1534.31159643","0.244409284836"
"SL2.50ch05:42985477-42985949","178","42985477","42985949","472","1534.31159643","0.307629819847"
"SL2.50ch05:42985495-42985999","178","42985495","42985999","504","1534.31159643","0.32848607882"
"SL2.50ch05:45135206-45136043","6314","45135206","45136043","837","1534.31159643","0.545521523755"
"SL2.50ch05:45135258-45135873","6295","45135258","45135873","615","1534.31159643","0.400831227132"
"SL2.50ch05:47140025-47140809","149","47140025","47140809","784","1534.31159643","0.510978344831"
"SL2.50ch05:47294704-47295828","222","47294704","47295828","1124","1534.31159643","0.732576096416"
"SL2.50ch05:47551289-47551880","114","47551289","47551880","591","1534.31159643","0.385189032902"
"SL2.50ch05:47671730-47672105","100","47671730","47672105","375","1534.31159643","0.244409284836"
"SL2.50ch05:48166716-48167327","117","48166716","48167327","611","1534.31159643","0.39822419476"
"SL2.50ch05:48423913-48424315","466","48423913","48424315","402","1534.31159643","0.262006753345"
"SL2.50ch05:49228459-49228834","84","49228459","49228834","375","1534.31159643","0.244409284836"
"SL2.50ch05:49830583-49830958","101","49830583","49830958","375","1534.31159643","0.244409284836"
"SL2.50ch05:49929704-49930705","1178","49929704","49930705","1001","1534.31159643","0.65240985099"
"SL2.50ch05:49929897-49930538","1120","49929897","49930538","641","1534.31159643","0.417776937547"
"SL2.50ch05:51313961-51315479","29088","51313961","51315479","1518","1534.31159643","0.989368785017"
"SL2.50ch05:51314130-51315314","29029","51314130","51315314","1184","1534.31159643","0.77168158199"
"SL2.50ch05:51316938-51317633","362","51316938","51317633","695","1534.31159643","0.452971874563"
"SL2.50ch05:51317025-51317543","335","51317025","51317543","518","1534.31159643","0.337610692121"
"SL2.50ch05:51467477-51468328","288","51467477","51468328","851","1534.31159643","0.554646137055"
"SL2.50ch05:5398937-5399493","109","5398937","5399493","556","1534.31159643","0.362377499651"
"SL2.50ch05:56673377-56673752","72","56673377","56673752","375","1534.31159643","0.244409284836"
"SL2.50ch05:56705687-56706449","568","56705687","56706449","762","1534.31159643","0.496639666787"
"SL2.50ch05:56705909-56706311","470","56705909","56706311","402","1534.31159643","0.262006753345"
"SL2.50ch05:57568564-57573125","6794","57568564","57573125","4561","1534.31159643","2.9726686617"
"SL2.50ch05:57569065-57571282","1696","57569065","57571282","2217","1534.31159643","1.44494769195"
"SL2.50ch05:57571670-57573071","4855","57571670","57573071","1401","1534.31159643","0.913113088149"
"SL2.50ch05:57574567-57576582","2963","57574567","57576582","2015","1534.31159643","1.31329255719"
"SL2.50ch05:57574895-57576031","2825","57574895","57576031","1136","1534.31159643","0.740397193531"
"SL2.50ch05:57583723-57584484","503","57583723","57584484","761","1534.31159643","0.495987908695"
"SL2.50ch05:57583750-57584573","510","57583750","57584573","823","1534.31159643","0.536396910454"
"SL2.50ch05:57990456-57991043","114","57990456","57991043","587","1534.31159643","0.38258200053"
"SL2.50ch05:58886943-58888070","335","58886943","58888070","1127","1534.31159643","0.734531370695"
"SL2.50ch05:58887104-58887646","185","58887104","58887646","542","1534.31159643","0.35325288635"
"SL2.50ch05:58892060-58892860","17995","58892060","58892860","800","1534.31159643","0.521406474318"
"SL2.50ch05:58892105-58892790","17994","58892105","58892790","685","1534.31159643","0.446454293634"
"SL2.50ch05:60997404-60998305","1913","60997404","60998305","901","1534.31159643","0.5872340417"
"SL2.50ch05:60997419-60998286","1906","60997419","60998286","867","1534.31159643","0.565074266542"
"SL2.50ch05:62772343-62773063","4690","62772343","62773063","720","1534.31159643","0.469265826886"
"SL2.50ch05:62772472-62772980","4670","62772472","62772980","508","1534.31159643","0.331093111192"
"SL2.50ch05:62857695-62858167","341","62857695","62858167","472","1534.31159643","0.307629819847"
"SL2.50ch05:62857730-62858132","333","62857730","62858132","402","1534.31159643","0.262006753345"
"SL2.50ch05:64808123-64809136","900","64808123","64809136","1013","1534.31159643","0.660230948105"
"SL2.50ch05:6498327-6499129","21246","6498327","6499129","802","1534.31159643","0.522709990503"
"SL2.50ch05:6498340-6499318","21268","6498340","6499318","978","1534.31159643","0.637419414853"
"SL2.50ch05:6728431-6728921","785","6728431","6728921","490","1534.31159643","0.319361465519"
"SL2.50ch05:6773480-6774045","1997","6773480","6774045","565","1534.31159643","0.368243322487"
"SL2.50ch05:6773513-6774003","1997","6773513","6774003","490","1534.31159643","0.319361465519"
"SL2.50ch05:8435969-8436440","145","8435969","8436440","471","1534.31159643","0.306978061754"
"SL2.50ch05:8891224-8892218","147","8891224","8892218","994","1534.31159643","0.647847544339"
"SL2.50ch05:9087602-9088399","195","9087602","9088399","797","1534.31159643","0.519451200039"
"SL2.50ch05:932544-933080","117","932544","933080","536","1534.31159643","0.349342337793"
"SL2.50ch05:9672010-9673035","162","9672010","9673035","1025","1534.31159643","0.668052045219"
"SL2.50ch06:10946406-10946781","79","10946406","10946781","375","1534.31159643","0.244409284836"
"SL2.50ch06:10947690-10948333","202","10947690","10948333","643","1534.31159643","0.419080453733"
"SL2.50ch06:10947723-10948504","230","10947723","10948504","781","1534.31159643","0.509023070552"
"SL2.50ch06:10950419-10951848","395","10950419","10951848","1429","1534.31159643","0.93136231475"
"SL2.50ch06:10951139-10951768","267","10951139","10951768","629","1534.31159643","0.409955840432"
"SL2.50ch06:10957290-10958336","273","10957290","10958336","1046","1534.31159643","0.68173896517"
"SL2.50ch06:10957404-10958264","255","10957404","10958264","860","1534.31159643","0.560511959891"
"SL2.50ch06:10960949-10962258","472","10960949","10962258","1309","1534.31159643","0.853151343602"
"SL2.50ch06:10961192-10962318","424","10961192","10962318","1126","1534.31159643","0.733879612602"
"SL2.50ch06:10963237-10964462","355","10963237","10964462","1225","1534.31159643","0.798403663799"
"SL2.50ch06:10963704-10964378","245","10963704","10964378","674","1534.31159643","0.439284954612"
"SL2.50ch06:10965818-10966637","315","10965818","10966637","819","1534.31159643","0.533789878083"
"SL2.50ch06:10965974-10966580","297","10965974","10966580","606","1534.31159643","0.394965404296"
"SL2.50ch06:10968849-10970164","650","10968849","10970164","1315","1534.31159643","0.857061892159"
"SL2.50ch06:10968874-10970273","640","10968874","10970273","1399","1534.31159643","0.911809571963"
"SL2.50ch06:10971739-10972830","587","10971739","10972830","1091","1534.31159643","0.71106807935"
"SL2.50ch06:10971756-10972893","587","10971756","10972893","1137","1534.31159643","0.741048951624"
"SL2.50ch06:10979435-10980097","269","10979435","10980097","662","1534.31159643","0.431463857498"
"SL2.50ch06:10979499-10980082","260","10979499","10980082","583","1534.31159643","0.379974968159"
"SL2.50ch06:10982149-10982966","314","10982149","10982966","817","1534.31159643","0.532486361897"
"SL2.50ch06:10982192-10983000","296","10982192","10983000","808","1534.31159643","0.526620539061"
"SL2.50ch06:10986800-10990160","1138","10986800","10990160","3360","1534.31159643","2.18990719213"
"SL2.50ch06:10986803-10990089","1138","10986803","10990089","3286","1534.31159643","2.14167709326"
"SL2.50ch06:10996599-10999028","906","10996599","10999028","2429","1534.31159643","1.58312040765"
"SL2.50ch06:10996667-10998928","888","10996667","10998928","2261","1534.31159643","1.47362504804"
"SL2.50ch06:11000039-11000967","695","11000039","11000967","928","1534.31159643","0.604831510208"
"SL2.50ch06:11000042-11000979","695","11000042","11000979","937","1534.31159643","0.610697333044"
"SL2.50ch06:11008968-11009484","178","11008968","11009484","516","1534.31159643","0.336307175935"
"SL2.50ch06:11008998-11014464","1512","11008998","11014464","5466","1534.31159643","3.56250973577"
"SL2.50ch06:11009993-11014385","1245","11009993","11014385","4392","1534.31159643","2.862521544"
"SL2.50ch06:11019623-11027377","4255","11019623","11027377","7754","1534.31159643","5.05373225232"
"SL2.50ch06:11019663-11027361","4255","11019663","11027361","7698","1534.31159643","5.01723379912"
"SL2.50ch06:11032885-11037142","1903","11032885","11037142","4257","1534.31159643","2.77453420146"
"SL2.50ch06:11032913-11036993","1891","11032913","11036993","4080","1534.31159643","2.65917301902"
"SL2.50ch06:11037846-11040202","1183","11037846","11040202","2356","1534.31159643","1.53554206687"
"SL2.50ch06:11037848-11040368","1194","11037848","11040368","2520","1534.31159643","1.6424303941"
"SL2.50ch06:11040975-11044012","1391","11040975","11044012","3037","1534.31159643","1.97938932813"
"SL2.50ch06:11040994-11044052","1391","11040994","11044052","3058","1534.31159643","1.99307624808"
"SL2.50ch06:11050075-11054389","2498","11050075","11054389","4314","1534.31159643","2.81168441276"
"SL2.50ch06:11050100-11054316","2498","11050100","11054316","4216","1534.31159643","2.74781211965"
"SL2.50ch06:11063385-11064584","219","11063385","11064584","1199","1534.31159643","0.781457953383"
"SL2.50ch06:11088653-11090639","401","11088653","11090639","1986","1534.31159643","1.29439157249"
"SL2.50ch06:11092108-11092483","110","11092108","11092483","375","1534.31159643","0.244409284836"
"SL2.50ch06:11101527-11102398","212","11101527","11102398","871","1534.31159643","0.567681298913"
"SL2.50ch06:11121982-11124438","955","11121982","11124438","2456","1534.31159643","1.60071787615"
"SL2.50ch06:11122106-11124460","941","11122106","11124460","2354","1534.31159643","1.53423855068"
"SL2.50ch06:11125035-11127101","636","11125035","11127101","2066","1534.31159643","1.34653221992"
"SL2.50ch06:11125555-11127032","533","11125555","11127032","1477","1534.31159643","0.962646703209"
"SL2.50ch06:11127599-11128855","432","11127599","11128855","1256","1534.31159643","0.818608164678"
"SL2.50ch06:11137678-11138080","121","11137678","11138080","402","1534.31159643","0.262006753345"
"SL2.50ch06:11142260-11147791","1608","11142260","11147791","5531","1534.31159643","3.60487401181"
"SL2.50ch06:11142264-11149330","1862","11142264","11149330","7066","1534.31159643","4.60532268441"
"SL2.50ch06:11150074-11152488","1152","11150074","11152488","2414","1534.31159643","1.57334403625"
"SL2.50ch06:11186558-11187865","286","11186558","11187865","1307","1534.31159643","0.851847827416"
"SL2.50ch06:11194871-11195361","1172","11194871","11195361","490","1534.31159643","0.319361465519"
"SL2.50ch06:11232084-11232643","147","11232084","11232643","559","1534.31159643","0.364332773929"
"SL2.50ch06:11242479-11243580","198","11242479","11243580","1101","1534.31159643","0.717585660279"
"SL2.50ch06:11249527-11251064","316","11249527","11251064","1537","1534.31159643","1.00175218878"
"SL2.50ch06:11251623-11252887","253","11251623","11252887","1264","1534.31159643","0.823822229422"
"SL2.50ch06:11281571-11283224","259","11281571","11283224","1653","1534.31159643","1.07735612756"
"SL2.50ch06:11284966-11285462","110","11284966","11285462","496","1534.31159643","0.323272014077"
"SL2.50ch06:11403082-11403457","70","11403082","11403457","375","1534.31159643","0.244409284836"
"SL2.50ch06:11534187-11534803","586","11534187","11534803","616","1534.31159643","0.401482985224"
"SL2.50ch06:11537547-11538159","178","11537547","11538159","612","1534.31159643","0.398875952853"
"SL2.50ch06:11555872-11556484","1565","11555872","11556484","612","1534.31159643","0.398875952853"
"SL2.50ch06:11558107-11558719","1184","11558107","11558719","612","1534.31159643","0.398875952853"
"SL2.50ch06:11564966-11565573","395","11564966","11565573","607","1534.31159643","0.395617162388"
"SL2.50ch06:11564973-11565846","433","11564973","11565846","873","1534.31159643","0.568984815099"
"SL2.50ch06:11566596-11567349","352","11566596","11567349","753","1534.31159643","0.490773843951"
"SL2.50ch06:11567625-11569107","258","11567625","11569107","1482","1534.31159643","0.965905493673"
"SL2.50ch06:11578294-11578894","226","11578294","11578894","600","1534.31159643","0.391054855738"
"SL2.50ch06:11578367-11578928","226","11578367","11578928","561","1534.31159643","0.365636290115"
"SL2.50ch06:11581359-11581971","215","11581359","11581971","612","1534.31159643","0.398875952853"
"SL2.50ch06:11586601-11587003","133","11586601","11587003","402","1534.31159643","0.262006753345"
"SL2.50ch06:11590094-11593520","871","11590094","11593520","3426","1534.31159643","2.23292322626"
"SL2.50ch06:11599666-11601367","463","11599666","11601367","1701","1534.31159643","1.10864051602"
"SL2.50ch06:11604823-11606584","408","11604823","11606584","1761","1534.31159643","1.14774600159"
"SL2.50ch06:11605426-11606268","222","11605426","11606268","842","1534.31159643","0.548780314219"
"SL2.50ch06:11607704-11609191","783","11607704","11609191","1487","1534.31159643","0.969164284138"
"SL2.50ch06:11607763-11609274","785","11607763","11609274","1511","1534.31159643","0.984806478367"
"SL2.50ch06:11610985-11612389","446","11610985","11612389","1404","1534.31159643","0.915068362427"
"SL2.50ch06:11611117-11612311","417","11611117","11612311","1194","1534.31159643","0.778199162919"
"SL2.50ch06:11615330-11616382","259","11615330","11616382","1052","1534.31159643","0.685649513728"
"SL2.50ch06:11620070-11620580","127","11620070","11620580","510","1534.31159643","0.332396627377"
"SL2.50ch06:11622767-11624432","877","11622767","11624432","1665","1534.31159643","1.08517722467"
"SL2.50ch06:11622839-11624605","880","11622839","11624605","1766","1534.31159643","1.15100479206"
"SL2.50ch06:11632062-11632714","536","11632062","11632714","652","1534.31159643","0.424946276569"
"SL2.50ch06:11632067-11632732","536","11632067","11632732","665","1534.31159643","0.433419131776"
"SL2.50ch06:11634541-11636861","1122","11634541","11636861","2320","1534.31159643","1.51207877552"
"SL2.50ch06:11634582-11636856","1122","11634582","11636856","2274","1534.31159643","1.48209790325"
"SL2.50ch06:12253792-12255393","851","12253792","12255393","1601","1534.31159643","1.04346470673"
"SL2.50ch06:12253946-12255434","834","12253946","12255434","1488","1534.31159643","0.969816042231"
"SL2.50ch06:12260836-12261238","155","12260836","12261238","402","1534.31159643","0.262006753345"
"SL2.50ch06:12260932-12261847","251","12260932","12261847","915","1534.31159643","0.596358655001"
"SL2.50ch06:12263990-12268177","3015","12263990","12268177","4187","1534.31159643","2.72891113496"
"SL2.50ch06:12263995-12269859","3328","12263995","12269859","5864","1534.31159643","3.82190945675"
"SL2.50ch06:12268952-12269454","149","12268952","12269454","502","1534.31159643","0.327182562634"
"SL2.50ch06:12271732-12272338","119","12271732","12272338","606","1534.31159643","0.394965404296"
"SL2.50ch06:12276344-12278623","417","12276344","12278623","2279","1534.31159643","1.48535669371"
"SL2.50ch06:12276374-12276776","114","12276374","12276776","402","1534.31159643","0.262006753345"
"SL2.50ch06:12283739-12284815","187","12283739","12284815","1076","1534.31159643","0.701291707957"
"SL2.50ch06:12296111-12296601","819","12296111","12296601","490","1534.31159643","0.319361465519"
"SL2.50ch06:12375345-12376977","295","12375345","12376977","1632","1534.31159643","1.06366920761"
"SL2.50ch06:12380252-12382058","372","12380252","12382058","1806","1534.31159643","1.17707511577"
"SL2.50ch06:12387063-12389014","349","12387063","12389014","1951","1534.31159643","1.27158003924"
"SL2.50ch06:12392143-12392763","124","12392143","12392763","620","1534.31159643","0.404090017596"
"SL2.50ch06:12402165-12402540","78","12402165","12402540","375","1534.31159643","0.244409284836"
"SL2.50ch06:12431451-12433857","452","12431451","12433857","2406","1534.31159643","1.56812997151"
"SL2.50ch06:12447289-12448805","301","12447289","12448805","1516","1534.31159643","0.988065268832"
"SL2.50ch06:12449493-12450841","250","12449493","12450841","1348","1534.31159643","0.878569909225"
"SL2.50ch06:12457559-12459263","298","12457559","12459263","1704","1534.31159643","1.1105957903"
"SL2.50ch06:12465109-12465990","188","12465109","12465990","881","1534.31159643","0.574198879842"
"SL2.50ch06:12477838-12478858","233","12477838","12478858","1020","1534.31159643","0.664793254755"
"SL2.50ch06:12482968-12484779","286","12482968","12484779","1811","1534.31159643","1.18033390624"
"SL2.50ch06:12488303-12489856","302","12488303","12489856","1553","1534.31159643","1.01218031827"
"SL2.50ch06:12492685-12493828","185","12492685","12493828","1143","1534.31159643","0.744959500181"
"SL2.50ch06:12504601-12506605","349","12504601","12506605","2004","1534.31159643","1.30612321817"
"SL2.50ch06:12507326-12508268","190","12507326","12508268","942","1534.31159643","0.613956123509"
"SL2.50ch06:12533674-12534900","212","12533674","12534900","1226","1534.31159643","0.799055421892"
"SL2.50ch06:12562663-12564129","262","12562663","12564129","1466","1534.31159643","0.955477364187"
"SL2.50ch06:12579820-12580762","208","12579820","12580762","942","1534.31159643","0.613956123509"
"SL2.50ch06:12602997-12604244","243","12602997","12604244","1247","1534.31159643","0.812742341842"
"SL2.50ch06:12606000-12607139","200","12606000","12607139","1139","1534.31159643","0.74235246781"
"SL2.50ch06:12618856-12619563","147","12618856","12619563","707","1534.31159643","0.460792971678"
"SL2.50ch06:12621804-12623260","281","12621804","12623260","1456","1534.31159643","0.948959783258"
"SL2.50ch06:12642682-12643616","169","12642682","12643616","934","1534.31159643","0.608742058766"
"SL2.50ch06:12655595-12656931","231","12655595","12656931","1336","1534.31159643","0.87074881211"
"SL2.50ch06:12659346-12659814","108","12659346","12659814","468","1534.31159643","0.305022787476"
"SL2.50ch06:12667513-12670001","435","12667513","12670001","2488","1534.31159643","1.62157413513"
"SL2.50ch06:12673868-12675784","429","12673868","12675784","1916","1534.31159643","1.24876850599"
"SL2.50ch06:12691023-12692471","347","12691023","12692471","1448","1534.31159643","0.943745718515"
"SL2.50ch06:12715474-12716891","227","12715474","12716891","1417","1534.31159643","0.923541217635"
"SL2.50ch06:12741197-12743812","495","12741197","12743812","2615","1534.31159643","1.70434741293"
"SL2.50ch06:12754105-12754923","188","12754105","12754923","818","1534.31159643","0.53313811999"
"SL2.50ch06:12772546-12774247","421","12772546","12774247","1701","1534.31159643","1.10864051602"
"SL2.50ch06:12779180-12780745","285","12779180","12780745","1565","1534.31159643","1.02000141538"
"SL2.50ch06:12849408-12850272","1633","12849408","12850272","864","1534.31159643","0.563118992263"
"SL2.50ch06:12849430-12850318","1635","12849430","12850318","888","1534.31159643","0.578761186492"
"SL2.50ch06:12853054-12853456","80","12853054","12853456","402","1534.31159643","0.262006753345"
"SL2.50ch06:12880369-12882549","424","12880369","12882549","2180","1534.31159643","1.42083264252"
"SL2.50ch06:12904330-12905284","178","12904330","12905284","954","1534.31159643","0.621777220624"
"SL2.50ch06:12911795-12912848","177","12911795","12912848","1053","1534.31159643","0.68630127182"
"SL2.50ch06:12927539-12930895","632","12927539","12930895","3356","1534.31159643","2.18730015976"
"SL2.50ch06:12935094-12935563","145","12935094","12935563","469","1534.31159643","0.305674545569"
"SL2.50ch06:12944847-12945380","104","12944847","12945380","533","1534.31159643","0.347387063514"
"SL2.50ch06:12978564-12978939","97","12978564","12978939","375","1534.31159643","0.244409284836"
"SL2.50ch06:12987225-12987600","78","12987225","12987600","375","1534.31159643","0.244409284836"
"SL2.50ch06:12993501-12994303","193","12993501","12994303","802","1534.31159643","0.522709990503"
"SL2.50ch06:13025796-13026986","212","13025796","13026986","1190","1534.31159643","0.775592130547"
"SL2.50ch06:13027702-13029858","363","13027702","13029858","2156","1534.31159643","1.40519044829"
"SL2.50ch06:13035131-13036192","189","13035131","13036192","1061","1534.31159643","0.691515336564"
"SL2.50ch06:13037463-13040146","459","13037463","13040146","2683","1534.31159643","1.74866696324"
"SL2.50ch06:13042253-13043575","228","13042253","13043575","1322","1534.31159643","0.86162419881"
"SL2.50ch06:13045620-13046727","196","13045620","13046727","1107","1534.31159643","0.721496208837"
"SL2.50ch06:13422386-13423254","2164","13422386","13423254","868","1534.31159643","0.565726024634"
"SL2.50ch06:13424246-13425133","1495","13424246","13425133","887","1534.31159643","0.5781094284"
"SL2.50ch06:13424254-13425155","1487","13424254","13425155","901","1534.31159643","0.5872340417"
"SL2.50ch06:15863785-15864253","83","15863785","15864253","468","1534.31159643","0.305022787476"
"SL2.50ch06:16299554-16300320","150","16299554","16300320","766","1534.31159643","0.499246699159"
"SL2.50ch06:19442474-19442849","77","19442474","19442849","375","1534.31159643","0.244409284836"
"SL2.50ch06:19446373-19446886","95","19446373","19446886","513","1534.31159643","0.334351901656"
"SL2.50ch06:19472302-19473254","169","19472302","19473254","952","1534.31159643","0.620473704438"
"SL2.50ch06:19676262-19680566","894","19676262","19680566","4304","1534.31159643","2.80516683183"
"SL2.50ch06:19877103-19877664","98","19877103","19877664","561","1534.31159643","0.365636290115"
"SL2.50ch06:19933156-19934187","199","19933156","19934187","1031","1534.31159643","0.671962593777"
"SL2.50ch06:20126876-20127614","4685","20126876","20127614","738","1534.31159643","0.480997472558"
"SL2.50ch06:20128274-20129320","5849","20128274","20129320","1046","1534.31159643","0.68173896517"
"SL2.50ch06:20128282-20130263","19183","20128282","20130263","1981","1534.31159643","1.29113278203"
"SL2.50ch06:20129779-20130247","13323","20129779","20130247","468","1534.31159643","0.305022787476"
"SL2.50ch06:20515044-20515446","967","20515044","20515446","402","1534.31159643","0.262006753345"
"SL2.50ch06:20964815-20965283","98","20964815","20965283","468","1534.31159643","0.305022787476"
"SL2.50ch06:21340983-21341385","5186","21340983","21341385","402","1534.31159643","0.262006753345"
"SL2.50ch06:21340983-21341547","5207","21340983","21341547","564","1534.31159643","0.367591564394"
"SL2.50ch06:21522154-21523200","192","21522154","21523200","1046","1534.31159643","0.68173896517"
"SL2.50ch06:21771348-21772213","337","21771348","21772213","865","1534.31159643","0.563770750356"
"SL2.50ch06:21771458-21772091","322","21771458","21772091","633","1534.31159643","0.412562872804"
"SL2.50ch06:21888593-21889067","113","21888593","21889067","474","1534.31159643","0.308933336033"
"SL2.50ch06:22013353-22014090","203","22013353","22014090","737","1534.31159643","0.480345714465"
"SL2.50ch06:22674068-22674566","76","22674068","22674566","498","1534.31159643","0.324575530263"
"SL2.50ch06:24168328-24168968","2129","24168328","24168968","640","1534.31159643","0.417125179454"
"SL2.50ch06:24292005-24292708","134","24292005","24292708","703","1534.31159643","0.458185939307"
"SL2.50ch06:24536090-24536684","2195","24536090","24536684","594","1534.31159643","0.387144307181"
"SL2.50ch06:2523184-2523674","3130","2523184","2523674","490","1534.31159643","0.319361465519"
"SL2.50ch06:26056380-26056852","89","26056380","26056852","472","1534.31159643","0.307629819847"
"SL2.50ch06:26505820-26506408","133","26505820","26506408","588","1534.31159643","0.383233758623"
"SL2.50ch06:27182233-27182750","2015","27182233","27182750","517","1534.31159643","0.336958934028"
"SL2.50ch06:27219236-27219611","79","27219236","27219611","375","1534.31159643","0.244409284836"
"SL2.50ch06:27246387-27246762","77","27246387","27246762","375","1534.31159643","0.244409284836"
"SL2.50ch06:27367795-27368170","81","27367795","27368170","375","1534.31159643","0.244409284836"
"SL2.50ch06:27436796-27437198","389","27436796","27437198","402","1534.31159643","0.262006753345"
"SL2.50ch06:27475556-27478013","538","27475556","27478013","2457","1534.31159643","1.60136963425"
"SL2.50ch06:29196945-29199345","522","29196945","29199345","2400","1534.31159643","1.56421942295"
"SL2.50ch06:29609666-29610630","162","29609666","29610630","964","1534.31159643","0.628294801553"
"SL2.50ch06:30951127-30951502","151","30951127","30951502","375","1534.31159643","0.244409284836"
"SL2.50ch06:31135950-31136539","583","31135950","31136539","589","1534.31159643","0.383885516716"
"SL2.50ch06:31136046-31136550","576","31136046","31136550","504","1534.31159643","0.32848607882"
"SL2.50ch06:32398471-32399126","139","32398471","32399126","655","1534.31159643","0.426901550847"
"SL2.50ch06:32472746-32473580","248","32472746","32473580","834","1534.31159643","0.543566249476"
"SL2.50ch06:3332759-3333441","186","3332759","3333441","682","1534.31159643","0.444499019356"
"SL2.50ch06:33858415-33859055","512","33858415","33859055","640","1534.31159643","0.417125179454"
"SL2.50ch06:33858481-33858856","501","33858481","33858856","375","1534.31159643","0.244409284836"
"SL2.50ch06:3414131-3415346","351","3414131","3415346","1215","1534.31159643","0.79188608287"
"SL2.50ch06:3416275-3416978","201","3416275","3416978","703","1534.31159643","0.458185939307"
"SL2.50ch06:34189577-34189952","85","34189577","34189952","375","1534.31159643","0.244409284836"
"SL2.50ch06:3440582-3441174","124","3440582","3441174","592","1534.31159643","0.385840790995"
"SL2.50ch06:3447211-3449683","689","3447211","3449683","2472","1534.31159643","1.61114600564"
"SL2.50ch06:35232373-35232979","123","35232373","35232979","606","1534.31159643","0.394965404296"
"SL2.50ch06:35232454-35233130","127","35232454","35233130","676","1534.31159643","0.440588470798"
"SL2.50ch06:35841331-35842181","218","35841331","35842181","850","1534.31159643","0.553994378962"
"SL2.50ch06:35848126-35848934","143","35848126","35848934","808","1534.31159643","0.526620539061"
"SL2.50ch06:36593466-36594178","7460","36593466","36594178","712","1534.31159643","0.464051762143"
"SL2.50ch06:36593593-36594154","7457","36593593","36594154","561","1534.31159643","0.365636290115"
"SL2.50ch06:38692646-38693048","392","38692646","38693048","402","1534.31159643","0.262006753345"
"SL2.50ch06:3923921-3924746","165","3923921","3924746","825","1534.31159643","0.53770042664"
"SL2.50ch06:39340459-39340949","921","39340459","39340949","490","1534.31159643","0.319361465519"
"SL2.50ch06:39340474-39340972","923","39340474","39340972","498","1534.31159643","0.324575530263"
"SL2.50ch06:40138792-40139290","889","40138792","40139290","498","1534.31159643","0.324575530263"
"SL2.50ch06:40138835-40139354","895","40138835","40139354","519","1534.31159643","0.338262450213"
"SL2.50ch06:40454177-40455330","257","40454177","40455330","1153","1534.31159643","0.75147708111"
"SL2.50ch06:4241505-4241907","420","4241505","4241907","402","1534.31159643","0.262006753345"
"SL2.50ch06:42662776-42663530","9470","42662776","42663530","754","1534.31159643","0.491425602044"
"SL2.50ch06:42662920-42663448","9460","42662920","42663448","528","1534.31159643","0.34412827305"
"SL2.50ch06:4357240-4357783","3594","4357240","4357783","543","1534.31159643","0.353904644443"
"SL2.50ch06:44550669-44551657","173","44550669","44551657","988","1534.31159643","0.643936995782"
"SL2.50ch06:44655007-44655497","580","44655007","44655497","490","1534.31159643","0.319361465519"
"SL2.50ch06:44744098-44744642","9932","44744098","44744642","544","1534.31159643","0.354556402536"
"SL2.50ch06:44744152-44744620","9932","44744152","44744620","468","1534.31159643","0.305022787476"
"SL2.50ch06:46138783-46140500","1854","46138783","46140500","1717","1534.31159643","1.1190686455"
"SL2.50ch06:46139900-46140419","1434","46139900","46140419","519","1534.31159643","0.338262450213"
"SL2.50ch06:46145260-46148713","33255","46145260","46148713","3453","1534.31159643","2.25052069477"
"SL2.50ch06:46145263-46148659","33255","46145263","46148659","3396","1534.31159643","2.21337048348"
"SL2.50ch06:47239582-47239984","665","47239582","47239984","402","1534.31159643","0.262006753345"
"SL2.50ch06:47293410-47294104","3571","47293410","47294104","694","1534.31159643","0.45232011647"
"SL2.50ch06:47293568-47294058","3566","47293568","47294058","490","1534.31159643","0.319361465519"
"SL2.50ch06:49737655-49738607","330","49737655","49738607","952","1534.31159643","0.620473704438"
"SL2.50ch06:5020160-5021283","204","5020160","5021283","1123","1534.31159643","0.731924338323"
"SL2.50ch06:5039987-5040769","198","5039987","5040769","782","1534.31159643","0.509674828645"
"SL2.50ch06:5041583-5042558","162","5041583","5042558","975","1534.31159643","0.635464140574"
"SL2.50ch06:5043143-5045374","447","5043143","5045374","2231","1534.31159643","1.45407230525"
"SL2.50ch06:5047687-5048863","220","5047687","5048863","1176","1534.31159643","0.766467517247"
"SL2.50ch06:5059484-5060242","136","5059484","5060242","758","1534.31159643","0.494032634416"
"SL2.50ch06:5075343-5076357","216","5075343","5076357","1014","1534.31159643","0.660882706197"
"SL2.50ch06:5118428-5118960","94","5118428","5118960","532","1534.31159643","0.346735305421"
"SL2.50ch06:5261752-5262254","372","5261752","5262254","502","1534.31159643","0.327182562634"
"SL2.50ch06:5300730-5301297","336","5300730","5301297","567","1534.31159643","0.369546838673"
"SL2.50ch06:5300818-5301220","329","5300818","5301220","402","1534.31159643","0.262006753345"
"SL2.50ch06:5452603-5453175","123","5452603","5453175","572","1534.31159643","0.372805629137"
"SL2.50ch06:5534297-5535698","864","5534297","5535698","1401","1534.31159643","0.913113088149"
"SL2.50ch06:5535212-5535614","652","5535212","5535614","402","1534.31159643","0.262006753345"
"SL2.50ch06:5745929-5747291","211","5745929","5747291","1362","1534.31159643","0.887694522526"
"SL2.50ch06:5771150-5772119","229","5771150","5772119","969","1534.31159643","0.631553592017"
"SL2.50ch06:5772988-5773457","119","5772988","5773457","469","1534.31159643","0.305674545569"
"SL2.50ch06:6317096-6317682","106","6317096","6317682","586","1534.31159643","0.381930242438"
"SL2.50ch06:6377893-6378409","101","6377893","6378409","516","1534.31159643","0.336307175935"
"SL2.50ch06:6389691-6390201","1595","6389691","6390201","510","1534.31159643","0.332396627377"
"SL2.50ch06:7153407-7154126","144","7153407","7154126","719","1534.31159643","0.468614068793"
"SL2.50ch06:7235782-7236157","78","7235782","7236157","375","1534.31159643","0.244409284836"
"SL2.50ch06:7609794-7610284","440","7609794","7610284","490","1534.31159643","0.319361465519"
"SL2.50ch06:7753223-7754056","156","7753223","7754056","833","1534.31159643","0.542914491383"
"SL2.50ch06:8413666-8414041","68","8413666","8414041","375","1534.31159643","0.244409284836"
"SL2.50ch06:8559912-8561917","362","8559912","8561917","2005","1534.31159643","1.30677497626"
"SL2.50ch06:8595972-8597144","203","8595972","8597144","1172","1534.31159643","0.763860484875"
"SL2.50ch07:10330984-10331487","91","10330984","10331487","503","1534.31159643","0.327834320727"
"SL2.50ch07:10484574-10485384","1041","10484574","10485384","810","1534.31159643","0.527924055246"
"SL2.50ch07:10484695-10485407","1013","10484695","10485407","712","1534.31159643","0.464051762143"
"SL2.50ch07:10490115-10490850","4911","10490115","10490850","735","1534.31159643","0.479042198279"
"SL2.50ch07:10490242-10490872","4904","10490242","10490872","630","1534.31159643","0.410607598525"
"SL2.50ch07:11359676-11360051","79","11359676","11360051","375","1534.31159643","0.244409284836"
"SL2.50ch07:11631133-11631734","251","11631133","11631734","601","1534.31159643","0.391706613831"
"SL2.50ch07:11633188-11633660","102","11633188","11633660","472","1534.31159643","0.307629819847"
"SL2.50ch07:11852425-11856905","5005","11852425","11856905","4480","1534.31159643","2.91987625618"
"SL2.50ch07:11854649-11856819","3632","11854649","11856819","2170","1534.31159643","1.41431506159"
"SL2.50ch07:12791877-12792490","186","12791877","12792490","613","1534.31159643","0.399527710946"
"SL2.50ch07:12855807-12856325","102","12855807","12856325","518","1534.31159643","0.337610692121"
"SL2.50ch07:13215968-13216343","78","13215968","13216343","375","1534.31159643","0.244409284836"
"SL2.50ch07:13510775-13511856","218","13510775","13511856","1081","1534.31159643","0.704550498422"
"SL2.50ch07:13703611-13704084","83","13703611","13704084","473","1534.31159643","0.30828157794"
"SL2.50ch07:14478817-14479429","118","14478817","14479429","612","1534.31159643","0.398875952853"
"SL2.50ch07:14670431-14670952","86","14670431","14670952","521","1534.31159643","0.339565966399"
"SL2.50ch07:14879251-14880856","320","14879251","14880856","1605","1534.31159643","1.0460717391"
"SL2.50ch07:15207359-15207939","157","15207359","15207939","580","1534.31159643","0.37801969388"
"SL2.50ch07:15364684-15365534","183","15364684","15365534","850","1534.31159643","0.553994378962"
"SL2.50ch07:15509086-15509461","80","15509086","15509461","375","1534.31159643","0.244409284836"
"SL2.50ch07:16223192-16226558","742","16223192","16226558","3366","1534.31159643","2.19381774069"
"SL2.50ch07:16793730-16795427","466","16793730","16795427","1697","1534.31159643","1.10603348365"
"SL2.50ch07:17357581-17358076","92","17357581","17358076","495","1534.31159643","0.322620255984"
"SL2.50ch07:18155913-18156854","251","18155913","18156854","941","1534.31159643","0.613304365416"
"SL2.50ch07:18155996-18156486","169","18155996","18156486","490","1534.31159643","0.319361465519"
"SL2.50ch07:18257099-18259691","458","18257099","18259691","2592","1534.31159643","1.68935697679"
"SL2.50ch07:18723447-18723990","117","18723447","18723990","543","1534.31159643","0.353904644443"
"SL2.50ch07:19363002-19363653","138","19363002","19363653","651","1534.31159643","0.424294518476"
"SL2.50ch07:19794728-19795857","262","19794728","19795857","1129","1534.31159643","0.735834886881"
"SL2.50ch07:19803738-19805595","353","19803738","19805595","1857","1534.31159643","1.21031477851"
"SL2.50ch07:19807330-19812504","1153","19807330","19812504","5174","1534.31159643","3.37219637265"
"SL2.50ch07:19831167-19835424","867","19831167","19835424","4257","1534.31159643","2.77453420146"
"SL2.50ch07:19838534-19839278","159","19838534","19839278","744","1534.31159643","0.484908021115"
"SL2.50ch07:19842461-19843414","213","19842461","19843414","953","1534.31159643","0.621125462531"
"SL2.50ch07:19847505-19849329","396","19847505","19849329","1824","1534.31159643","1.18880676144"
"SL2.50ch07:19862863-19866371","760","19862863","19866371","3508","1534.31159643","2.28636738988"
"SL2.50ch07:19871390-19873872","509","19871390","19873872","2482","1534.31159643","1.61766358657"
"SL2.50ch07:19880668-19881287","150","19880668","19881287","619","1534.31159643","0.403438259503"
"SL2.50ch07:19882133-19882812","183","19882133","19882812","679","1534.31159643","0.442543745077"
"SL2.50ch07:19882213-19882882","198","19882213","19882882","669","1534.31159643","0.436026164148"
"SL2.50ch07:19886196-19887691","398","19886196","19887691","1495","1534.31159643","0.974378348881"
"SL2.50ch07:19950395-19950978","114","19950395","19950978","583","1534.31159643","0.379974968159"
"SL2.50ch07:19983938-19984833","253","19983938","19984833","895","1534.31159643","0.583323493143"
"SL2.50ch07:20362429-20362966","99","20362429","20362966","537","1534.31159643","0.349994095886"
"SL2.50ch07:20482154-20482529","90","20482154","20482529","375","1534.31159643","0.244409284836"
"SL2.50ch07:20862124-20862962","150","20862124","20862962","838","1534.31159643","0.546173281848"
"SL2.50ch07:21109522-21110259","138","21109522","21110259","737","1534.31159643","0.480345714465"
"SL2.50ch07:21158805-21159733","164","21158805","21159733","928","1534.31159643","0.604831510208"
"SL2.50ch07:22267574-22267949","81","22267574","22267949","375","1534.31159643","0.244409284836"
"SL2.50ch07:23178828-23179371","132","23178828","23179371","543","1534.31159643","0.353904644443"
"SL2.50ch07:23705203-23705721","97","23705203","23705721","518","1534.31159643","0.337610692121"
"SL2.50ch07:23731754-23732129","66","23731754","23732129","375","1534.31159643","0.244409284836"
"SL2.50ch07:24165265-24165640","75","24165265","24165640","375","1534.31159643","0.244409284836"
"SL2.50ch07:24197521-24197896","80","24197521","24197896","375","1534.31159643","0.244409284836"
"SL2.50ch07:24678668-24679043","64","24678668","24679043","375","1534.31159643","0.244409284836"
"SL2.50ch07:24747101-24747570","104","24747101","24747570","469","1534.31159643","0.305674545569"
"SL2.50ch07:25085594-25085969","78","25085594","25085969","375","1534.31159643","0.244409284836"
"SL2.50ch07:25270007-25270603","123","25270007","25270603","596","1534.31159643","0.388447823367"
"SL2.50ch07:25828749-25829260","100","25828749","25829260","511","1534.31159643","0.33304838547"
"SL2.50ch07:26467698-26468166","179","26467698","26468166","468","1534.31159643","0.305022787476"
"SL2.50ch07:27088118-27088667","97","27088118","27088667","549","1534.31159643","0.357815193"
"SL2.50ch07:27171286-27171661","65","27171286","27171661","375","1534.31159643","0.244409284836"
"SL2.50ch07:27291139-27291786","222","27291139","27291786","647","1534.31159643","0.421687486104"
"SL2.50ch07:27291165-27291868","220","27291165","27291868","703","1534.31159643","0.458185939307"
"SL2.50ch07:28302934-28303544","10181","28302934","28303544","610","1534.31159643","0.397572436667"
"SL2.50ch07:28303049-28303517","10171","28303049","28303517","468","1534.31159643","0.305022787476"
"SL2.50ch07:29209638-29210040","1245","29209638","29210040","402","1534.31159643","0.262006753345"
"SL2.50ch07:29426734-29427203","100","29426734","29427203","469","1534.31159643","0.305674545569"
"SL2.50ch07:29887449-29887958","86","29887449","29887958","509","1534.31159643","0.331744869285"
"SL2.50ch07:29919954-29920437","83","29919954","29920437","483","1534.31159643","0.314799158869"
"SL2.50ch07:2999403-3000995","581","2999403","3000995","1592","1534.31159643","1.03759888389"
"SL2.50ch07:2999672-3000302","363","2999672","3000302","630","1534.31159643","0.410607598525"
"SL2.50ch07:30150602-30151092","2016","30150602","30151092","490","1534.31159643","0.319361465519"
"SL2.50ch07:30175177-30175660","90","30175177","30175660","483","1534.31159643","0.314799158869"
"SL2.50ch07:30902000-30903467","870","30902000","30903467","1467","1534.31159643","0.95612912228"
"SL2.50ch07:30902001-30903455","870","30902001","30903455","1454","1534.31159643","0.947656267072"
"SL2.50ch07:30904019-30904523","242","30904019","30904523","504","1534.31159643","0.32848607882"
"SL2.50ch07:30904026-30904590","243","30904026","30904590","564","1534.31159643","0.367591564394"
"SL2.50ch07:30906020-30906631","1401","30906020","30906631","611","1534.31159643","0.39822419476"
"SL2.50ch07:3184708-3185110","1530","3184708","3185110","402","1534.31159643","0.262006753345"
"SL2.50ch07:32432796-32433583","5441","32432796","32433583","787","1534.31159643","0.51293361911"
"SL2.50ch07:32432891-32433453","5422","32432891","32433453","562","1534.31159643","0.366288048208"
"SL2.50ch07:3372-4110","1011","3372","4110","738","1534.31159643","0.480997472558"
"SL2.50ch07:34209928-34210528","134","34209928","34210528","600","1534.31159643","0.391054855738"
"SL2.50ch07:34439127-34439673","100","34439127","34439673","546","1534.31159643","0.355859918722"
"SL2.50ch07:34595240-34595615","80","34595240","34595615","375","1534.31159643","0.244409284836"
"SL2.50ch07:34915326-34915920","120","34915326","34915920","594","1534.31159643","0.387144307181"
"SL2.50ch07:35058834-35059437","134","35058834","35059437","603","1534.31159643","0.393010130017"
"SL2.50ch07:36068592-36069317","345","36068592","36069317","725","1534.31159643","0.47252461735"
"SL2.50ch07:37273451-37273949","120","37273451","37273949","498","1534.31159643","0.324575530263"
"SL2.50ch07:3774743-3776382","430","3774743","3776382","1639","1534.31159643","1.06823151426"
"SL2.50ch07:38058364-38058833","84","38058364","38058833","469","1534.31159643","0.305674545569"
"SL2.50ch07:38160847-38161662","192","38160847","38161662","815","1534.31159643","0.531182845711"
"SL2.50ch07:38212908-38213396","94","38212908","38213396","488","1534.31159643","0.318057949334"
"SL2.50ch07:4007281-4008058","1193","4007281","4008058","777","1534.31159643","0.506416038181"
"SL2.50ch07:4007379-4008043","1185","4007379","4008043","664","1534.31159643","0.432767373684"
"SL2.50ch07:40130551-40130926","95","40130551","40130926","375","1534.31159643","0.244409284836"
"SL2.50ch07:40168529-40169090","172","40168529","40169090","561","1534.31159643","0.365636290115"
"SL2.50ch07:40295479-40296056","115","40295479","40296056","577","1534.31159643","0.376064419601"
"SL2.50ch07:41249675-41250932","224","41249675","41250932","1257","1534.31159643","0.819259922771"
"SL2.50ch07:41360345-41360720","76","41360345","41360720","375","1534.31159643","0.244409284836"
"SL2.50ch07:44009853-44010353","94","44009853","44010353","500","1534.31159643","0.325879046448"
"SL2.50ch07:44373038-44373861","209","44373038","44373861","823","1534.31159643","0.536396910454"
"SL2.50ch07:44663230-44663705","92","44663230","44663705","475","1534.31159643","0.309585094126"
"SL2.50ch07:45274098-45275110","206","45274098","45275110","1012","1534.31159643","0.659579190012"
"SL2.50ch07:45482513-45482888","68","45482513","45482888","375","1534.31159643","0.244409284836"
"SL2.50ch07:46279404-46280757","228","46279404","46280757","1353","1534.31159643","0.881828699689"
"SL2.50ch07:4794178-4794650","106","4794178","4794650","472","1534.31159643","0.307629819847"
"SL2.50ch07:48383329-48383933","124","48383329","48383933","604","1534.31159643","0.39366188811"
"SL2.50ch07:48899122-48899639","99","48899122","48899639","517","1534.31159643","0.336958934028"
"SL2.50ch07:49605353-49605728","76","49605353","49605728","375","1534.31159643","0.244409284836"
"SL2.50ch07:50218720-50219647","329","50218720","50219647","927","1534.31159643","0.604179752115"
"SL2.50ch07:50218764-50219166","253","50218764","50219166","402","1534.31159643","0.262006753345"
"SL2.50ch07:50387754-50388861","251","50387754","50388861","1107","1534.31159643","0.721496208837"
"SL2.50ch07:50623523-50623994","148","50623523","50623994","471","1534.31159643","0.306978061754"
"SL2.50ch07:51235860-51236437","2334","51235860","51236437","577","1534.31159643","0.376064419601"
"SL2.50ch07:52229731-52230258","509","52229731","52230258","527","1534.31159643","0.343476514957"
"SL2.50ch07:52294483-52295151","137","52294483","52295151","668","1534.31159643","0.435374406055"
"SL2.50ch07:52522616-52524449","330","52522616","52524449","1833","1534.31159643","1.19467258428"
"SL2.50ch07:53599442-53600287","187","53599442","53600287","845","1534.31159643","0.550735588498"
"SL2.50ch07:53965457-53966247","170","53965457","53966247","790","1534.31159643","0.514888893389"
"SL2.50ch07:53975469-53975871","1450","53975469","53975871","402","1534.31159643","0.262006753345"
"SL2.50ch07:5413089-5413754","142","5413089","5413754","665","1534.31159643","0.433419131776"
"SL2.50ch07:5413298-5414032","154","5413298","5414032","734","1534.31159643","0.478390440186"
"SL2.50ch07:5449682-5452325","716","5449682","5452325","2643","1534.31159643","1.72259663953"
"SL2.50ch07:54736705-54737343","863","54736705","54737343","638","1534.31159643","0.415821663268"
"SL2.50ch07:54736841-54737354","854","54736841","54737354","513","1534.31159643","0.334351901656"
"SL2.50ch07:55282802-55283204","714","55282802","55283204","402","1534.31159643","0.262006753345"
"SL2.50ch07:55623508-55624399","145","55623508","55624399","891","1534.31159643","0.580716460771"
"SL2.50ch07:55632576-55633447","262","55632576","55633447","871","1534.31159643","0.567681298913"
"SL2.50ch07:55632801-55633422","227","55632801","55633422","621","1534.31159643","0.404741775689"
"SL2.50ch07:5584399-5585220","209","5584399","5585220","821","1534.31159643","0.535093394268"
"SL2.50ch07:5586890-5587265","80","5586890","5587265","375","1534.31159643","0.244409284836"
"SL2.50ch07:56754891-56755463","179","56754891","56755463","572","1534.31159643","0.372805629137"
"SL2.50ch07:56757127-56757897","222","56757127","56757897","770","1534.31159643","0.501853731531"
"SL2.50ch07:57398872-57400681","345","57398872","57400681","1809","1534.31159643","1.17903039005"
"SL2.50ch07:57403887-57404531","125","57403887","57404531","644","1534.31159643","0.419732211826"
"SL2.50ch07:57406693-57407290","142","57406693","57407290","597","1534.31159643","0.389099581459"
"SL2.50ch07:57409285-57410276","205","57409285","57410276","991","1534.31159643","0.645892270061"
"SL2.50ch07:58301086-58301688","563","58301086","58301688","602","1534.31159643","0.392358371924"
"SL2.50ch07:58802352-58805143","705","58802352","58805143","2791","1534.31159643","1.81905683728"
"SL2.50ch07:59388843-59389425","766","59388843","59389425","582","1534.31159643","0.379323210066"
"SL2.50ch07:59388935-59389477","762","59388935","59389477","542","1534.31159643","0.35325288635"
"SL2.50ch07:59506934-59507820","12229","59506934","59507820","886","1534.31159643","0.577457670307"
"SL2.50ch07:59506991-59507646","12180","59506991","59507646","655","1534.31159643","0.426901550847"
"SL2.50ch07:61301593-61302247","911","61301593","61302247","654","1534.31159643","0.426249792755"
"SL2.50ch07:61301649-61302327","911","61301649","61302327","678","1534.31159643","0.441891986984"
"SL2.50ch07:61414731-61415106","78","61414731","61415106","375","1534.31159643","0.244409284836"
"SL2.50ch07:63553939-63554314","69","63553939","63554314","375","1534.31159643","0.244409284836"
"SL2.50ch07:63554982-63555460","112","63554982","63555460","478","1534.31159643","0.311540368405"
"SL2.50ch07:64790120-64790495","122","64790120","64790495","375","1534.31159643","0.244409284836"
"SL2.50ch07:65397005-65397380","152","65397005","65397380","375","1534.31159643","0.244409284836"
"SL2.50ch07:65784663-65785153","671","65784663","65785153","490","1534.31159643","0.319361465519"
"SL2.50ch07:7832025-7832533","873","7832025","7832533","508","1534.31159643","0.331093111192"
"SL2.50ch07:8195959-8196334","75","8195959","8196334","375","1534.31159643","0.244409284836"
"SL2.50ch07:8824605-8825074","170","8824605","8825074","469","1534.31159643","0.305674545569"
"SL2.50ch07:90612-91248","110","90612","91248","636","1534.31159643","0.414518147082"
"SL2.50ch07:9403987-9405063","174","9403987","9405063","1076","1534.31159643","0.701291707957"
"SL2.50ch08:10002631-10004774","959","10002631","10004774","2143","1534.31159643","1.39671759308"
"SL2.50ch08:10002767-10004772","927","10002767","10004772","2005","1534.31159643","1.30677497626"
"SL2.50ch08:10005552-10006837","511","10005552","10006837","1285","1534.31159643","0.837509149372"
"SL2.50ch08:10005569-10006879","505","10005569","10006879","1310","1534.31159643","0.853803101695"
"SL2.50ch08:10011819-10013442","1045","10011819","10013442","1623","1534.31159643","1.05780338477"
"SL2.50ch08:10011842-10013449","1045","10011842","10013449","1607","1534.31159643","1.04737525529"
"SL2.50ch08:10015683-10017918","1522","10015683","10017918","2235","1534.31159643","1.45667933762"
"SL2.50ch08:10015792-10017881","1518","10015792","10017881","2089","1534.31159643","1.36152265606"
"SL2.50ch08:10024206-10028238","2759","10024206","10028238","4032","1534.31159643","2.62788863056"
"SL2.50ch08:10024259-10028312","2758","10024259","10028312","4053","1534.31159643","2.64157555051"
"SL2.50ch08:10030614-10031938","485","10030614","10031938","1324","1534.31159643","0.862927714995"
"SL2.50ch08:10030648-10031833","485","10030648","10031833","1185","1534.31159643","0.772333340083"
"SL2.50ch08:10032530-10036482","1651","10032530","10036482","3952","1534.31159643","2.57574798313"
"SL2.50ch08:10032595-10036544","1647","10032595","10036544","3949","1534.31159643","2.57379270885"
"SL2.50ch08:10429512-10430017","107","10429512","10430017","505","1534.31159643","0.329137836913"
"SL2.50ch08:10434313-10437377","588","10434313","10437377","3064","1534.31159643","1.99698679664"
"SL2.50ch08:10445852-10446438","101","10445852","10446438","586","1534.31159643","0.381930242438"
"SL2.50ch08:10563767-10564351","132","10563767","10564351","584","1534.31159643","0.380626726252"
"SL2.50ch08:10821212-10821897","238","10821212","10821897","685","1534.31159643","0.446454293634"
"SL2.50ch08:10888393-10890109","380","10888393","10890109","1716","1534.31159643","1.11841688741"
"SL2.50ch08:11082829-11083405","852","11082829","11083405","576","1534.31159643","0.375412661509"
"SL2.50ch08:11082930-11083400","841","11082930","11083400","470","1534.31159643","0.306326303662"
"SL2.50ch08:11130632-11131379","1479","11130632","11131379","747","1534.31159643","0.486863295394"
"SL2.50ch08:11137848-11141424","24015","11137848","11141424","3576","1534.31159643","2.3306869402"
"SL2.50ch08:11138082-11141260","23976","11138082","11141260","3178","1534.31159643","2.07128721923"
"SL2.50ch08:11147837-11149023","1813","11147837","11149023","1186","1534.31159643","0.772985098176"
"SL2.50ch08:11147964-11148936","1783","11147964","11148936","972","1534.31159643","0.633508866296"
"SL2.50ch08:11732669-11733512","1071","11732669","11733512","843","1534.31159643","0.549432072312"
"SL2.50ch08:11732728-11733548","1071","11732728","11733548","820","1534.31159643","0.534441636175"
"SL2.50ch08:11880892-11881676","259","11880892","11881676","784","1534.31159643","0.510978344831"
"SL2.50ch08:12271948-12272456","98","12271948","12272456","508","1534.31159643","0.331093111192"
"SL2.50ch08:13446739-13447472","169","13446739","13447472","733","1534.31159643","0.477738682093"
"SL2.50ch08:14138174-14139779","263","14138174","14139779","1605","1534.31159643","1.0460717391"
"SL2.50ch08:14423080-14423455","81","14423080","14423455","375","1534.31159643","0.244409284836"
"SL2.50ch08:14782409-14783639","243","14782409","14783639","1230","1534.31159643","0.801662454263"
"SL2.50ch08:14849153-14849922","144","14849153","14849922","769","1534.31159643","0.501201973438"
"SL2.50ch08:14906344-14906719","84","14906344","14906719","375","1534.31159643","0.244409284836"
"SL2.50ch08:14929397-14930627","201","14929397","14930627","1230","1534.31159643","0.801662454263"
"SL2.50ch08:14939719-14940094","73","14939719","14940094","375","1534.31159643","0.244409284836"
"SL2.50ch08:14999361-15000850","1513","14999361","15000850","1489","1534.31159643","0.970467800323"
"SL2.50ch08:14999814-15000611","1409","14999814","15000611","797","1534.31159643","0.519451200039"
"SL2.50ch08:15012585-15015861","569","15012585","15015861","3276","1534.31159643","2.13515951233"
"SL2.50ch08:15167719-15168629","924","15167719","15168629","910","1534.31159643","0.593099864536"
"SL2.50ch08:15167816-15168423","910","15167816","15168423","607","1534.31159643","0.395617162388"
"SL2.50ch08:15513770-15514768","302","15513770","15514768","998","1534.31159643","0.650454576711"
"SL2.50ch08:15513785-15514624","284","15513785","15514624","839","1534.31159643","0.54682503994"
"SL2.50ch08:15515434-15516356","349","15515434","15516356","922","1534.31159643","0.600920961651"
"SL2.50ch08:15515493-15516330","346","15515493","15516330","837","1534.31159643","0.545521523755"
"SL2.50ch08:15517553-15518021","174","15517553","15518021","468","1534.31159643","0.305022787476"
"SL2.50ch08:15547353-15547924","185","15547353","15547924","571","1534.31159643","0.372153871044"
"SL2.50ch08:15555027-15555495","204","15555027","15555495","468","1534.31159643","0.305022787476"
"SL2.50ch08:15556231-15557378","311","15556231","15557378","1147","1534.31159643","0.747566532553"
"SL2.50ch08:15556257-15557433","309","15556257","15557433","1176","1534.31159643","0.766467517247"
"SL2.50ch08:15570741-15571524","158","15570741","15571524","783","1534.31159643","0.510326586738"
"SL2.50ch08:15612648-15613407","183","15612648","15613407","759","1534.31159643","0.494684392509"
"SL2.50ch08:15838909-15839311","451","15838909","15839311","402","1534.31159643","0.262006753345"
"SL2.50ch08:15840182-15840584","560","15840182","15840584","402","1534.31159643","0.262006753345"
"SL2.50ch08:15840200-15840698","568","15840200","15840698","498","1534.31159643","0.324575530263"
"SL2.50ch08:15842238-15842811","376","15842238","15842811","573","1534.31159643","0.37345738723"
"SL2.50ch08:15842263-15842784","366","15842263","15842784","521","1534.31159643","0.339565966399"
"SL2.50ch08:15843673-15844141","299","15843673","15844141","468","1534.31159643","0.305022787476"
"SL2.50ch08:15843676-15844078","296","15843676","15844078","402","1534.31159643","0.262006753345"
"SL2.50ch08:15847478-15847880","311","15847478","15847880","402","1534.31159643","0.262006753345"
"SL2.50ch08:16026314-16027981","1038","16026314","16027981","1667","1534.31159643","1.08648074086"
"SL2.50ch08:16027161-16027932","930","16027161","16027932","771","1534.31159643","0.502505489623"
"SL2.50ch08:16031684-16032194","721","16031684","16032194","510","1534.31159643","0.332396627377"
"SL2.50ch08:16184608-16185513","168","16184608","16185513","905","1534.31159643","0.589841074072"
"SL2.50ch08:16330791-16331166","72","16330791","16331166","375","1534.31159643","0.244409284836"
"SL2.50ch08:18438018-18438486","401","18438018","18438486","468","1534.31159643","0.305022787476"
"SL2.50ch08:18882883-18883258","82","18882883","18883258","375","1534.31159643","0.244409284836"
"SL2.50ch08:20831258-20831944","132","20831258","20831944","686","1534.31159643","0.447106051727"
"SL2.50ch08:21993489-21994553","231","21993489","21994553","1064","1534.31159643","0.693470610842"
"SL2.50ch08:22048713-22049654","164","22048713","22049654","941","1534.31159643","0.613304365416"
"SL2.50ch08:22057628-22059113","246","22057628","22059113","1485","1534.31159643","0.967860767952"
"SL2.50ch08:22106435-22107140","137","22106435","22107140","705","1534.31159643","0.459489455492"
"SL2.50ch08:22110937-22112032","281","22110937","22112032","1095","1534.31159643","0.713675111722"
"SL2.50ch08:22754166-22754762","113","22754166","22754762","596","1534.31159643","0.388447823367"
"SL2.50ch08:23194922-23195394","102","23194922","23195394","472","1534.31159643","0.307629819847"
"SL2.50ch08:24008165-24008906","164","24008165","24008906","741","1534.31159643","0.482952746837"
"SL2.50ch08:25319895-25320574","148","25319895","25320574","679","1534.31159643","0.442543745077"
"SL2.50ch08:25335907-25336309","275","25335907","25336309","402","1534.31159643","0.262006753345"
"SL2.50ch08:25881646-25882394","171","25881646","25882394","748","1534.31159643","0.487515053487"
"SL2.50ch08:26152852-26153326","112","26152852","26153326","474","1534.31159643","0.308933336033"
"SL2.50ch08:2620366-2620768","412","2620366","2620768","402","1534.31159643","0.262006753345"
"SL2.50ch08:2620392-2620767","412","2620392","2620767","375","1534.31159643","0.244409284836"
"SL2.50ch08:26693003-26693746","281","26693003","26693746","743","1534.31159643","0.484256263022"
"SL2.50ch08:26922990-26923365","82","26922990","26923365","375","1534.31159643","0.244409284836"
"SL2.50ch08:27633040-27633813","16919","27633040","27633813","773","1534.31159643","0.503809005809"
"SL2.50ch08:27633124-27633828","16911","27633124","27633828","704","1534.31159643","0.458837697399"
"SL2.50ch08:28973967-28974989","225","28973967","28974989","1022","1534.31159643","0.666096770941"
"SL2.50ch08:29032708-29033083","71","29032708","29033083","375","1534.31159643","0.244409284836"
"SL2.50ch08:29725656-29726031","81","29725656","29726031","375","1534.31159643","0.244409284836"
"SL2.50ch08:29731350-29731725","83","29731350","29731725","375","1534.31159643","0.244409284836"
"SL2.50ch08:29735774-29736548","198","29735774","29736548","774","1534.31159643","0.504460763902"
"SL2.50ch08:29769736-29770224","96","29769736","29770224","488","1534.31159643","0.318057949334"
"SL2.50ch08:30721854-30722229","89","30721854","30722229","375","1534.31159643","0.244409284836"
"SL2.50ch08:31765783-31766601","7892","31765783","31766601","818","1534.31159643","0.53313811999"
"SL2.50ch08:32308823-32309711","229","32308823","32309711","888","1534.31159643","0.578761186492"
"SL2.50ch08:32821717-32822280","1074","32821717","32822280","563","1534.31159643","0.366939806301"
"SL2.50ch08:32821729-32822351","1076","32821729","32822351","622","1534.31159643","0.405393533782"
"SL2.50ch08:33532582-33533633","239","33532582","33533633","1051","1534.31159643","0.684997755635"
"SL2.50ch08:33539540-33540141","118","33539540","33540141","601","1534.31159643","0.391706613831"
"SL2.50ch08:33559933-33561952","389","33559933","33561952","2019","1534.31159643","1.31589958956"
"SL2.50ch08:33791999-33792945","167","33791999","33792945","946","1534.31159643","0.61656315588"
"SL2.50ch08:33847277-33847952","126","33847277","33847952","675","1534.31159643","0.439936712705"
"SL2.50ch08:33973640-33974015","75","33973640","33974015","375","1534.31159643","0.244409284836"
"SL2.50ch08:34038094-34038610","115","34038094","34038610","516","1534.31159643","0.336307175935"
"SL2.50ch08:34452829-34453204","74","34452829","34453204","375","1534.31159643","0.244409284836"
"SL2.50ch08:36254055-36254523","87","36254055","36254523","468","1534.31159643","0.305022787476"
"SL2.50ch08:36327095-36327819","159","36327095","36327819","724","1534.31159643","0.471872859257"
"SL2.50ch08:37202792-37203633","797","37202792","37203633","841","1534.31159643","0.548128556126"
"SL2.50ch08:37202826-37204271","891","37202826","37204271","1445","1534.31159643","0.941790444236"
"SL2.50ch08:37207199-37208138","205","37207199","37208138","939","1534.31159643","0.61200084923"
"SL2.50ch08:37401945-37402449","1824","37401945","37402449","504","1534.31159643","0.32848607882"
"SL2.50ch08:38677612-38678102","1465","38677612","38678102","490","1534.31159643","0.319361465519"
"SL2.50ch08:39144765-39154049","46646","39144765","39154049","9284","1534.31159643","6.05092213445"
"SL2.50ch08:39144970-39146391","5007","39144970","39146391","1421","1534.31159643","0.926148250006"
"SL2.50ch08:39146800-39147758","5679","39146800","39147758","958","1534.31159643","0.624384252995"
"SL2.50ch08:39148615-39150867","23981","39148615","39150867","2252","1534.31159643","1.4677592252"
"SL2.50ch08:39151290-39153967","11567","39151290","39153967","2677","1534.31159643","1.74475641468"
"SL2.50ch08:39461737-39462112","72","39461737","39462112","375","1534.31159643","0.244409284836"
"SL2.50ch08:40119573-40120194","123","40119573","40120194","621","1534.31159643","0.404741775689"
"SL2.50ch08:40507516-40507891","86","40507516","40507891","375","1534.31159643","0.244409284836"
"SL2.50ch08:40624439-40624918","100","40624439","40624918","479","1534.31159643","0.312192126498"
"SL2.50ch08:40631090-40631465","72","40631090","40631465","375","1534.31159643","0.244409284836"
"SL2.50ch08:40632968-40633569","129","40632968","40633569","601","1534.31159643","0.391706613831"
"SL2.50ch08:41075319-41076236","269","41075319","41076236","917","1534.31159643","0.597662171186"
"SL2.50ch08:41315057-41315579","108","41315057","41315579","522","1534.31159643","0.340217724492"
"SL2.50ch08:41619053-41619543","63","41619053","41619543","490","1534.31159643","0.319361465519"
"SL2.50ch08:42177146-42177627","226","42177146","42177627","481","1534.31159643","0.313495642683"
"SL2.50ch08:4256808-4257458","115","4256808","4257458","650","1534.31159643","0.423642760383"
"SL2.50ch08:4393981-4394383","1204","4393981","4394383","402","1534.31159643","0.262006753345"
"SL2.50ch08:44328114-44328997","172","44328114","44328997","883","1534.31159643","0.575502396028"
"SL2.50ch08:44809859-44810351","90","44809859","44810351","492","1534.31159643","0.320664981705"
"SL2.50ch08:46708959-46710564","1428","46708959","46710564","1605","1534.31159643","1.0460717391"
"SL2.50ch08:46709679-46710490","1320","46709679","46710490","811","1534.31159643","0.528575813339"
"SL2.50ch08:46782997-46783372","71","46782997","46783372","375","1534.31159643","0.244409284836"
"SL2.50ch08:46873921-46876100","337","46873921","46876100","2179","1534.31159643","1.42018088442"
"SL2.50ch08:46950792-46951507","158","46950792","46951507","715","1534.31159643","0.466007036421"
"SL2.50ch08:46953229-46956365","63502","46953229","46956365","3136","1534.31159643","2.04391337932"
"SL2.50ch08:46953330-46956047","63417","46953330","46956047","2717","1534.31159643","1.7708267384"
"SL2.50ch08:48239737-48240989","1515","48239737","48240989","1252","1534.31159643","0.816001132307"
"SL2.50ch08:48239856-48240807","1475","48239856","48240807","951","1534.31159643","0.619821946345"
"SL2.50ch08:48578587-48579189","139","48578587","48579189","602","1534.31159643","0.392358371924"
"SL2.50ch08:50477166-50478169","223","50477166","50478169","1003","1534.31159643","0.653713367176"
"SL2.50ch08:51015740-51016115","94","51015740","51016115","375","1534.31159643","0.244409284836"
"SL2.50ch08:51242868-51243343","103","51242868","51243343","475","1534.31159643","0.309585094126"
"SL2.50ch08:51743956-51744483","3757","51743956","51744483","527","1534.31159643","0.343476514957"
"SL2.50ch08:54478594-54479084","3438","54478594","54479084","490","1534.31159643","0.319361465519"
"SL2.50ch08:54824004-54824605","235","54824004","54824605","601","1534.31159643","0.391706613831"
"SL2.50ch08:54992791-54994630","375","54992791","54994630","1839","1534.31159643","1.19858313284"
"SL2.50ch08:57456485-57456887","1053","57456485","57456887","402","1534.31159643","0.262006753345"
"SL2.50ch08:5746546-5747235","163","5746546","5747235","689","1534.31159643","0.449061326006"
"SL2.50ch08:57484981-57486206","4782","57484981","57486206","1225","1534.31159643","0.798403663799"
"SL2.50ch08:57485394-57486098","4708","57485394","57486098","704","1534.31159643","0.458837697399"
"SL2.50ch08:57859884-57863473","951","57859884","57863473","3589","1534.31159643","2.33915979541"
"SL2.50ch08:60629009-60629993","374","60629009","60629993","984","1534.31159643","0.641329963411"
"SL2.50ch08:6345911-6346468","125","6345911","6346468","557","1534.31159643","0.363029257744"
"SL2.50ch08:63628760-63629740","214","63628760","63629740","980","1534.31159643","0.638722931039"
"SL2.50ch08:6502019-6502394","86","6502019","6502394","375","1534.31159643","0.244409284836"
"SL2.50ch08:65066031-65066691","231","65066031","65066691","660","1534.31159643","0.430160341312"
"SL2.50ch08:65133266-65133734","233","65133266","65133734","468","1534.31159643","0.305022787476"
"SL2.50ch08:65160430-65161335","174","65160430","65161335","905","1534.31159643","0.589841074072"
"SL2.50ch08:6548271-6548931","4543","6548271","6548931","660","1534.31159643","0.430160341312"
"SL2.50ch08:6548308-6548870","4535","6548308","6548870","562","1534.31159643","0.366288048208"
"SL2.50ch08:65731792-65734597","590","65731792","65734597","2805","1534.31159643","1.82818145058"
"SL2.50ch08:7035438-7036053","509","7035438","7036053","615","1534.31159643","0.400831227132"
"SL2.50ch08:7130693-7131166","98","7130693","7131166","473","1534.31159643","0.30828157794"
"SL2.50ch08:8130598-8131124","113","8130598","8131124","526","1534.31159643","0.342824756864"
"SL2.50ch08:8702609-8703998","317","8702609","8703998","1389","1534.31159643","0.905291991034"
"SL2.50ch08:9019480-9019855","88","9019480","9019855","375","1534.31159643","0.244409284836"
"SL2.50ch08:9361556-9364116","489","9361556","9364116","2560","1534.31159643","1.66850071782"
"SL2.50ch08:9427529-9431458","736","9427529","9431458","3929","1534.31159643","2.56075754699"
"SL2.50ch08:9428601-9429104","147","9428601","9429104","503","1534.31159643","0.327834320727"
"SL2.50ch08:9436310-9437747","260","9436310","9437747","1437","1534.31159643","0.936576379493"
"SL2.50ch08:9455858-9456233","74","9455858","9456233","375","1534.31159643","0.244409284836"
"SL2.50ch08:9460721-9462248","263","9460721","9462248","1527","1534.31159643","0.995234607854"
"SL2.50ch08:9465618-9467091","473","9465618","9467091","1473","1534.31159643","0.960039670837"
"SL2.50ch08:9985729-9986390","526","9985729","9986390","661","1534.31159643","0.430812099405"
"SL2.50ch08:9985756-9986388","526","9985756","9986388","632","1534.31159643","0.411911114711"
"SL2.50ch08:9987933-9990384","2160","9987933","9990384","2451","1534.31159643","1.59745908569"
"SL2.50ch08:9987993-9990336","2120","9987993","9990336","2343","1534.31159643","1.52706921166"
"SL2.50ch08:9993033-9995895","2500","9993033","9995895","2862","1534.31159643","1.86533166187"
"SL2.50ch08:9993036-9995912","2500","9993036","9995912","2876","1534.31159643","1.87445627517"
"SL2.50ch09:10913610-10913985","84","10913610","10913985","375","1534.31159643","0.244409284836"
"SL2.50ch09:11297433-11301505","16933","11297433","11301505","4072","1534.31159643","2.65395895428"
"SL2.50ch09:11297633-11301471","16912","11297633","11301471","3838","1534.31159643","2.50144756054"
"SL2.50ch09:11302230-11304243","8242","11302230","11304243","2013","1534.31159643","1.311989041"
"SL2.50ch09:11302374-11304283","8243","11302374","11304283","1909","1534.31159643","1.24420619934"
"SL2.50ch09:11306570-11308211","5609","11306570","11308211","1641","1534.31159643","1.06953503044"
"SL2.50ch09:11306583-11308316","5609","11306583","11308316","1733","1534.31159643","1.12949677499"
"SL2.50ch09:11310073-11314098","7971","11310073","11314098","4025","1534.31159643","2.62332632391"
"SL2.50ch09:11310180-11312338","7424","11310180","11312338","2158","1534.31159643","1.40649396447"
"SL2.50ch09:11312889-11313291","264","11312889","11313291","402","1534.31159643","0.262006753345"
"SL2.50ch09:11575480-11576351","160","11575480","11576351","871","1534.31159643","0.567681298913"
"SL2.50ch09:12099517-12100172","113","12099517","12100172","655","1534.31159643","0.426901550847"
"SL2.50ch09:12786329-12786968","146","12786329","12786968","639","1534.31159643","0.416473421361"
"SL2.50ch09:12883847-12884332","104","12883847","12884332","485","1534.31159643","0.316102675055"
"SL2.50ch09:13688021-13688423","1471","13688021","13688423","402","1534.31159643","0.262006753345"
"SL2.50ch09:13697321-13697723","107","13697321","13697723","402","1534.31159643","0.262006753345"
"SL2.50ch09:14455145-14456119","189","14455145","14456119","974","1534.31159643","0.634812382482"
"SL2.50ch09:15203638-15204013","81","15203638","15204013","375","1534.31159643","0.244409284836"
"SL2.50ch09:1555849-1556419","362","1555849","1556419","570","1534.31159643","0.371502112951"
"SL2.50ch09:1555899-1556389","362","1555899","1556389","490","1534.31159643","0.319361465519"
"SL2.50ch09:16779793-16780722","203","16779793","16780722","929","1534.31159643","0.605483268301"
"SL2.50ch09:16784081-16785298","241","16784081","16785298","1217","1534.31159643","0.793189599056"
"SL2.50ch09:17834934-17835451","115","17834934","17835451","517","1534.31159643","0.336958934028"
"SL2.50ch09:18467595-18469417","526","18467595","18469417","1822","1534.31159643","1.18750324526"
"SL2.50ch09:18938919-18939551","1076","18938919","18939551","632","1534.31159643","0.411911114711"
"SL2.50ch09:19183208-19183583","74","19183208","19183583","375","1534.31159643","0.244409284836"
"SL2.50ch09:20902832-20903304","87","20902832","20903304","472","1534.31159643","0.307629819847"
"SL2.50ch09:21073066-21073441","75","21073066","21073441","375","1534.31159643","0.244409284836"
"SL2.50ch09:21620518-21621122","163","21620518","21621122","604","1534.31159643","0.39366188811"
"SL2.50ch09:22012360-22012948","148","22012360","22012948","588","1534.31159643","0.383233758623"
"SL2.50ch09:22135710-22136380","207","22135710","22136380","670","1534.31159643","0.436677922241"
"SL2.50ch09:22141916-22142778","168","22141916","22142778","862","1534.31159643","0.561815476077"
"SL2.50ch09:23494719-23495226","106","23494719","23495226","507","1534.31159643","0.330441353099"
"SL2.50ch09:2437059-2437726","4011","2437059","2437726","667","1534.31159643","0.434722647962"
"SL2.50ch09:2437079-2437650","4011","2437079","2437650","571","1534.31159643","0.372153871044"
"SL2.50ch09:24474541-24475334","2661","24474541","24475334","793","1534.31159643","0.516844167667"
"SL2.50ch09:24474549-24475257","2658","24474549","24475257","708","1534.31159643","0.461444729771"
"SL2.50ch09:25552558-25553171","142","25552558","25553171","613","1534.31159643","0.399527710946"
"SL2.50ch09:25887216-25887696","350","25887216","25887696","480","1534.31159643","0.312843884591"
"SL2.50ch09:25887304-25887706","345","25887304","25887706","402","1534.31159643","0.262006753345"
"SL2.50ch09:27249298-27250497","172","27249298","27250497","1199","1534.31159643","0.781457953383"
"SL2.50ch09:27730679-27731464","187","27730679","27731464","785","1534.31159643","0.511630102924"
"SL2.50ch09:27733037-27733692","438","27733037","27733692","655","1534.31159643","0.426901550847"
"SL2.50ch09:27891051-27891426","83","27891051","27891426","375","1534.31159643","0.244409284836"
"SL2.50ch09:28285369-28285744","86","28285369","28285744","375","1534.31159643","0.244409284836"
"SL2.50ch09:28762960-28763600","113","28762960","28763600","640","1534.31159643","0.417125179454"
"SL2.50ch09:28838378-28838972","109","28838378","28838972","594","1534.31159643","0.387144307181"
"SL2.50ch09:28987986-28988586","121","28987986","28988586","600","1534.31159643","0.391054855738"
"SL2.50ch09:29282249-29282761","110","29282249","29282761","512","1534.31159643","0.333700143563"
"SL2.50ch09:29455461-29456594","180","29455461","29456594","1133","1534.31159643","0.738441919252"
"SL2.50ch09:29741815-29742432","1899","29741815","29742432","617","1534.31159643","0.402134743317"
"SL2.50ch09:29757793-29758168","83","29757793","29758168","375","1534.31159643","0.244409284836"
"SL2.50ch09:29912063-29912915","163","29912063","29912915","852","1534.31159643","0.555297895148"
"SL2.50ch09:29954305-29954866","143","29954305","29954866","561","1534.31159643","0.365636290115"
"SL2.50ch09:30236488-30236968","99","30236488","30236968","480","1534.31159643","0.312843884591"
"SL2.50ch09:33570958-33572285","241","33570958","33572285","1327","1534.31159643","0.864882989274"
"SL2.50ch09:34125225-34126397","240","34125225","34126397","1172","1534.31159643","0.763860484875"
"SL2.50ch09:34702464-34702969","97","34702464","34702969","505","1534.31159643","0.329137836913"
"SL2.50ch09:34844549-34845493","183","34844549","34845493","944","1534.31159643","0.615259639695"
"SL2.50ch09:34860382-34860983","144","34860382","34860983","601","1534.31159643","0.391706613831"
"SL2.50ch09:34987011-34988002","162","34987011","34988002","991","1534.31159643","0.645892270061"
"SL2.50ch09:35168289-35168779","109","35168289","35168779","490","1534.31159643","0.319361465519"
"SL2.50ch09:35300602-35302548","8827","35300602","35302548","1946","1534.31159643","1.26832124878"
"SL2.50ch09:35300663-35302556","8819","35300663","35302556","1893","1534.31159643","1.23377806985"
"SL2.50ch09:35303351-35308999","17510","35303351","35308999","5648","1534.31159643","3.68112970868"
"SL2.50ch09:35303443-35305387","8558","35303443","35305387","1944","1534.31159643","1.26701773259"
"SL2.50ch09:35306176-35308989","8666","35306176","35308989","2813","1534.31159643","1.83339551532"
"SL2.50ch09:37196994-37197835","169","37196994","37197835","841","1534.31159643","0.548128556126"
"SL2.50ch09:37216149-37217048","165","37216149","37217048","899","1534.31159643","0.585930525514"
"SL2.50ch09:37249312-37249946","133","37249312","37249946","634","1534.31159643","0.413214630897"
"SL2.50ch09:37475320-37476676","249","37475320","37476676","1356","1534.31159643","0.883783973968"
"SL2.50ch09:37523057-37523715","756","37523057","37523715","658","1534.31159643","0.428856825126"
"SL2.50ch09:37523249-37523651","731","37523249","37523651","402","1534.31159643","0.262006753345"
"SL2.50ch09:3848301-3852522","922","3848301","3852522","4221","1534.31159643","2.75107091012"
"SL2.50ch09:38513258-38514429","196","38513258","38514429","1171","1534.31159643","0.763208726782"
"SL2.50ch09:40279709-40281584","46272","40279709","40281584","1875","1534.31159643","1.22204642418"
"SL2.50ch09:40280079-40281577","46199","40280079","40281577","1498","1534.31159643","0.97633362316"
"SL2.50ch09:40552759-40553134","78","40552759","40553134","375","1534.31159643","0.244409284836"
"SL2.50ch09:40947150-40948005","288","40947150","40948005","855","1534.31159643","0.557253169427"
"SL2.50ch09:41484055-41484889","164","41484055","41484889","834","1534.31159643","0.543566249476"
"SL2.50ch09:4209630-4210120","2474","4209630","4210120","490","1534.31159643","0.319361465519"
"SL2.50ch09:42326378-42326753","75","42326378","42326753","375","1534.31159643","0.244409284836"
"SL2.50ch09:42545887-42546262","71","42545887","42546262","375","1534.31159643","0.244409284836"
"SL2.50ch09:43426394-43426930","101","43426394","43426930","536","1534.31159643","0.349342337793"
"SL2.50ch09:43698962-43699337","76","43698962","43699337","375","1534.31159643","0.244409284836"
"SL2.50ch09:44219804-44220533","164","44219804","44220533","729","1534.31159643","0.475131649722"
"SL2.50ch09:45397090-45398123","3293","45397090","45398123","1033","1534.31159643","0.673266109962"
"SL2.50ch09:45397097-45398282","3300","45397097","45398282","1185","1534.31159643","0.772333340083"
"SL2.50ch09:45408056-45408524","102","45408056","45408524","468","1534.31159643","0.305022787476"
"SL2.50ch09:45873708-45874276","127","45873708","45874276","568","1534.31159643","0.370198596765"
"SL2.50ch09:45954908-45955894","191","45954908","45955894","986","1534.31159643","0.642633479596"
"SL2.50ch09:45983903-45985557","260","45983903","45985557","1654","1534.31159643","1.07800788565"
"SL2.50ch09:46155173-46155548","72","46155173","46155548","375","1534.31159643","0.244409284836"
"SL2.50ch09:46262521-46263447","30603","46262521","46263447","926","1534.31159643","0.603527994023"
"SL2.50ch09:46262538-46263493","30609","46262538","46263493","955","1534.31159643","0.622428978717"
"SL2.50ch09:46321036-46321411","85","46321036","46321411","375","1534.31159643","0.244409284836"
"SL2.50ch09:46513407-46513782","102","46513407","46513782","375","1534.31159643","0.244409284836"
"SL2.50ch09:46933685-46934274","124","46933685","46934274","589","1534.31159643","0.383885516716"
"SL2.50ch09:47142074-47142625","128","47142074","47142625","551","1534.31159643","0.359118709186"
"SL2.50ch09:47738019-47738394","77","47738019","47738394","375","1534.31159643","0.244409284836"
"SL2.50ch09:48423702-48424298","118","48423702","48424298","596","1534.31159643","0.388447823367"
"SL2.50ch09:49050495-49050990","91","49050495","49050990","495","1534.31159643","0.322620255984"
"SL2.50ch09:49471027-49473562","566","49471027","49473562","2535","1534.31159643","1.65220676549"
"SL2.50ch09:50420333-50420882","101","50420333","50420882","549","1534.31159643","0.357815193"
"SL2.50ch09:50745497-50746146","581","50745497","50746146","649","1534.31159643","0.42299100229"
"SL2.50ch09:50745717-50746227","552","50745717","50746227","510","1534.31159643","0.332396627377"
"SL2.50ch09:51275981-51276471","2059","51275981","51276471","490","1534.31159643","0.319361465519"
"SL2.50ch09:51344045-51344420","74","51344045","51344420","375","1534.31159643","0.244409284836"
"SL2.50ch09:51595983-51596497","99","51595983","51596497","514","1534.31159643","0.335003659749"
"SL2.50ch09:51905531-51905906","78","51905531","51905906","375","1534.31159643","0.244409284836"
"SL2.50ch09:53088338-53091071","9424","53088338","53091071","2733","1534.31159643","1.78125486789"
"SL2.50ch09:53088398-53090475","9346","53088398","53090475","2077","1534.31159643","1.35370155895"
"SL2.50ch09:53828985-53829972","182","53828985","53829972","987","1534.31159643","0.643285237689"
"SL2.50ch09:54057403-54057882","95","54057403","54057882","479","1534.31159643","0.312192126498"
"SL2.50ch09:54977957-54978359","1254","54977957","54978359","402","1534.31159643","0.262006753345"
"SL2.50ch09:55002502-55003120","130","55002502","55003120","618","1534.31159643","0.40278650141"
"SL2.50ch09:55027619-55028153","2400","55027619","55028153","534","1534.31159643","0.348038821607"
"SL2.50ch09:55543055-55543527","76","55543055","55543527","472","1534.31159643","0.307629819847"
"SL2.50ch09:56322382-56322784","364","56322382","56322784","402","1534.31159643","0.262006753345"
"SL2.50ch09:58045759-58046663","172","58045759","58046663","904","1534.31159643","0.589189315979"
"SL2.50ch09:58157621-58158308","119","58157621","58158308","687","1534.31159643","0.44775780982"
"SL2.50ch09:58182606-58182981","92","58182606","58182981","375","1534.31159643","0.244409284836"
"SL2.50ch09:58995412-58997131","14850","58995412","58997131","1719","1534.31159643","1.12037216169"
"SL2.50ch09:58995750-58996791","14725","58995750","58996791","1041","1534.31159643","0.678480174706"
"SL2.50ch09:60656705-60657375","1183","60656705","60657375","670","1534.31159643","0.436677922241"
"SL2.50ch09:60656797-60657410","1174","60656797","60657410","613","1534.31159643","0.399527710946"
"SL2.50ch09:61857371-61858195","18677","61857371","61858195","824","1534.31159643","0.537048668547"
"SL2.50ch09:61857396-61858161","18671","61857396","61858161","765","1534.31159643","0.498594941066"
"SL2.50ch09:62110628-62111030","2335","62110628","62111030","402","1534.31159643","0.262006753345"
"SL2.50ch09:63666452-63666942","2940","63666452","63666942","490","1534.31159643","0.319361465519"
"SL2.50ch09:63970859-63971481","14531","63970859","63971481","622","1534.31159643","0.405393533782"
"SL2.50ch09:63970860-63971410","14527","63970860","63971410","550","1534.31159643","0.358466951093"
"SL2.50ch09:64935402-64937389","640","64935402","64937389","1987","1534.31159643","1.29504333059"
"SL2.50ch09:65535129-65535619","402","65535129","65535619","490","1534.31159643","0.319361465519"
"SL2.50ch09:67002207-67003115","297","67002207","67003115","908","1534.31159643","0.59179634835"
"SL2.50ch09:67762875-67763250","74","67762875","67763250","375","1534.31159643","0.244409284836"
"SL2.50ch09:6789960-6791468","1538","6789960","6791468","1508","1534.31159643","0.982851204088"
"SL2.50ch09:6789992-6791557","1543","6789992","6791557","1565","1534.31159643","1.02000141538"
"SL2.50ch09:68837167-68838375","335","68837167","68838375","1208","1534.31159643","0.787323776219"
"SL2.50ch09:70696416-70697033","1890","70696416","70697033","617","1534.31159643","0.402134743317"
"SL2.50ch09:70696434-70697040","1890","70696434","70697040","606","1534.31159643","0.394965404296"
"SL2.50ch09:71682972-71683347","73","71682972","71683347","375","1534.31159643","0.244409284836"
"SL2.50ch09:7384132-7384605","219","7384132","7384605","473","1534.31159643","0.30828157794"
"SL2.50ch09:8067272-8067647","140","8067272","8067647","375","1534.31159643","0.244409284836"
"SL2.50ch09:8532278-8533253","317","8532278","8533253","975","1534.31159643","0.635464140574"
"SL2.50ch09:8551137-8551645","1033","8551137","8551645","508","1534.31159643","0.331093111192"
"SL2.50ch09:8786424-8786799","265","8786424","8786799","375","1534.31159643","0.244409284836"
"SL2.50ch10:1-701","363","1","701","700","1534.31159643","0.456230665028"
"SL2.50ch10:10731514-10732335","1197","10731514","10732335","821","1534.31159643","0.535093394268"
"SL2.50ch10:10731664-10732377","1177","10731664","10732377","713","1534.31159643","0.464703520235"
"SL2.50ch10:10733637-10734143","619","10733637","10734143","506","1534.31159643","0.329789595006"
"SL2.50ch10:10734960-10735464","909","10734960","10735464","504","1534.31159643","0.32848607882"
"SL2.50ch10:11654073-11654599","107","11654073","11654599","526","1534.31159643","0.342824756864"
"SL2.50ch10:11687652-11689381","372","11687652","11689381","1729","1534.31159643","1.12688974262"
"SL2.50ch10:12559557-12560236","134","12559557","12560236","679","1534.31159643","0.442543745077"
"SL2.50ch10:13106178-13107086","162","13106178","13107086","908","1534.31159643","0.59179634835"
"SL2.50ch10:13112693-13113212","122","13112693","13113212","519","1534.31159643","0.338262450213"
"SL2.50ch10:14078179-14078554","85","14078179","14078554","375","1534.31159643","0.244409284836"
"SL2.50ch10:14203407-14204871","280","14203407","14204871","1464","1534.31159643","0.954173848001"
"SL2.50ch10:14222028-14222403","100","14222028","14222403","375","1534.31159643","0.244409284836"
"SL2.50ch10:14253242-14253617","70","14253242","14253617","375","1534.31159643","0.244409284836"
"SL2.50ch10:14308409-14308963","111","14308409","14308963","554","1534.31159643","0.361073983465"
"SL2.50ch10:14396595-14397204","116","14396595","14397204","609","1534.31159643","0.396920678574"
"SL2.50ch10:14724591-14726784","442","14724591","14726784","2193","1534.31159643","1.42930549772"
"SL2.50ch10:15241379-15242845","55831","15241379","15242845","1466","1534.31159643","0.955477364187"
"SL2.50ch10:15241454-15242846","55828","15241454","15242846","1392","1534.31159643","0.907247265312"
"SL2.50ch10:15272405-15273237","258","15272405","15273237","832","1534.31159643","0.54226273329"
"SL2.50ch10:15372211-15372855","115","15372211","15372855","644","1534.31159643","0.419732211826"
"SL2.50ch10:15650527-15651102","124","15650527","15651102","575","1534.31159643","0.374760903416"
"SL2.50ch10:15654170-15654545","78","15654170","15654545","375","1534.31159643","0.244409284836"
"SL2.50ch10:15721784-15725257","673","15721784","15725257","3473","1534.31159643","2.26355585663"
"SL2.50ch10:15742129-15745008","695","15742129","15745008","2879","1534.31159643","1.87641154945"
"SL2.50ch10:15782402-15786109","788","15782402","15786109","3707","1534.31159643","2.41606725037"
"SL2.50ch10:15874568-15875171","135","15874568","15875171","603","1534.31159643","0.393010130017"
"SL2.50ch10:15949441-15949909","86","15949441","15949909","468","1534.31159643","0.305022787476"
"SL2.50ch10:16275581-16276262","124","16275581","16276262","681","1534.31159643","0.443847261263"
"SL2.50ch10:16338716-16339287","124","16338716","16339287","571","1534.31159643","0.372153871044"
"SL2.50ch10:16372227-16372851","117","16372227","16372851","624","1534.31159643","0.406697049968"
"SL2.50ch10:16378991-16379660","136","16378991","16379660","669","1534.31159643","0.436026164148"
"SL2.50ch10:16717479-16717854","73","16717479","16717854","375","1534.31159643","0.244409284836"
"SL2.50ch10:16939078-16940016","163","16939078","16940016","938","1534.31159643","0.611349091137"
"SL2.50ch10:18-641","362","18","641","623","1534.31159643","0.406045291875"
"SL2.50ch10:18054873-18056070","207","18054873","18056070","1197","1534.31159643","0.780154437198"
"SL2.50ch10:18417510-18421836","1972","18417510","18421836","4326","1534.31159643","2.81950550987"
"SL2.50ch10:18418674-18420316","1342","18418674","18420316","1642","1534.31159643","1.07018678854"
"SL2.50ch10:18762999-18763489","1321","18762999","18763489","490","1534.31159643","0.319361465519"
"SL2.50ch10:19088893-19089504","112","19088893","19089504","611","1534.31159643","0.39822419476"
"SL2.50ch10:19334782-19335157","74","19334782","19335157","375","1534.31159643","0.244409284836"
"SL2.50ch10:19988231-19988804","105","19988231","19988804","573","1534.31159643","0.37345738723"
"SL2.50ch10:20007176-20007918","136","20007176","20007918","742","1534.31159643","0.483604504929"
"SL2.50ch10:20194133-20195111","185","20194133","20195111","978","1534.31159643","0.637419414853"
"SL2.50ch10:20311622-20312105","99","20311622","20312105","483","1534.31159643","0.314799158869"
"SL2.50ch10:20635803-20636178","69","20635803","20636178","375","1534.31159643","0.244409284836"
"SL2.50ch10:21219967-21221128","285","21219967","21221128","1161","1534.31159643","0.756691145853"
"SL2.50ch10:21225499-21228599","777","21225499","21228599","3100","1534.31159643","2.02045008798"
"SL2.50ch10:21231545-21232691","243","21231545","21232691","1146","1534.31159643","0.74691477446"
"SL2.50ch10:21236001-21237691","356","21236001","21237691","1690","1534.31159643","1.101471177"
"SL2.50ch10:21247088-21247972","427","21247088","21247972","884","1534.31159643","0.576154154121"
"SL2.50ch10:21250900-21251570","157","21250900","21251570","670","1534.31159643","0.436677922241"
"SL2.50ch10:22463263-22463776","1470","22463263","22463776","513","1534.31159643","0.334351901656"
"SL2.50ch10:22665297-22665974","593","22665297","22665974","677","1534.31159643","0.441240228891"
"SL2.50ch10:22665414-22665918","567","22665414","22665918","504","1534.31159643","0.32848607882"
"SL2.50ch10:23944452-23944854","282","23944452","23944854","402","1534.31159643","0.262006753345"
"SL2.50ch10:23945580-23946082","565","23945580","23946082","502","1534.31159643","0.327182562634"
"SL2.50ch10:23948704-23949277","297","23948704","23949277","573","1534.31159643","0.37345738723"
"SL2.50ch10:23948779-23949181","287","23948779","23949181","402","1534.31159643","0.262006753345"
"SL2.50ch10:23972110-23972485","71","23972110","23972485","375","1534.31159643","0.244409284836"
"SL2.50ch10:24143571-24146441","916","24143571","24146441","2870","1534.31159643","1.87054572661"
"SL2.50ch10:24474490-24474865","65","24474490","24474865","375","1534.31159643","0.244409284836"
"SL2.50ch10:24813287-24813755","93","24813287","24813755","468","1534.31159643","0.305022787476"
"SL2.50ch10:25679622-25680204","124","25679622","25680204","582","1534.31159643","0.379323210066"
"SL2.50ch10:25715786-25716490","163","25715786","25716490","704","1534.31159643","0.458837697399"
"SL2.50ch10:25777485-25777975","6146","25777485","25777975","490","1534.31159643","0.319361465519"
"SL2.50ch10:26348586-26357575","2736","26348586","26357575","8989","1534.31159643","5.85865349705"
"SL2.50ch10:26356202-26357520","392","26356202","26357520","1318","1534.31159643","0.859017166438"
"SL2.50ch10:26364134-26365086","228","26364134","26365086","952","1534.31159643","0.620473704438"
"SL2.50ch10:26364243-26365002","206","26364243","26365002","759","1534.31159643","0.494684392509"
"SL2.50ch10:26365611-26366196","181","26365611","26366196","585","1534.31159643","0.381278484345"
"SL2.50ch10:26371425-26374710","1000","26371425","26374710","3285","1534.31159643","2.14102533517"
"SL2.50ch10:26801238-26804011","28614","26801238","26804011","2773","1534.31159643","1.8073251916"
"SL2.50ch10:26801368-26803806","28587","26801368","26803806","2438","1534.31159643","1.58898623048"
"SL2.50ch10:26805655-26806686","8846","26805655","26806686","1031","1534.31159643","0.671962593777"
"SL2.50ch10:26805688-26806695","8815","26805688","26806695","1007","1534.31159643","0.656320399547"
"SL2.50ch10:26986697-26987165","100","26986697","26987165","468","1534.31159643","0.305022787476"
"SL2.50ch10:27367989-27368602","6624","27367989","27368602","613","1534.31159643","0.399527710946"
"SL2.50ch10:28171694-28172069","73","28171694","28172069","375","1534.31159643","0.244409284836"
"SL2.50ch10:28297575-28299380","691","28297575","28299380","1805","1534.31159643","1.17642335768"
"SL2.50ch10:28298074-28299384","593","28298074","28299384","1310","1534.31159643","0.853803101695"
"SL2.50ch10:28333936-28334311","102","28333936","28334311","375","1534.31159643","0.244409284836"
"SL2.50ch10:28974325-28975005","127","28974325","28975005","680","1534.31159643","0.44319550317"
"SL2.50ch10:29736412-29737191","159","29736412","29737191","779","1534.31159643","0.507719554367"
"SL2.50ch10:30176407-30176937","108","30176407","30176937","530","1534.31159643","0.345431789235"
"SL2.50ch10:30262764-30263256","104","30262764","30263256","492","1534.31159643","0.320664981705"
"SL2.50ch10:30914447-30915421","164","30914447","30915421","974","1534.31159643","0.634812382482"
"SL2.50ch10:3100798-3101427","812","3100798","3101427","629","1534.31159643","0.409955840432"
"SL2.50ch10:3100924-3101393","811","3100924","3101393","469","1534.31159643","0.305674545569"
"SL2.50ch10:31221287-31221662","80","31221287","31221662","375","1534.31159643","0.244409284836"
"SL2.50ch10:31948568-31949336","173","31948568","31949336","768","1534.31159643","0.500550215345"
"SL2.50ch10:32121655-32122145","75","32121655","32122145","490","1534.31159643","0.319361465519"
"SL2.50ch10:32243555-32244036","100","32243555","32244036","481","1534.31159643","0.313495642683"
"SL2.50ch10:32274552-32275126","103","32274552","32275126","574","1534.31159643","0.374109145323"
"SL2.50ch10:32295418-32296388","234","32295418","32296388","970","1534.31159643","0.63220535011"
"SL2.50ch10:32297514-32298129","132","32297514","32298129","615","1534.31159643","0.400831227132"
"SL2.50ch10:32437159-32437832","128","32437159","32437832","673","1534.31159643","0.43863319652"
"SL2.50ch10:33582526-33582901","80","33582526","33582901","375","1534.31159643","0.244409284836"
"SL2.50ch10:3515329-3517677","435","3515329","3517677","2348","1534.31159643","1.53032800212"
"SL2.50ch10:35324569-35324944","81","35324569","35324944","375","1534.31159643","0.244409284836"
"SL2.50ch10:35415878-35416280","201","35415878","35416280","402","1534.31159643","0.262006753345"
"SL2.50ch10:35971426-35971801","67","35971426","35971801","375","1534.31159643","0.244409284836"
"SL2.50ch10:36492781-36493290","107","36492781","36493290","509","1534.31159643","0.331744869285"
"SL2.50ch10:36675059-36675434","100","36675059","36675434","375","1534.31159643","0.244409284836"
"SL2.50ch10:36684431-36685513","623","36684431","36685513","1082","1534.31159643","0.705202256514"
"SL2.50ch10:36684467-36685379","619","36684467","36685379","912","1534.31159643","0.594403380722"
"SL2.50ch10:36692857-36693428","352","36692857","36693428","571","1534.31159643","0.372153871044"
"SL2.50ch10:37171312-37171802","4385","37171312","37171802","490","1534.31159643","0.319361465519"
"SL2.50ch10:37171355-37171823","4380","37171355","37171823","468","1534.31159643","0.305022787476"
"SL2.50ch10:37566299-37566866","95","37566299","37566866","567","1534.31159643","0.369546838673"
"SL2.50ch10:3773789-3775431","356","3773789","3775431","1642","1534.31159643","1.07018678854"
"SL2.50ch10:38100516-38105622","1140","38100516","38105622","5106","1534.31159643","3.32787682233"
"SL2.50ch10:3824639-3826206","440","3824639","3826206","1567","1534.31159643","1.02130493157"
"SL2.50ch10:38517930-38518836","283","38517930","38518836","906","1534.31159643","0.590492832165"
"SL2.50ch10:39018233-39019133","1122","39018233","39019133","900","1534.31159643","0.586582283607"
"SL2.50ch10:39018255-39019106","1118","39018255","39019106","851","1534.31159643","0.554646137055"
"SL2.50ch10:39505430-39506103","5545","39505430","39506103","673","1534.31159643","0.43863319652"
"SL2.50ch10:39505493-39505983","5525","39505493","39505983","490","1534.31159643","0.319361465519"
"SL2.50ch10:39802143-39802518","82","39802143","39802518","375","1534.31159643","0.244409284836"
"SL2.50ch10:40793839-40797294","15561","40793839","40797294","3455","1534.31159643","2.25182421096"
"SL2.50ch10:40798547-40799263","23591","40798547","40799263","716","1534.31159643","0.466658794514"
"SL2.50ch10:40799672-40800178","2896","40799672","40800178","506","1534.31159643","0.329789595006"
"SL2.50ch10:40803642-40804263","3315","40803642","40804263","621","1534.31159643","0.404741775689"
"SL2.50ch10:40803669-40804328","3320","40803669","40804328","659","1534.31159643","0.429508583219"
"SL2.50ch10:41437753-41438226","187","41437753","41438226","473","1534.31159643","0.30828157794"
"SL2.50ch10:41646844-41647246","1135","41646844","41647246","402","1534.31159643","0.262006753345"
"SL2.50ch10:42461031-42462032","230","42461031","42462032","1001","1534.31159643","0.65240985099"
"SL2.50ch10:43054283-43060735","2511","43054283","43060735","6452","1534.31159643","4.20514321537"
"SL2.50ch10:43055031-43060557","2401","43055031","43060557","5526","1534.31159643","3.60161522135"
"SL2.50ch10:43880858-43882594","16269","43880858","43882594","1736","1534.31159643","1.13145204927"
"SL2.50ch10:43880890-43882566","16207","43880890","43882566","1676","1534.31159643","1.0923465637"
"SL2.50ch10:43884398-43885693","7637","43884398","43885693","1295","1534.31159643","0.844026730301"
"SL2.50ch10:43884515-43885625","7608","43884515","43885625","1110","1534.31159643","0.723451483116"
"SL2.50ch10:43886615-43888382","15696","43886615","43888382","1767","1534.31159643","1.15165655015"
"SL2.50ch10:43886618-43888440","15696","43886618","43888440","1822","1534.31159643","1.18750324526"
"SL2.50ch10:43892666-43893357","2798","43892666","43893357","691","1534.31159643","0.450364842192"
"SL2.50ch10:43892709-43893629","2847","43892709","43893629","920","1534.31159643","0.599617445465"
"SL2.50ch10:43989776-43990151","77","43989776","43990151","375","1534.31159643","0.244409284836"
"SL2.50ch10:45905625-45906385","5909","45905625","45906385","760","1534.31159643","0.495336150602"
"SL2.50ch10:45905650-45906305","5907","45905650","45906305","655","1534.31159643","0.426901550847"
"SL2.50ch10:46185706-46186727","261","46185706","46186727","1021","1534.31159643","0.665445012848"
"SL2.50ch10:46644232-46645002","171","46644232","46645002","770","1534.31159643","0.501853731531"
"SL2.50ch10:4700007-4700937","17725","4700007","4700937","930","1534.31159643","0.606135026394"
"SL2.50ch10:4700036-4700898","17725","4700036","4700898","862","1534.31159643","0.561815476077"
"SL2.50ch10:47369518-47369986","186","47369518","47369986","468","1534.31159643","0.305022787476"
"SL2.50ch10:47373453-47373828","77","47373453","47373828","375","1534.31159643","0.244409284836"
"SL2.50ch10:47595708-47598356","753","47595708","47598356","2648","1534.31159643","1.72585542999"
"SL2.50ch10:47596963-47598278","439","47596963","47598278","1315","1534.31159643","0.857061892159"
"SL2.50ch10:47837605-47837980","73","47837605","47837980","375","1534.31159643","0.244409284836"
"SL2.50ch10:48488925-48489300","73","48488925","48489300","375","1534.31159643","0.244409284836"
"SL2.50ch10:48524359-48524761","1151","48524359","48524761","402","1534.31159643","0.262006753345"
"SL2.50ch10:48677438-48678027","114","48677438","48678027","589","1534.31159643","0.383885516716"
"SL2.50ch10:49149682-49150330","127","49149682","49150330","648","1534.31159643","0.422339244197"
"SL2.50ch10:50498192-50498674","104","50498192","50498674","482","1534.31159643","0.314147400776"
"SL2.50ch10:51068064-51068556","95","51068064","51068556","492","1534.31159643","0.320664981705"
"SL2.50ch10:51237020-51237865","168","51237020","51237865","845","1534.31159643","0.550735588498"
"SL2.50ch10:52342349-52342889","100","52342349","52342889","540","1534.31159643","0.351949370164"
"SL2.50ch10:53322775-53323337","6941","53322775","53323337","562","1534.31159643","0.366288048208"
"SL2.50ch10:53322810-53323348","6943","53322810","53323348","538","1534.31159643","0.350645853979"
"SL2.50ch10:53525541-53526156","1735","53525541","53526156","615","1534.31159643","0.400831227132"
"SL2.50ch10:54021908-54024602","616","54021908","54024602","2694","1534.31159643","1.75583630226"
"SL2.50ch10:54023609-54024011","138","54023609","54024011","402","1534.31159643","0.262006753345"
"SL2.50ch10:54026726-54027542","198","54026726","54027542","816","1534.31159643","0.531834603804"
"SL2.50ch10:55347672-55348047","70","55347672","55348047","375","1534.31159643","0.244409284836"
"SL2.50ch10:57563929-57565882","533","57563929","57565882","1953","1534.31159643","1.27288355543"
"SL2.50ch10:57573299-57578498","1299","57573299","57578498","5199","1534.31159643","3.38849032497"
"SL2.50ch10:57584192-57584885","233","57584192","57584885","693","1534.31159643","0.451668358378"
"SL2.50ch10:57587222-57588580","466","57587222","57588580","1358","1534.31159643","0.885087490154"
"SL2.50ch10:57594315-57595299","378","57594315","57595299","984","1534.31159643","0.641329963411"
"SL2.50ch10:57594383-57595217","371","57594383","57595217","834","1534.31159643","0.543566249476"
"SL2.50ch10:57647997-57648865","160","57647997","57648865","868","1534.31159643","0.565726024634"
"SL2.50ch10:57659221-57660171","547","57659221","57660171","950","1534.31159643","0.619170188252"
"SL2.50ch10:57686854-57687326","110","57686854","57687326","472","1534.31159643","0.307629819847"
"SL2.50ch10:57698042-57699159","389","57698042","57699159","1117","1534.31159643","0.728013789766"
"SL2.50ch10:57700866-57702286","682","57700866","57702286","1420","1534.31159643","0.925496491914"
"SL2.50ch10:58041839-58042241","1480","58041839","58042241","402","1534.31159643","0.262006753345"
"SL2.50ch10:58689040-58689415","79","58689040","58689415","375","1534.31159643","0.244409284836"
"SL2.50ch10:59391562-59392485","172","59391562","59392485","923","1534.31159643","0.601572719744"
"SL2.50ch10:59458580-59458955","80","59458580","59458955","375","1534.31159643","0.244409284836"
"SL2.50ch10:60013538-60014033","100","60013538","60014033","495","1534.31159643","0.322620255984"
"SL2.50ch10:60632952-60633943","294","60632952","60633943","991","1534.31159643","0.645892270061"
"SL2.50ch10:60633553-60633955","219","60633553","60633955","402","1534.31159643","0.262006753345"
"SL2.50ch10:61674621-61675556","221","61674621","61675556","935","1534.31159643","0.609393816859"
"SL2.50ch10:6175070-6186660","152278","6175070","6186660","11590","1534.31159643","7.55387629667"
"SL2.50ch10:6175266-6186579","152271","6175266","6186579","11313","1534.31159643","7.37333930494"
"SL2.50ch10:6187225-6187761","4062","6187225","6187761","536","1534.31159643","0.349342337793"
"SL2.50ch10:63001114-63001878","226","63001114","63001878","764","1534.31159643","0.497943182973"
"SL2.50ch10:65521191-65522972","579","65521191","65522972","1781","1534.31159643","1.16078116345"
"SL2.50ch10:65523714-65525561","652","65523714","65525561","1847","1534.31159643","1.20379719758"
"SL2.50ch10:6980397-6981026","141","6980397","6981026","629","1534.31159643","0.409955840432"
"SL2.50ch10:7026656-7027031","90","7026656","7027031","375","1534.31159643","0.244409284836"
"SL2.50ch10:7372271-7372746","526","7372271","7372746","475","1534.31159643","0.309585094126"
"SL2.50ch10:7372381-7372783","524","7372381","7372783","402","1534.31159643","0.262006753345"
"SL2.50ch10:7965182-7965557","71","7965182","7965557","375","1534.31159643","0.244409284836"
"SL2.50ch10:8853174-8853668","943","8853174","8853668","494","1534.31159643","0.321968497891"
"SL2.50ch10:9021012-9021414","559","9021012","9021414","402","1534.31159643","0.262006753345"
"SL2.50ch10:9939738-9940925","191","9939738","9940925","1187","1534.31159643","0.773636856269"
"SL2.50ch11:10861890-10862292","758","10861890","10862292","402","1534.31159643","0.262006753345"
"SL2.50ch11:11005906-11006652","153","11005906","11006652","746","1534.31159643","0.486211537301"
"SL2.50ch11:11091565-11093117","319","11091565","11093117","1552","1534.31159643","1.01152856018"
"SL2.50ch11:11288397-11288772","300","11288397","11288772","375","1534.31159643","0.244409284836"
"SL2.50ch11:11405368-11406109","157","11405368","11406109","741","1534.31159643","0.482952746837"
"SL2.50ch11:12015811-12016345","2754","12015811","12016345","534","1534.31159643","0.348038821607"
"SL2.50ch11:12456445-12457150","152","12456445","12457150","705","1534.31159643","0.459489455492"
"SL2.50ch11:13246325-13247072","157","13246325","13247072","747","1534.31159643","0.486863295394"
"SL2.50ch11:13364969-13367360","676","13364969","13367360","2391","1534.31159643","1.55835360012"
"SL2.50ch11:13371699-13372835","442","13371699","13372835","1136","1534.31159643","0.740397193531"
"SL2.50ch11:13372079-13372569","321","13372079","13372569","490","1534.31159643","0.319361465519"
"SL2.50ch11:13374609-13375317","147","13374609","13375317","708","1534.31159643","0.461444729771"
"SL2.50ch11:13377232-13380988","60282","13377232","13380988","3756","1534.31159643","2.44800339692"
"SL2.50ch11:13378216-13380906","60153","13378216","13380906","2690","1534.31159643","1.75322926989"
"SL2.50ch11:13383723-13384959","13920","13383723","13384959","1236","1534.31159643","0.805573002821"
"SL2.50ch11:13383731-13385920","15311","13383731","13385920","2189","1534.31159643","1.42669846535"
"SL2.50ch11:13385499-13385901","1162","13385499","13385901","402","1534.31159643","0.262006753345"
"SL2.50ch11:13386656-13388410","36729","13386656","13388410","1754","1534.31159643","1.14318369494"
"SL2.50ch11:13386812-13388294","35895","13386812","13388294","1482","1534.31159643","0.965905493673"
"SL2.50ch11:13390209-13392187","47696","13390209","13392187","1978","1534.31159643","1.28917750775"
"SL2.50ch11:13390239-13392190","47463","13390239","13392190","1951","1534.31159643","1.27158003924"
"SL2.50ch11:13394669-13399910","100425","13394669","13399910","5241","1534.31159643","3.41586416487"
"SL2.50ch11:13394681-13400108","100431","13394681","13400108","5427","1534.31159643","3.53709117015"
"SL2.50ch11:13401178-13402107","2913","13401178","13402107","929","1534.31159643","0.605483268301"
"SL2.50ch11:13401366-13402088","2896","13401366","13402088","722","1534.31159643","0.470569343072"
"SL2.50ch11:14275764-14276772","199","14275764","14276772","1008","1534.31159643","0.65697215764"
"SL2.50ch11:14383511-14384001","554","14383511","14384001","490","1534.31159643","0.319361465519"
"SL2.50ch11:14418958-14419333","65","14418958","14419333","375","1534.31159643","0.244409284836"
"SL2.50ch11:16103038-16104464","4403","16103038","16104464","1426","1534.31159643","0.929407040471"
"SL2.50ch11:1651130-1651532","740","1651130","1651532","402","1534.31159643","0.262006753345"
"SL2.50ch11:16916961-16917908","172","16916961","16917908","947","1534.31159643","0.617214913973"
"SL2.50ch11:17210284-17210907","2777","17210284","17210907","623","1534.31159643","0.406045291875"
"SL2.50ch11:17210290-17210902","2772","17210290","17210902","612","1534.31159643","0.398875952853"
"SL2.50ch11:17769198-17769859","12008","17769198","17769859","661","1534.31159643","0.430812099405"
"SL2.50ch11:17769254-17769867","12006","17769254","17769867","613","1534.31159643","0.399527710946"
"SL2.50ch11:17832274-17833728","261","17832274","17833728","1454","1534.31159643","0.947656267072"
"SL2.50ch11:17850965-17851723","161","17850965","17851723","758","1534.31159643","0.494032634416"
"SL2.50ch11:17861238-17861852","898","17861238","17861852","614","1534.31159643","0.400179469039"
"SL2.50ch11:17872768-17874068","2449","17872768","17874068","1300","1534.31159643","0.847285520766"
"SL2.50ch11:17898587-17899783","226","17898587","17899783","1196","1534.31159643","0.779502679105"
"SL2.50ch11:17940417-17941798","307","17940417","17941798","1381","1534.31159643","0.900077926291"
"SL2.50ch11:17948197-17948854","217","17948197","17948854","657","1534.31159643","0.428205067033"
"SL2.50ch11:17952477-17954993","704","17952477","17954993","2516","1534.31159643","1.63982336173"
"SL2.50ch11:17953886-17954979","390","17953886","17954979","1093","1534.31159643","0.712371595536"
"SL2.50ch11:17956473-17956952","99","17956473","17956952","479","1534.31159643","0.312192126498"
"SL2.50ch11:17963181-17963661","113","17963181","17963661","480","1534.31159643","0.312843884591"
"SL2.50ch11:17984475-17985156","152","17984475","17985156","681","1534.31159643","0.443847261263"
"SL2.50ch11:17987922-17989520","396","17987922","17989520","1598","1534.31159643","1.04150943245"
"SL2.50ch11:17990662-17991369","264","17990662","17991369","707","1534.31159643","0.460792971678"
"SL2.50ch11:17998453-18002543","1306","17998453","18002543","4090","1534.31159643","2.66569059995"
"SL2.50ch11:18006123-18007075","300","18006123","18007075","952","1534.31159643","0.620473704438"
"SL2.50ch11:18015281-18019377","958","18015281","18019377","4096","1534.31159643","2.66960114851"
"SL2.50ch11:18020853-18026759","1916","18020853","18026759","5906","1534.31159643","3.84928329665"
"SL2.50ch11:18024258-18026221","773","18024258","18026221","1963","1534.31159643","1.27940113636"
"SL2.50ch11:18031842-18034551","625","18031842","18034551","2709","1534.31159643","1.76561267366"
"SL2.50ch11:18032417-18033472","267","18032417","18033472","1055","1534.31159643","0.687604788006"
"SL2.50ch11:18034153-18034555","138","18034153","18034555","402","1534.31159643","0.262006753345"
"SL2.50ch11:18035054-18037120","787","18035054","18037120","2066","1534.31159643","1.34653221992"
"SL2.50ch11:18035360-18037075","712","18035360","18037075","1715","1534.31159643","1.11776512932"
"SL2.50ch11:18573851-18574412","130","18573851","18574412","561","1534.31159643","0.365636290115"
"SL2.50ch11:18584754-18585129","80","18584754","18585129","375","1534.31159643","0.244409284836"
"SL2.50ch11:18595359-18595971","1767","18595359","18595971","612","1534.31159643","0.398875952853"
"SL2.50ch11:18627136-18627797","171","18627136","18627797","661","1534.31159643","0.430812099405"
"SL2.50ch11:18627183-18627859","165","18627183","18627859","676","1534.31159643","0.440588470798"
"SL2.50ch11:18644711-18645835","281","18644711","18645835","1124","1534.31159643","0.732576096416"
"SL2.50ch11:18645231-18645633","198","18645231","18645633","402","1534.31159643","0.262006753345"
"SL2.50ch11:18652070-18652572","111","18652070","18652572","502","1534.31159643","0.327182562634"
"SL2.50ch11:18669090-18669465","220","18669090","18669465","375","1534.31159643","0.244409284836"
"SL2.50ch11:18669137-18669539","216","18669137","18669539","402","1534.31159643","0.262006753345"
"SL2.50ch11:18682077-18682479","222","18682077","18682479","402","1534.31159643","0.262006753345"
"SL2.50ch11:18737416-18738053","802","18737416","18738053","637","1534.31159643","0.415169905175"
"SL2.50ch11:18832189-18832905","166","18832189","18832905","716","1534.31159643","0.466658794514"
"SL2.50ch11:19502071-19502648","129","19502071","19502648","577","1534.31159643","0.376064419601"
"SL2.50ch11:19929961-19930336","81","19929961","19930336","375","1534.31159643","0.244409284836"
"SL2.50ch11:2007312-2007887","1452","2007312","2007887","575","1534.31159643","0.374760903416"
"SL2.50ch11:2007316-2007852","1452","2007316","2007852","536","1534.31159643","0.349342337793"
"SL2.50ch11:20225229-20225817","125","20225229","20225817","588","1534.31159643","0.383233758623"
"SL2.50ch11:20288855-20289934","204","20288855","20289934","1079","1534.31159643","0.703246982236"
"SL2.50ch11:20415748-20416757","1223","20415748","20416757","1009","1534.31159643","0.657623915733"
"SL2.50ch11:20415783-20416678","1204","20415783","20416678","895","1534.31159643","0.583323493143"
"SL2.50ch11:20418887-20423089","6576","20418887","20423089","4202","1534.31159643","2.73868750635"
"SL2.50ch11:20419051-20420293","1597","20419051","20420293","1242","1534.31159643","0.809483551378"
"SL2.50ch11:20421557-20423119","4663","20421557","20423119","1562","1534.31159643","1.0180461411"
"SL2.50ch11:20424366-20425295","631","20424366","20425295","929","1534.31159643","0.605483268301"
"SL2.50ch11:20424477-20425114","619","20424477","20425114","637","1534.31159643","0.415169905175"
"SL2.50ch11:20739247-20741244","432","20739247","20741244","1997","1534.31159643","1.30156091152"
"SL2.50ch11:20748465-20751023","521","20748465","20751023","2558","1534.31159643","1.66719720163"
"SL2.50ch11:20757194-20758479","218","20757194","20758479","1285","1534.31159643","0.837509149372"
"SL2.50ch11:20780226-20780694","89","20780226","20780694","468","1534.31159643","0.305022787476"
"SL2.50ch11:20785382-20786849","321","20785382","20786849","1467","1534.31159643","0.95612912228"
"SL2.50ch11:20798932-20803403","811","20798932","20803403","4471","1534.31159643","2.91401043334"
"SL2.50ch11:20806121-20808163","314","20806121","20808163","2042","1534.31159643","1.3308900257"
"SL2.50ch11:20813461-20813929","93","20813461","20813929","468","1534.31159643","0.305022787476"
"SL2.50ch11:20815127-20817429","424","20815127","20817429","2302","1534.31159643","1.50034712985"
"SL2.50ch11:20827370-20828506","246","20827370","20828506","1136","1534.31159643","0.740397193531"
"SL2.50ch11:20832239-20833742","313","20832239","20833742","1503","1534.31159643","0.979592413624"
"SL2.50ch11:20837860-20838896","229","20837860","20838896","1036","1534.31159643","0.675221384241"
"SL2.50ch11:20852200-20854359","450","20852200","20854359","2159","1534.31159643","1.40714572256"
"SL2.50ch11:21922290-21923240","1093","21922290","21923240","950","1534.31159643","0.619170188252"
"SL2.50ch11:21922554-21923164","1038","21922554","21923164","610","1534.31159643","0.397572436667"
"SL2.50ch11:22100621-22101537","198","22100621","22101537","916","1534.31159643","0.597010413094"
"SL2.50ch11:22560259-22560775","133","22560259","22560775","516","1534.31159643","0.336307175935"
"SL2.50ch11:23444510-23445113","125","23444510","23445113","603","1534.31159643","0.393010130017"
"SL2.50ch11:23447891-23448359","411","23447891","23448359","468","1534.31159643","0.305022787476"
"SL2.50ch11:23568763-23569351","139","23568763","23569351","588","1534.31159643","0.383233758623"
"SL2.50ch11:23839039-23840321","239","23839039","23840321","1282","1534.31159643","0.835553875094"
"SL2.50ch11:24012739-24014300","467","24012739","24014300","1561","1534.31159643","1.01739438301"
"SL2.50ch11:25050976-25051804","207","25050976","25051804","828","1534.31159643","0.539655700919"
"SL2.50ch11:25598236-25599066","152","25598236","25599066","830","1534.31159643","0.540959217104"
"SL2.50ch11:27896435-27896908","143","27896435","27896908","473","1534.31159643","0.30828157794"
"SL2.50ch11:28162925-28163513","133","28162925","28163513","588","1534.31159643","0.383233758623"
"SL2.50ch11:28248242-28248617","75","28248242","28248617","375","1534.31159643","0.244409284836"
"SL2.50ch11:28532238-28532809","118","28532238","28532809","571","1534.31159643","0.372153871044"
"SL2.50ch11:28734035-28734410","77","28734035","28734410","375","1534.31159643","0.244409284836"
"SL2.50ch11:30178500-30179077","150","30178500","30179077","577","1534.31159643","0.376064419601"
"SL2.50ch11:30180392-30180860","166","30180392","30180860","468","1534.31159643","0.305022787476"
"SL2.50ch11:30598125-30598615","1132","30598125","30598615","490","1534.31159643","0.319361465519"
"SL2.50ch11:30742549-30743611","270","30742549","30743611","1062","1534.31159643","0.692167094656"
"SL2.50ch11:30742846-30743467","202","30742846","30743467","621","1534.31159643","0.404741775689"
"SL2.50ch11:30981366-30982622","338","30981366","30982622","1256","1534.31159643","0.818608164678"
"SL2.50ch11:31073478-31074322","156","31073478","31074322","844","1534.31159643","0.550083830405"
"SL2.50ch11:31298298-31298916","4957","31298298","31298916","618","1534.31159643","0.40278650141"
"SL2.50ch11:31298333-31298901","4956","31298333","31298901","568","1534.31159643","0.370198596765"
"SL2.50ch11:31585927-31587699","7147","31585927","31587699","1772","1534.31159643","1.15491534061"
"SL2.50ch11:31585967-31587668","7144","31585967","31587668","1701","1534.31159643","1.10864051602"
"SL2.50ch11:32406457-32407315","536","32406457","32407315","858","1534.31159643","0.559208443706"
"SL2.50ch11:32409607-32410111","1015","32409607","32410111","504","1534.31159643","0.32848607882"
"SL2.50ch11:32416170-32416840","136","32416170","32416840","670","1534.31159643","0.436677922241"
"SL2.50ch11:32423926-32426840","26323","32423926","32426840","2914","1534.31159643","1.8992230827"
"SL2.50ch11:32424004-32426786","26318","32424004","32426786","2782","1534.31159643","1.81319101444"
"SL2.50ch11:33038626-33039160","279","33038626","33039160","534","1534.31159643","0.348038821607"
"SL2.50ch11:33038657-33039160","275","33038657","33039160","503","1534.31159643","0.327834320727"
"SL2.50ch11:34486737-34487207","96","34486737","34487207","470","1534.31159643","0.306326303662"
"SL2.50ch11:35491059-35491540","114","35491059","35491540","481","1534.31159643","0.313495642683"
"SL2.50ch11:36180587-36180962","71","36180587","36180962","375","1534.31159643","0.244409284836"
"SL2.50ch11:36311075-36311560","90","36311075","36311560","485","1534.31159643","0.316102675055"
"SL2.50ch11:37254852-37255227","76","37254852","37255227","375","1534.31159643","0.244409284836"
"SL2.50ch11:37661451-37661826","77","37661451","37661826","375","1534.31159643","0.244409284836"
"SL2.50ch11:37707177-37707552","76","37707177","37707552","375","1534.31159643","0.244409284836"
"SL2.50ch11:37761667-37762042","85","37761667","37762042","375","1534.31159643","0.244409284836"
"SL2.50ch11:38194523-38196143","795","38194523","38196143","1620","1534.31159643","1.05584811049"
"SL2.50ch11:38768420-38769019","149","38768420","38769019","599","1534.31159643","0.390403097645"
"SL2.50ch11:38960517-38961881","280","38960517","38961881","1364","1534.31159643","0.888998038711"
"SL2.50ch11:39472431-39472806","89","39472431","39472806","375","1534.31159643","0.244409284836"
"SL2.50ch11:40317148-40320530","15523","40317148","40320530","3382","1534.31159643","2.20424587018"
"SL2.50ch11:40317234-40320467","15523","40317234","40320467","3233","1534.31159643","2.10713391434"
"SL2.50ch11:40957143-40957785","124","40957143","40957785","642","1534.31159643","0.41842869564"
"SL2.50ch11:41400250-41400963","143","41400250","41400963","713","1534.31159643","0.464703520235"
"SL2.50ch11:42695683-42696164","97","42695683","42696164","481","1534.31159643","0.313495642683"
"SL2.50ch11:42792157-42792858","128","42792157","42792858","701","1534.31159643","0.456882423121"
"SL2.50ch11:42918205-42918703","848","42918205","42918703","498","1534.31159643","0.324575530263"
"SL2.50ch11:42918270-42918772","861","42918270","42918772","502","1534.31159643","0.327182562634"
"SL2.50ch11:43122296-43122671","178","43122296","43122671","375","1534.31159643","0.244409284836"
"SL2.50ch11:43658586-43659072","107","43658586","43659072","486","1534.31159643","0.316754433148"
"SL2.50ch11:44956600-44957298","150","44956600","44957298","698","1534.31159643","0.454927148842"
"SL2.50ch11:44961553-44962410","169","44961553","44962410","857","1534.31159643","0.558556685613"
"SL2.50ch11:45009815-45010925","189","45009815","45010925","1110","1534.31159643","0.723451483116"
"SL2.50ch11:45022509-45022978","102","45022509","45022978","469","1534.31159643","0.305674545569"
"SL2.50ch11:45027784-45028326","108","45027784","45028326","542","1534.31159643","0.35325288635"
"SL2.50ch11:45233322-45239721","37136","45233322","45239721","6399","1534.31159643","4.17060003645"
"SL2.50ch11:45233611-45239698","37120","45233611","45239698","6087","1534.31159643","3.96725151146"
"SL2.50ch11:45246230-45248244","10199","45246230","45248244","2014","1534.31159643","1.31264079909"
"SL2.50ch11:45246271-45248409","10200","45246271","45248409","2138","1534.31159643","1.39345880261"
"SL2.50ch11:45250531-45251283","8583","45250531","45251283","752","1534.31159643","0.490122085858"
"SL2.50ch11:45250610-45251298","8569","45250610","45251298","688","1534.31159643","0.448409567913"
"SL2.50ch11:45252807-45254478","8668","45252807","45254478","1671","1534.31159643","1.08908777323"
"SL2.50ch11:45252841-45254425","8530","45252841","45254425","1584","1534.31159643","1.03238481915"
"SL2.50ch11:45255681-45260487","26833","45255681","45260487","4806","1534.31159643","3.13234939446"
"SL2.50ch11:45255682-45260461","26833","45255682","45260461","4779","1534.31159643","3.11475192595"
"SL2.50ch11:45336898-45338922","9766","45336898","45338922","2024","1534.31159643","1.31915838002"
"SL2.50ch11:45336998-45338797","9747","45336998","45338797","1799","1534.31159643","1.17251280912"
"SL2.50ch11:45339523-45342194","12584","45339523","45342194","2671","1534.31159643","1.74084586613"
"SL2.50ch11:45339954-45342124","12516","45339954","45342124","2170","1534.31159643","1.41431506159"
"SL2.50ch11:45343872-45345788","10645","45343872","45345788","1916","1534.31159643","1.24876850599"
"SL2.50ch11:45343920-45345749","10548","45343920","45345749","1829","1534.31159643","1.19206555191"
"SL2.50ch11:45350079-45351514","7000","45350079","45351514","1435","1534.31159643","0.935272863307"
"SL2.50ch11:45350094-45351490","7000","45350094","45351490","1396","1534.31159643","0.909854297684"
"SL2.50ch11:45354466-45356001","8215","45354466","45356001","1535","1534.31159643","1.0004486726"
"SL2.50ch11:45354488-45356004","8215","45354488","45356004","1516","1534.31159643","0.988065268832"
"SL2.50ch11:45357881-45358722","3374","45357881","45358722","841","1534.31159643","0.548128556126"
"SL2.50ch11:45357909-45358712","3374","45357909","45358712","803","1534.31159643","0.523361748596"
"SL2.50ch11:45363862-45368020","29896","45363862","45368020","4158","1534.31159643","2.71001015027"
"SL2.50ch11:45363948-45368134","29849","45363948","45368134","4186","1534.31159643","2.72825937687"
"SL2.50ch11:45371051-45372719","4585","45371051","45372719","1668","1534.31159643","1.08713249895"
"SL2.50ch11:45371067-45372307","4353","45371067","45372307","1240","1534.31159643","0.808180035192"
"SL2.50ch11:45374326-45377827","16344","45374326","45377827","3501","1534.31159643","2.28180508323"
"SL2.50ch11:45374344-45377693","16331","45374344","45377693","3349","1534.31159643","2.18273785311"
"SL2.50ch11:45386703-45388297","10710","45386703","45388297","1594","1534.31159643","1.03890240008"
"SL2.50ch11:45386738-45388227","10619","45386738","45388227","1489","1534.31159643","0.970467800323"
"SL2.50ch11:45390128-45391152","6508","45390128","45391152","1024","1534.31159643","0.667400287126"
"SL2.50ch11:45390135-45391197","6465","45390135","45391197","1062","1534.31159643","0.692167094656"
"SL2.50ch11:45392566-45394336","7203","45392566","45394336","1770","1534.31159643","1.15361182443"
"SL2.50ch11:45392780-45394226","7133","45392780","45394226","1446","1534.31159643","0.942442202329"
"SL2.50ch11:45396292-45396782","528","45396292","45396782","490","1534.31159643","0.319361465519"
"SL2.50ch11:45397271-45397986","2899","45397271","45397986","715","1534.31159643","0.466007036421"
"SL2.50ch11:45400835-45401237","374","45400835","45401237","402","1534.31159643","0.262006753345"
"SL2.50ch11:45400835-45401304","374","45400835","45401304","469","1534.31159643","0.305674545569"
"SL2.50ch11:45403889-45404808","930","45403889","45404808","919","1534.31159643","0.598965687372"
"SL2.50ch11:45403903-45404547","912","45403903","45404547","644","1534.31159643","0.419732211826"
"SL2.50ch11:45406044-45406720","419","45406044","45406720","676","1534.31159643","0.440588470798"
"SL2.50ch11:45406107-45406635","401","45406107","45406635","528","1534.31159643","0.34412827305"
"SL2.50ch11:45411470-45413031","7390","45411470","45413031","1561","1534.31159643","1.01739438301"
"SL2.50ch11:45411477-45413071","7390","45411477","45413071","1594","1534.31159643","1.03890240008"
"SL2.50ch11:45417254-45418460","2694","45417254","45418460","1206","1534.31159643","0.786020260034"
"SL2.50ch11:45417317-45418319","2654","45417317","45418319","1002","1534.31159643","0.653061609083"
"SL2.50ch11:45422580-45423774","6068","45422580","45423774","1194","1534.31159643","0.778199162919"
"SL2.50ch11:45422586-45423618","6066","45422586","45423618","1032","1534.31159643","0.67261435187"
"SL2.50ch11:45440165-45440879","2523","45440165","45440879","714","1534.31159643","0.465355278328"
"SL2.50ch11:45440169-45441052","2546","45440169","45441052","883","1534.31159643","0.575502396028"
"SL2.50ch11:45444323-45444945","1822","45444323","45444945","622","1534.31159643","0.405393533782"
"SL2.50ch11:45444356-45444858","1822","45444356","45444858","502","1534.31159643","0.327182562634"
"SL2.50ch11:45446552-45449056","10481","45446552","45449056","2504","1534.31159643","1.63200226461"
"SL2.50ch11:45446644-45449027","10413","45446644","45449027","2383","1534.31159643","1.55313953537"
"SL2.50ch11:45450191-45451961","5274","45450191","45451961","1770","1534.31159643","1.15361182443"
"SL2.50ch11:45450196-45452029","5270","45450196","45452029","1833","1534.31159643","1.19467258428"
"SL2.50ch11:45459797-45460432","4190","45459797","45460432","635","1534.31159643","0.41386638899"
"SL2.50ch11:45459803-45460439","4190","45459803","45460439","636","1534.31159643","0.414518147082"
"SL2.50ch11:45461227-45462145","2841","45461227","45462145","918","1534.31159643","0.598313929279"
"SL2.50ch11:45461260-45462081","2841","45461260","45462081","821","1534.31159643","0.535093394268"
"SL2.50ch11:45463519-45465554","7085","45463519","45465554","2035","1534.31159643","1.32632771905"
"SL2.50ch11:45463548-45465554","7084","45463548","45465554","2006","1534.31159643","1.30742673435"
"SL2.50ch11:45475461-45476498","1324","45475461","45476498","1037","1534.31159643","0.675873142334"
"SL2.50ch11:45475497-45476105","1244","45475497","45476105","608","1534.31159643","0.396268920481"
"SL2.50ch11:45556112-45556600","102","45556112","45556600","488","1534.31159643","0.318057949334"
"SL2.50ch11:45560372-45561169","161","45560372","45561169","797","1534.31159643","0.519451200039"
"SL2.50ch11:45581334-45581709","72","45581334","45581709","375","1534.31159643","0.244409284836"
"SL2.50ch11:45626619-45626994","72","45626619","45626994","375","1534.31159643","0.244409284836"
"SL2.50ch11:45864853-45865441","147","45864853","45865441","588","1534.31159643","0.383233758623"
"SL2.50ch11:48465837-48466212","76","48465837","48466212","375","1534.31159643","0.244409284836"
"SL2.50ch11:48691951-48692326","220","48691951","48692326","375","1534.31159643","0.244409284836"
"SL2.50ch11:48717882-48719513","8994","48717882","48719513","1631","1534.31159643","1.06301744951"
"SL2.50ch11:48717894-48719621","9000","48717894","48719621","1727","1534.31159643","1.12558622643"
"SL2.50ch11:48869778-48870955","28251","48869778","48870955","1177","1534.31159643","0.76711927534"
"SL2.50ch11:48869826-48871305","28280","48869826","48871305","1479","1534.31159643","0.963950219394"
"SL2.50ch11:48874032-48874407","70","48874032","48874407","375","1534.31159643","0.244409284836"
"SL2.50ch11:48951925-48952408","212","48951925","48952408","483","1534.31159643","0.314799158869"
"SL2.50ch11:49617710-49620670","9778","49617710","49620670","2960","1534.31159643","1.92920395497"
"SL2.50ch11:49617835-49625590","30943","49617835","49625590","7755","1534.31159643","5.05438401042"
"SL2.50ch11:49621245-49625665","21119","49621245","49625665","4420","1534.31159643","2.8807707706"
"SL2.50ch11:49629321-49636174","20903","49629321","49636174","6853","1534.31159643","4.46649821062"
"SL2.50ch11:49629371-49631187","6603","49629371","49631187","1816","1534.31159643","1.1835926967"
"SL2.50ch11:49632467-49633328","4406","49632467","49633328","861","1534.31159643","0.561163717984"
"SL2.50ch11:49633983-49636026","9104","49633983","49636026","2043","1534.31159643","1.33154178379"
"SL2.50ch11:49638648-49644092","8147","49638648","49644092","5444","1534.31159643","3.54817105773"
"SL2.50ch11:49638816-49640638","4337","49638816","49640638","1822","1534.31159643","1.18750324526"
"SL2.50ch11:49641566-49642532","2361","49641566","49642532","966","1534.31159643","0.629598317738"
"SL2.50ch11:49643051-49643844","988","49643051","49643844","793","1534.31159643","0.516844167667"
"SL2.50ch11:49647978-49649592","6535","49647978","49649592","1614","1534.31159643","1.05193756194"
"SL2.50ch11:49648420-49649437","6482","49648420","49649437","1017","1534.31159643","0.662837980476"
"SL2.50ch11:50256207-50256968","5228","50256207","50256968","761","1534.31159643","0.495987908695"
"SL2.50ch11:50256234-50256904","5223","50256234","50256904","670","1534.31159643","0.436677922241"
"SL2.50ch11:50269930-50270332","418","50269930","50270332","402","1534.31159643","0.262006753345"
"SL2.50ch11:50794388-50795063","759","50794388","50795063","675","1534.31159643","0.439936712705"
"SL2.50ch11:50794510-50795000","742","50794510","50795000","490","1534.31159643","0.319361465519"
"SL2.50ch11:51013007-51013677","144","51013007","51013677","670","1534.31159643","0.436677922241"
"SL2.50ch11:51640950-51641426","153","51640950","51641426","476","1534.31159643","0.310236852219"
"SL2.50ch11:51640969-51641482","151","51640969","51641482","513","1534.31159643","0.334351901656"
"SL2.50ch11:53074910-53075381","228","53074910","53075381","471","1534.31159643","0.306978061754"
"SL2.50ch11:53587494-53587869","200","53587494","53587869","375","1534.31159643","0.244409284836"
"SL2.50ch11:55434577-55435600","463","55434577","55435600","1023","1534.31159643","0.666748529034"
"SL2.50ch11:55434683-55435658","435","55434683","55435658","975","1534.31159643","0.635464140574"
"SL2.50ch11:5768911-5769313","563","5768911","5769313","402","1534.31159643","0.262006753345"
"SL2.50ch11:7156086-7156752","325","7156086","7156752","666","1534.31159643","0.434070889869"
"SL2.50ch11:7156309-7156711","291","7156309","7156711","402","1534.31159643","0.262006753345"
"SL2.50ch11:7159693-7160095","331","7159693","7160095","402","1534.31159643","0.262006753345"
"SL2.50ch11:7159713-7160182","348","7159713","7160182","469","1534.31159643","0.305674545569"
"SL2.50ch11:8237824-8238485","151","8237824","8238485","661","1534.31159643","0.430812099405"
"SL2.50ch11:8470492-8472596","1043","8470492","8472596","2104","1534.31159643","1.37129902746"
"SL2.50ch11:8470516-8472378","1006","8470516","8472378","1862","1534.31159643","1.21357356897"
"SL2.50ch11:8479927-8480850","210","8479927","8480850","923","1534.31159643","0.601572719744"
"SL2.50ch11:8488520-8488993","104","8488520","8488993","473","1534.31159643","0.30828157794"
"SL2.50ch11:8509929-8510717","281","8509929","8510717","788","1534.31159643","0.513585377203"
"SL2.50ch11:8509954-8510688","278","8509954","8510688","734","1534.31159643","0.478390440186"
"SL2.50ch11:8517008-8517476","212","8517008","8517476","468","1534.31159643","0.305022787476"
"SL2.50ch11:9484220-9484969","235","9484220","9484969","749","1534.31159643","0.48816681158"
"SL2.50ch12:11125600-11126165","1670","11125600","11126165","565","1534.31159643","0.368243322487"
"SL2.50ch12:11702022-11702636","113","11702022","11702636","614","1534.31159643","0.400179469039"
"SL2.50ch12:12049577-12050049","107","12049577","12050049","472","1534.31159643","0.307629819847"
"SL2.50ch12:12502481-12502856","75","12502481","12502856","375","1534.31159643","0.244409284836"
"SL2.50ch12:1281241-1282093","13740","1281241","1282093","852","1534.31159643","0.555297895148"
"SL2.50ch12:1281255-1282012","13721","1281255","1282012","757","1534.31159643","0.493380876323"
"SL2.50ch12:13093684-13094156","150","13093684","13094156","472","1534.31159643","0.307629819847"
"SL2.50ch12:13250747-13251330","785","13250747","13251330","583","1534.31159643","0.379974968159"
"SL2.50ch12:13409476-13410083","179","13409476","13410083","607","1534.31159643","0.395617162388"
"SL2.50ch12:15633989-15634957","356","15633989","15634957","968","1534.31159643","0.630901833924"
"SL2.50ch12:16497032-16498359","293","16497032","16498359","1327","1534.31159643","0.864882989274"
"SL2.50ch12:16584261-16584887","130","16584261","16584887","626","1534.31159643","0.408000566153"
"SL2.50ch12:16612583-16613064","95","16612583","16613064","481","1534.31159643","0.313495642683"
"SL2.50ch12:17016267-17017171","212","17016267","17017171","904","1534.31159643","0.589189315979"
"SL2.50ch12:17284165-17285287","261","17284165","17285287","1122","1534.31159643","0.73127258023"
"SL2.50ch12:17316112-17316705","118","17316112","17316705","593","1534.31159643","0.386492549088"
"SL2.50ch12:17330786-17334032","836","17330786","17334032","3246","1534.31159643","2.11560676954"
"SL2.50ch12:17335049-17335912","201","17335049","17335912","863","1534.31159643","0.56246723417"
"SL2.50ch12:17336362-17340703","1035","17336362","17340703","4341","1534.31159643","2.82928188127"
"SL2.50ch12:17343133-17343956","201","17343133","17343956","823","1534.31159643","0.536396910454"
"SL2.50ch12:17344734-17347336","617","17344734","17347336","2602","1534.31159643","1.69587455772"
"SL2.50ch12:17369690-17375684","1354","17369690","17375684","5994","1534.31159643","3.90663800882"
"SL2.50ch12:17454017-17455033","199","17454017","17455033","1016","1534.31159643","0.662186222383"
"SL2.50ch12:17462286-17463613","638","17462286","17463613","1327","1534.31159643","0.864882989274"
"SL2.50ch12:17462782-17463618","565","17462782","17463618","836","1534.31159643","0.544869765662"
"SL2.50ch12:17468858-17470321","1269","17468858","17470321","1463","1534.31159643","0.953522089908"
"SL2.50ch12:17469011-17470277","1250","17469011","17470277","1266","1534.31159643","0.825125745607"
"SL2.50ch12:17570240-17573194","750","17570240","17573194","2954","1534.31159643","1.92529340642"
"SL2.50ch12:17570388-17571221","311","17570388","17571221","833","1534.31159643","0.542914491383"
"SL2.50ch12:17582615-17583813","519","17582615","17583813","1198","1534.31159643","0.78080619529"
"SL2.50ch12:17582628-17583817","519","17582628","17583817","1189","1534.31159643","0.774940372454"
"SL2.50ch12:17584490-17586478","1302","17584490","17586478","1988","1534.31159643","1.29569508868"
"SL2.50ch12:17584580-17586620","1328","17584580","17586620","2040","1534.31159643","1.32958650951"
"SL2.50ch12:17593329-17593704","75","17593329","17593704","375","1534.31159643","0.244409284836"
"SL2.50ch12:17598661-17599862","248","17598661","17599862","1201","1534.31159643","0.782761469569"
"SL2.50ch12:17598690-17599092","158","17598690","17599092","402","1534.31159643","0.262006753345"
"SL2.50ch12:17600360-17602099","343","17600360","17602099","1739","1534.31159643","1.13340732355"
"SL2.50ch12:17605325-17606548","247","17605325","17606548","1223","1534.31159643","0.797100147613"
"SL2.50ch12:17770873-17771640","158","17770873","17771640","767","1534.31159643","0.499898457252"
"SL2.50ch12:19410326-19411466","210","19410326","19411466","1140","1534.31159643","0.743004225902"
"SL2.50ch12:20029637-20030318","135","20029637","20030318","681","1534.31159643","0.443847261263"
"SL2.50ch12:20970666-20971159","91","20970666","20971159","493","1534.31159643","0.321316739798"
"SL2.50ch12:21136812-21137445","128","21136812","21137445","633","1534.31159643","0.412562872804"
"SL2.50ch12:21139397-21144310","1148","21139397","21144310","4913","1534.31159643","3.2020875104"
"SL2.50ch12:21395345-21396276","210","21395345","21396276","931","1534.31159643","0.606786784487"
"SL2.50ch12:22083326-22083847","111","22083326","22083847","521","1534.31159643","0.339565966399"
"SL2.50ch12:22466405-22470000","1708","22466405","22470000","3595","1534.31159643","2.34307034396"
"SL2.50ch12:22467023-22469411","1496","22467023","22469411","2388","1534.31159643","1.55639832584"
"SL2.50ch12:22471365-22472124","331","22471365","22472124","759","1534.31159643","0.494684392509"
"SL2.50ch12:22471532-22472141","305","22471532","22472141","609","1534.31159643","0.396920678574"
"SL2.50ch12:22476830-22479067","857","22476830","22479067","2237","1534.31159643","1.45798285381"
"SL2.50ch12:22476972-22477998","690","22476972","22477998","1026","1534.31159643","0.668703803312"
"SL2.50ch12:22568860-22569567","177","22568860","22569567","707","1534.31159643","0.460792971678"
"SL2.50ch12:22571503-22572833","546","22571503","22572833","1330","1534.31159643","0.866838263553"
"SL2.50ch12:22571716-22572716","530","22571716","22572716","1000","1534.31159643","0.651758092897"
"SL2.50ch12:22575892-22577134","462","22575892","22577134","1242","1534.31159643","0.809483551378"
"SL2.50ch12:22575916-22577049","430","22575916","22577049","1133","1534.31159643","0.738441919252"
"SL2.50ch12:22587644-22589017","551","22587644","22589017","1373","1534.31159643","0.894863861547"
"SL2.50ch12:22587685-22588533","478","22587685","22588533","848","1534.31159643","0.552690862777"
"SL2.50ch12:22599424-22600377","410","22599424","22600377","953","1534.31159643","0.621125462531"
"SL2.50ch12:22607887-22609038","211","22607887","22609038","1151","1534.31159643","0.750173564924"
"SL2.50ch12:22609875-22611919","419","22609875","22611919","2044","1534.31159643","1.33219354188"
"SL2.50ch12:22619667-22621067","788","22619667","22621067","1400","1534.31159643","0.912461330056"
"SL2.50ch12:22619712-22621059","788","22619712","22621059","1347","1534.31159643","0.877918151132"
"SL2.50ch12:22622896-22624203","772","22622896","22624203","1307","1534.31159643","0.851847827416"
"SL2.50ch12:22622931-22624229","772","22622931","22624229","1298","1534.31159643","0.84598200458"
"SL2.50ch12:22626450-22627721","402","22626450","22627721","1271","1534.31159643","0.828384536072"
"SL2.50ch12:22626749-22627746","331","22626749","22627746","997","1534.31159643","0.649802818618"
"SL2.50ch12:22636213-22637123","549","22636213","22637123","910","1534.31159643","0.593099864536"
"SL2.50ch12:22636416-22637156","519","22636416","22637156","740","1534.31159643","0.482300988744"
"SL2.50ch12:22638777-22640115","784","22638777","22640115","1338","1534.31159643","0.872052328296"
"SL2.50ch12:22638777-22640151","784","22638777","22640151","1374","1534.31159643","0.89551561964"
"SL2.50ch12:22640807-22641801","417","22640807","22641801","994","1534.31159643","0.647847544339"
"SL2.50ch12:22640877-22641692","407","22640877","22641692","815","1534.31159643","0.531182845711"
"SL2.50ch12:22642968-22644320","731","22642968","22644320","1352","1534.31159643","0.881176941597"
"SL2.50ch12:22642977-22644344","731","22642977","22644344","1367","1534.31159643","0.89095331299"
"SL2.50ch12:22647671-22649157","614","22647671","22649157","1486","1534.31159643","0.968512526045"
"SL2.50ch12:22647686-22649146","614","22647686","22649146","1460","1534.31159643","0.951566815629"
"SL2.50ch12:22653598-22653973","73","22653598","22653973","375","1534.31159643","0.244409284836"
"SL2.50ch12:22661664-22664212","915","22661664","22664212","2548","1534.31159643","1.6606796207"
"SL2.50ch12:22663015-22663628","370","22663015","22663628","613","1534.31159643","0.399527710946"
"SL2.50ch12:22698656-22699443","207","22698656","22699443","787","1534.31159643","0.51293361911"
"SL2.50ch12:22698712-22699544","223","22698712","22699544","832","1534.31159643","0.54226273329"
"SL2.50ch12:22729497-22736133","1607","22729497","22736133","6636","1534.31159643","4.32506670446"
"SL2.50ch12:22756163-22757148","172","22756163","22757148","985","1534.31159643","0.641981721503"
"SL2.50ch12:22765306-22770404","1430","22765306","22770404","5098","1534.31159643","3.32266275759"
"SL2.50ch12:22770993-22773736","707","22770993","22773736","2743","1534.31159643","1.78777244882"
"SL2.50ch12:22791466-22791841","78","22791466","22791841","375","1534.31159643","0.244409284836"
"SL2.50ch12:23358906-23359281","73","23358906","23359281","375","1534.31159643","0.244409284836"
"SL2.50ch12:24078701-24079560","11274","24078701","24079560","859","1534.31159643","0.559860201798"
"SL2.50ch12:24169458-24169930","87","24169458","24169930","472","1534.31159643","0.307629819847"
"SL2.50ch12:26175653-26176028","88","26175653","26176028","375","1534.31159643","0.244409284836"
"SL2.50ch12:26321657-26322032","83","26321657","26322032","375","1534.31159643","0.244409284836"
"SL2.50ch12:26463352-26463727","87","26463352","26463727","375","1534.31159643","0.244409284836"
"SL2.50ch12:26867044-26867419","68","26867044","26867419","375","1534.31159643","0.244409284836"
"SL2.50ch12:27365076-27365798","160","27365076","27365798","722","1534.31159643","0.470569343072"
"SL2.50ch12:29229996-29231202","263","29229996","29231202","1206","1534.31159643","0.786020260034"
"SL2.50ch12:29494451-29494826","77","29494451","29494826","375","1534.31159643","0.244409284836"
"SL2.50ch12:30017705-30018208","3711","30017705","30018208","503","1534.31159643","0.327834320727"
"SL2.50ch12:31058653-31059028","83","31058653","31059028","375","1534.31159643","0.244409284836"
"SL2.50ch12:3209901-3210407","392","3209901","3210407","506","1534.31159643","0.329789595006"
"SL2.50ch12:32393559-32395295","298","32393559","32395295","1736","1534.31159643","1.13145204927"
"SL2.50ch12:32491718-32492238","120","32491718","32492238","520","1534.31159643","0.338914208306"
"SL2.50ch12:32676301-32676676","97","32676301","32676676","375","1534.31159643","0.244409284836"
"SL2.50ch12:33401409-33401784","73","33401409","33401784","375","1534.31159643","0.244409284836"
"SL2.50ch12:33815406-33815808","703","33815406","33815808","402","1534.31159643","0.262006753345"
"SL2.50ch12:33827523-33828515","307","33827523","33828515","992","1534.31159643","0.646544028154"
"SL2.50ch12:33961197-33961572","87","33961197","33961572","375","1534.31159643","0.244409284836"
"SL2.50ch12:34179760-34180304","106","34179760","34180304","544","1534.31159643","0.354556402536"
"SL2.50ch12:34295103-34305798","4578","34295103","34305798","10695","1534.31159643","6.97055280353"
"SL2.50ch12:34306193-34319398","5055","34306193","34319398","13205","1534.31159643","8.6064656167"
"SL2.50ch12:35956067-35956540","89","35956067","35956540","473","1534.31159643","0.30828157794"
"SL2.50ch12:36092612-36136248","15401","36092612","36136248","43636","1534.31159643","28.4401161416"
"SL2.50ch12:36147721-36149541","360","36147721","36149541","1820","1534.31159643","1.18619972907"
"SL2.50ch12:36168713-36169186","101","36168713","36169186","473","1534.31159643","0.30828157794"
"SL2.50ch12:36172679-36176703","952","36172679","36176703","4024","1534.31159643","2.62267456582"
"SL2.50ch12:36178209-36178584","85","36178209","36178584","375","1534.31159643","0.244409284836"
"SL2.50ch12:36179078-36182664","727","36179078","36182664","3586","1534.31159643","2.33720452113"
"SL2.50ch12:36192610-36197008","815","36192610","36197008","4398","1534.31159643","2.86643209256"
"SL2.50ch12:36197435-36198793","256","36197435","36198793","1358","1534.31159643","0.885087490154"
"SL2.50ch12:36213291-36218331","997","36213291","36218331","5040","1534.31159643","3.2848607882"
"SL2.50ch12:36218739-36219696","176","36218739","36219696","957","1534.31159643","0.623732494902"
"SL2.50ch12:36223379-36226257","536","36223379","36226257","2878","1534.31159643","1.87575979136"
"SL2.50ch12:36240623-36241559","166","36240623","36241559","936","1534.31159643","0.610045574951"
"SL2.50ch12:36242452-36243295","197","36242452","36243295","843","1534.31159643","0.549432072312"
"SL2.50ch12:36243674-36246207","462","36243674","36246207","2533","1534.31159643","1.65090324931"
"SL2.50ch12:36247013-36250322","608","36247013","36250322","3309","1534.31159643","2.1566675294"
"SL2.50ch12:37504894-37505472","146","37504894","37505472","578","1534.31159643","0.376716177694"
"SL2.50ch12:37679988-37680515","1035","37679988","37680515","527","1534.31159643","0.343476514957"
"SL2.50ch12:37680016-37680506","1035","37680016","37680506","490","1534.31159643","0.319361465519"
"SL2.50ch12:38096537-38098487","363","38096537","38098487","1950","1534.31159643","1.27092828115"
"SL2.50ch12:39449893-39450478","142","39449893","39450478","585","1534.31159643","0.381278484345"
"SL2.50ch12:42006160-42006629","96","42006160","42006629","469","1534.31159643","0.305674545569"
"SL2.50ch12:42325906-42326396","116","42325906","42326396","490","1534.31159643","0.319361465519"
"SL2.50ch12:42620046-42620621","111","42620046","42620621","575","1534.31159643","0.374760903416"
"SL2.50ch12:4279797-4283741","6193","4279797","4283741","3944","1534.31159643","2.57053391839"
"SL2.50ch12:4279848-4283783","6191","4279848","4283783","3935","1534.31159643","2.56466809555"
"SL2.50ch12:4296541-4297125","134","4296541","4297125","584","1534.31159643","0.380626726252"
"SL2.50ch12:4297709-4298629","361","4297709","4298629","920","1534.31159643","0.599617445465"
"SL2.50ch12:4300147-4301817","367","4300147","4301817","1670","1534.31159643","1.08843601514"
"SL2.50ch12:4302871-4303457","190","4302871","4303457","586","1534.31159643","0.381930242438"
"SL2.50ch12:4308732-4310108","357","4308732","4310108","1376","1534.31159643","0.896819135826"
"SL2.50ch12:4311879-4312254","85","4311879","4312254","375","1534.31159643","0.244409284836"
"SL2.50ch12:4328906-4330117","503","4328906","4330117","1211","1534.31159643","0.789279050498"
"SL2.50ch12:4335353-4336360","404","4335353","4336360","1007","1534.31159643","0.656320399547"
"SL2.50ch12:4350346-4351076","406","4350346","4351076","730","1534.31159643","0.475783407815"
"SL2.50ch12:4350355-4351379","463","4350355","4351379","1024","1534.31159643","0.667400287126"
"SL2.50ch12:45737991-45738393","543","45737991","45738393","402","1534.31159643","0.262006753345"
"SL2.50ch12:46125872-46126868","185","46125872","46126868","996","1534.31159643","0.649151060525"
"SL2.50ch12:48944674-48945049","84","48944674","48945049","375","1534.31159643","0.244409284836"
"SL2.50ch12:49282718-49283274","3423","49282718","49283274","556","1534.31159643","0.362377499651"
"SL2.50ch12:49661847-49662603","7088","49661847","49662603","756","1534.31159643","0.49272911823"
"SL2.50ch12:49661919-49662621","7081","49661919","49662621","702","1534.31159643","0.457534181214"
"SL2.50ch12:49894365-49895056","154","49894365","49895056","691","1534.31159643","0.450364842192"
"SL2.50ch12:50172170-50173835","509","50172170","50173835","1665","1534.31159643","1.08517722467"
"SL2.50ch12:50172603-50173705","413","50172603","50173705","1102","1534.31159643","0.718237418372"
"SL2.50ch12:5094055-5094457","975","5094055","5094457","402","1534.31159643","0.262006753345"
"SL2.50ch12:51036441-51037152","184","51036441","51037152","711","1534.31159643","0.46340000405"
"SL2.50ch12:51038594-51038996","470","51038594","51038996","402","1534.31159643","0.262006753345"
"SL2.50ch12:51040250-51042235","2506","51040250","51042235","1985","1534.31159643","1.2937398144"
"SL2.50ch12:51040466-51041177","1554","51040466","51041177","711","1534.31159643","0.46340000405"
"SL2.50ch12:51041623-51042025","842","51041623","51042025","402","1534.31159643","0.262006753345"
"SL2.50ch12:51073475-51073965","444","51073475","51073965","490","1534.31159643","0.319361465519"
"SL2.50ch12:51073582-51074050","437","51073582","51074050","468","1534.31159643","0.305022787476"
"SL2.50ch12:51538054-51538685","576","51538054","51538685","631","1534.31159643","0.411259356618"
"SL2.50ch12:51538141-51538905","595","51538141","51538905","764","1534.31159643","0.497943182973"
"SL2.50ch12:51544216-51545827","719","51544216","51545827","1611","1534.31159643","1.04998228766"
"SL2.50ch12:51544315-51545030","606","51544315","51545030","715","1534.31159643","0.466007036421"
"SL2.50ch12:51597168-51597798","4653","51597168","51597798","630","1534.31159643","0.410607598525"
"SL2.50ch12:51597234-51597796","4650","51597234","51597796","562","1534.31159643","0.366288048208"
"SL2.50ch12:5192094-5192691","122","5192094","5192691","597","1534.31159643","0.389099581459"
"SL2.50ch12:5194273-5194840","116","5194273","5194840","567","1534.31159643","0.369546838673"
"SL2.50ch12:52831357-52831732","86","52831357","52831732","375","1534.31159643","0.244409284836"
"SL2.50ch12:52832186-52833138","167","52832186","52833138","952","1534.31159643","0.620473704438"
"SL2.50ch12:53994766-53995245","108","53994766","53995245","479","1534.31159643","0.312192126498"
"SL2.50ch12:54088521-54089007","85","54088521","54089007","486","1534.31159643","0.316754433148"
"SL2.50ch12:54256028-54257444","856","54256028","54257444","1416","1534.31159643","0.922889459542"
"SL2.50ch12:54273685-54274175","5846","54273685","54274175","490","1534.31159643","0.319361465519"
"SL2.50ch12:54273746-54274315","5855","54273746","54274315","569","1534.31159643","0.370850354858"
"SL2.50ch12:54304479-54305831","758","54304479","54305831","1352","1534.31159643","0.881176941597"
"SL2.50ch12:54315136-54316473","535","54315136","54316473","1337","1534.31159643","0.871400570203"
"SL2.50ch12:54318549-54319669","472","54318549","54319669","1120","1534.31159643","0.729969064045"
"SL2.50ch12:54672271-54672742","107","54672271","54672742","471","1534.31159643","0.306978061754"
"SL2.50ch12:55224550-55225126","262","55224550","55225126","576","1534.31159643","0.375412661509"
"SL2.50ch12:55224649-55225051","257","55224649","55225051","402","1534.31159643","0.262006753345"
"SL2.50ch12:55407597-55408072","102","55407597","55408072","475","1534.31159643","0.309585094126"
"SL2.50ch12:56908861-56910045","17350","56908861","56910045","1184","1534.31159643","0.77168158199"
"SL2.50ch12:56909105-56910099","17342","56909105","56910099","994","1534.31159643","0.647847544339"
"SL2.50ch12:57042969-57043783","155","57042969","57043783","814","1534.31159643","0.530531087618"
"SL2.50ch12:57552167-57553571","446","57552167","57553571","1404","1534.31159643","0.915068362427"
"SL2.50ch12:57600573-57601099","106","57600573","57601099","526","1534.31159643","0.342824756864"
"SL2.50ch12:57621664-57622367","1423","57621664","57622367","703","1534.31159643","0.458185939307"
"SL2.50ch12:57621722-57622278","1414","57621722","57622278","556","1534.31159643","0.362377499651"
"SL2.50ch12:58258318-58258901","113","58258318","58258901","583","1534.31159643","0.379974968159"
"SL2.50ch12:5831512-5832564","241","5831512","5832564","1052","1534.31159643","0.685649513728"
"SL2.50ch12:58814694-58815220","105","58814694","58815220","526","1534.31159643","0.342824756864"
"SL2.50ch12:59137510-59138124","2346","59137510","59138124","614","1534.31159643","0.400179469039"
"SL2.50ch12:59550555-59551646","191","59550555","59551646","1091","1534.31159643","0.71106807935"
"SL2.50ch12:60389381-60390063","122","60389381","60390063","682","1534.31159643","0.444499019356"
"SL2.50ch12:60463834-60464740","203","60463834","60464740","906","1534.31159643","0.590492832165"
"SL2.50ch12:60486630-60488203","376","60486630","60488203","1573","1534.31159643","1.02521548013"
"SL2.50ch12:60490968-60492417","295","60490968","60492417","1449","1534.31159643","0.944397476608"
"SL2.50ch12:60515989-60519415","728","60515989","60519415","3426","1534.31159643","2.23292322626"
"SL2.50ch12:60519967-60520916","211","60519967","60520916","949","1534.31159643","0.618518430159"
"SL2.50ch12:60523099-60526344","674","60523099","60526344","3245","1534.31159643","2.11495501145"
"SL2.50ch12:60531411-60533781","471","60531411","60533781","2370","1534.31159643","1.54466668017"
"SL2.50ch12:60539242-60543562","904","60539242","60543562","4320","1534.31159643","2.81559496131"
"SL2.50ch12:60544224-60545183","180","60544224","60545183","959","1534.31159643","0.625036011088"
"SL2.50ch12:60545801-60574312","9812","60545801","60574312","28511","1534.31159643","18.5822749866"
"SL2.50ch12:60626176-60631414","1582","60626176","60631414","5238","1534.31159643","3.41390889059"
"SL2.50ch12:60697245-60717814","7556","60697245","60717814","20569","1534.31159643","13.4060122128"
"SL2.50ch12:60709767-60717648","3006","60709767","60717648","7881","1534.31159643","5.13650553012"
"SL2.50ch12:60718776-60737505","7785","60718776","60737505","18729","1534.31159643","12.2067773219"
"SL2.50ch12:60736444-60737079","289","60736444","60737079","635","1534.31159643","0.41386638899"
"SL2.50ch12:60945362-60945951","151","60945362","60945951","589","1534.31159643","0.383885516716"
"SL2.50ch12:60947730-60949734","9563","60947730","60949734","2004","1534.31159643","1.30612321817"
"SL2.50ch12:60947758-60951646","10224","60947758","60951646","3888","1534.31159643","2.53403546518"
"SL2.50ch12:61002478-61005865","4525","61002478","61005865","3387","1534.31159643","2.20750466064"
"SL2.50ch12:61003004-61005586","4388","61003004","61005586","2582","1534.31159643","1.68283939586"
"SL2.50ch12:61476812-61480913","709","61476812","61480913","4101","1534.31159643","2.67285993897"
"SL2.50ch12:61617077-61618674","364","61617077","61618674","1597","1534.31159643","1.04085767436"
"SL2.50ch12:61625619-61633960","2368","61625619","61633960","8341","1534.31159643","5.43631425285"
"SL2.50ch12:61636552-61659148","7564","61636552","61659148","22596","1534.31159643","14.7271258671"
"SL2.50ch12:61650844-61651914","580","61650844","61651914","1070","1534.31159643","0.6973811594"
"SL2.50ch12:6204133-6204665","115","6204133","6204665","532","1534.31159643","0.346735305421"
"SL2.50ch12:6208324-6208892","137","6208324","6208892","568","1534.31159643","0.370198596765"
"SL2.50ch12:62260216-62260714","985","62260216","62260714","498","1534.31159643","0.324575530263"
"SL2.50ch12:62260226-62260716","985","62260226","62260716","490","1534.31159643","0.319361465519"
"SL2.50ch12:62670986-62673764","691","62670986","62673764","2778","1534.31159643","1.81058398207"
"SL2.50ch12:63804493-63805112","1314","63804493","63805112","619","1534.31159643","0.403438259503"
"SL2.50ch12:63804577-63805144","1301","63804577","63805144","567","1534.31159643","0.369546838673"
"SL2.50ch12:63885211-63885989","1283","63885211","63885989","778","1534.31159643","0.507067796274"
"SL2.50ch12:63885246-63885736","1236","63885246","63885736","490","1534.31159643","0.319361465519"
"SL2.50ch12:65405426-65406020","6011","65405426","65406020","594","1534.31159643","0.387144307181"
"SL2.50ch12:65405486-65406101","6009","65405486","65406101","615","1534.31159643","0.400831227132"
"SL2.50ch12:65636064-65636966","15864","65636064","65636966","902","1534.31159643","0.587885799793"
"SL2.50ch12:65636113-65636817","15852","65636113","65636817","704","1534.31159643","0.458837697399"
"SL2.50ch12:65736494-65739214","657","65736494","65739214","2720","1534.31159643","1.77278201268"
"SL2.50ch12:65737654-65738267","299","65737654","65738267","613","1534.31159643","0.399527710946"
"SL2.50ch12:65744928-65745598","934","65744928","65745598","670","1534.31159643","0.436677922241"
"SL2.50ch12:65745102-65745592","916","65745102","65745592","490","1534.31159643","0.319361465519"
"SL2.50ch12:7262949-7263680","173","7262949","7263680","731","1534.31159643","0.476435165908"
"SL2.50ch12:7358547-7359341","14069","7358547","7359341","794","1534.31159643","0.51749592576"
"SL2.50ch12:7358570-7359322","14064","7358570","7359322","752","1534.31159643","0.490122085858"
"SL2.50ch12:8135988-8136573","125","8135988","8136573","585","1534.31159643","0.381278484345"
"SL2.50ch12:870448-871151","2415","870448","871151","703","1534.31159643","0.458185939307"
"SL2.50ch12:870453-871063","2412","870453","871063","610","1534.31159643","0.397572436667"
"SL2.50ch12:8743223-8743799","101","8743223","8743799","576","1534.31159643","0.375412661509"
"SL2.50ch12:8853115-8853588","100","8853115","8853588","473","1534.31159643","0.30828157794"
"SL2.50ch12:9622181-9623979","469","9622181","9623979","1798","1534.31159643","1.17186105103"
"SL2.50ch12:9687502-9687877","79","9687502","9687877","375","1534.31159643","0.244409284836"
