"Read","Counts","Read Position Start","Read Position End","Read Size (rs)","Mean Read Size (mrs)","mrs/rs"
"SL2.50ch00:10005133-10011081","156","10005133","10011081","5948","1534.31159643","3.87665713655"
"SL2.50ch00:10006571-10011218","140","10006571","10011218","4647","1534.31159643","3.02871985769"
"SL2.50ch00:10028416-10029802","8","10028416","10029802","1386","1534.31159643","0.903336716755"
"SL2.50ch00:10040285-10041207","16","10040285","10041207","922","1534.31159643","0.600920961651"
"SL2.50ch00:10065547-10066847","28","10065547","10066847","1300","1534.31159643","0.847285520766"
"SL2.50ch00:10068678-10069836","13","10068678","10069836","1158","1534.31159643","0.754735871575"
"SL2.50ch00:10073347-10074116","52","10073347","10074116","769","1534.31159643","0.501201973438"
"SL2.50ch00:10073370-10074157","53","10073370","10074157","787","1534.31159643","0.51293361911"
"SL2.50ch00:10077053-10077901","16","10077053","10077901","848","1534.31159643","0.552690862777"
"SL2.50ch00:10083573-10085215","15","10083573","10085215","1642","1534.31159643","1.07018678854"
"SL2.50ch00:10103542-10104151","16","10103542","10104151","609","1534.31159643","0.396920678574"
"SL2.50ch00:10103592-10104363","16","10103592","10104363","771","1534.31159643","0.502505489623"
"SL2.50ch00:10105958-10106333","10","10105958","10106333","375","1534.31159643","0.244409284836"
"SL2.50ch00:10110853-10111334","7","10110853","10111334","481","1534.31159643","0.313495642683"
"SL2.50ch00:10117330-10118340","27","10117330","10118340","1010","1534.31159643","0.658275673826"
"SL2.50ch00:10120640-10122337","20","10120640","10122337","1697","1534.31159643","1.10603348365"
"SL2.50ch00:10152857-10156261","54","10152857","10156261","3404","1534.31159643","2.21858454822"
"SL2.50ch00:10157394-10158622","16","10157394","10158622","1228","1534.31159643","0.800358938077"
"SL2.50ch00:10272174-10272805","20","10272174","10272805","631","1534.31159643","0.411259356618"
"SL2.50ch00:10272195-10272892","20","10272195","10272892","697","1534.31159643","0.454275390749"
"SL2.50ch00:10279897-10280460","10","10279897","10280460","563","1534.31159643","0.366939806301"
"SL2.50ch00:10282406-10282910","15","10282406","10282910","504","1534.31159643","0.32848607882"
"SL2.50ch00:10282428-10283039","16","10282428","10283039","611","1534.31159643","0.39822419476"
"SL2.50ch00:10289371-10289773","9","10289371","10289773","402","1534.31159643","0.262006753345"
"SL2.50ch00:10289429-10289804","9","10289429","10289804","375","1534.31159643","0.244409284836"
"SL2.50ch00:10290747-10292202","8","10290747","10292202","1455","1534.31159643","0.948308025165"
"SL2.50ch00:10297658-10298405","26","10297658","10298405","747","1534.31159643","0.486863295394"
"SL2.50ch00:10297803-10298602","24","10297803","10298602","799","1534.31159643","0.520754716225"
"SL2.50ch00:10299758-10300798","19","10299758","10300798","1040","1534.31159643","0.677828416613"
"SL2.50ch00:10299813-10300215","11","10299813","10300215","402","1534.31159643","0.262006753345"
"SL2.50ch00:10302537-10303498","7","10302537","10303498","961","1534.31159643","0.626339527274"
"SL2.50ch00:10307200-10307668","8","10307200","10307668","468","1534.31159643","0.305022787476"
"SL2.50ch00:10310433-10311167","9","10310433","10311167","734","1534.31159643","0.478390440186"
"SL2.50ch00:10312893-10313507","20","10312893","10313507","614","1534.31159643","0.400179469039"
"SL2.50ch00:10399133-10400855","64","10399133","10400855","1722","1534.31159643","1.12232743597"
"SL2.50ch00:10399171-10400736","64","10399171","10400736","1565","1534.31159643","1.02000141538"
"SL2.50ch00:10401963-10403672","86","10401963","10403672","1709","1534.31159643","1.11385458076"
"SL2.50ch00:10402027-10403625","85","10402027","10403625","1598","1534.31159643","1.04150943245"
"SL2.50ch00:10405076-10406218","12","10405076","10406218","1142","1534.31159643","0.744307742088"
"SL2.50ch00:10410779-10412076","36","10410779","10412076","1297","1534.31159643","0.845330246487"
"SL2.50ch00:10410836-10412161","32","10410836","10412161","1325","1534.31159643","0.863579473088"
"SL2.50ch00:10413868-10414445","10","10413868","10414445","577","1534.31159643","0.376064419601"
"SL2.50ch00:10413950-10414440","10","10413950","10414440","490","1534.31159643","0.319361465519"
"SL2.50ch00:10421276-10421986","19","10421276","10421986","710","1534.31159643","0.462748245957"
"SL2.50ch00:10421280-10421993","19","10421280","10421993","713","1534.31159643","0.464703520235"
"SL2.50ch00:10423987-10424619","13","10423987","10424619","632","1534.31159643","0.411911114711"
"SL2.50ch00:10424007-10424533","12","10424007","10424533","526","1534.31159643","0.342824756864"
"SL2.50ch00:10428514-10429841","47","10428514","10429841","1327","1534.31159643","0.864882989274"
"SL2.50ch00:10428531-10429778","47","10428531","10429778","1247","1534.31159643","0.812742341842"
"SL2.50ch00:10431271-10432050","8","10431271","10432050","779","1534.31159643","0.507719554367"
"SL2.50ch00:10438285-10439172","20","10438285","10439172","887","1534.31159643","0.5781094284"
"SL2.50ch00:10438383-10439152","19","10438383","10439152","769","1534.31159643","0.501201973438"
"SL2.50ch00:10478820-10479373","9","10478820","10479373","553","1534.31159643","0.360422225372"
"SL2.50ch00:10479107-10484403","84","10479107","10484403","5296","1534.31159643","3.45171085998"
"SL2.50ch00:10480220-10481435","20","10480220","10481435","1215","1534.31159643","0.79188608287"
"SL2.50ch00:10483452-10484394","28","10483452","10484394","942","1534.31159643","0.613956123509"
"SL2.50ch00:10485674-10487518","70","10485674","10487518","1844","1534.31159643","1.2018419233"
"SL2.50ch00:10485719-10487540","70","10485719","10487540","1821","1534.31159643","1.18685148717"
"SL2.50ch00:10489689-10497666","135","10489689","10497666","7977","1534.31159643","5.19907430704"
"SL2.50ch00:10508251-10508728","12","10508251","10508728","477","1534.31159643","0.310888610312"
"SL2.50ch00:10574785-10576108","30","10574785","10576108","1323","1534.31159643","0.862275956903"
"SL2.50ch00:10574831-10576116","30","10574831","10576116","1285","1534.31159643","0.837509149372"
"SL2.50ch00:10577299-10578748","13","10577299","10578748","1449","1534.31159643","0.944397476608"
"SL2.50ch00:10583343-10583980","6","10583343","10583980","637","1534.31159643","0.415169905175"
"SL2.50ch00:10588089-10588760","11","10588089","10588760","671","1534.31159643","0.437329680334"
"SL2.50ch00:10591312-10591687","2","10591312","10591687","375","1534.31159643","0.244409284836"
"SL2.50ch00:10600386-10601998","17","10600386","10601998","1612","1534.31159643","1.05063404575"
"SL2.50ch00:10600469-10602059","17","10600469","10602059","1590","1534.31159643","1.03629536771"
"SL2.50ch00:10604587-10606328","81","10604587","10606328","1741","1534.31159643","1.13471083973"
"SL2.50ch00:10604706-10606192","81","10604706","10606192","1486","1534.31159643","0.968512526045"
"SL2.50ch00:10607825-10610081","121","10607825","10610081","2256","1534.31159643","1.47036625758"
"SL2.50ch00:10607848-10610097","121","10607848","10610097","2249","1534.31159643","1.46580395093"
"SL2.50ch00:10617034-10618103","120","10617034","10618103","1069","1534.31159643","0.696729401307"
"SL2.50ch00:10617090-10618160","119","10617090","10618160","1070","1534.31159643","0.6973811594"
"SL2.50ch00:10627406-10628362","66","10627406","10628362","956","1534.31159643","0.623080736809"
"SL2.50ch00:10627454-10628374","66","10627454","10628374","920","1534.31159643","0.599617445465"
"SL2.50ch00:10630273-10630919","14","10630273","10630919","646","1534.31159643","0.421035728011"
"SL2.50ch00:10630313-10630931","14","10630313","10630931","618","1534.31159643","0.40278650141"
"SL2.50ch00:10632641-10636726","182","10632641","10636726","4085","1534.31159643","2.66243180948"
"SL2.50ch00:10632670-10636807","182","10632670","10636807","4137","1534.31159643","2.69632323031"
"SL2.50ch00:10638561-10640200","162","10638561","10640200","1639","1534.31159643","1.06823151426"
"SL2.50ch00:10638566-10640222","162","10638566","10640222","1656","1534.31159643","1.07931140184"
"SL2.50ch00:10642060-10643975","147","10642060","10643975","1915","1534.31159643","1.2481167479"
"SL2.50ch00:10642075-10643948","147","10642075","10643948","1873","1534.31159643","1.220742908"
"SL2.50ch00:10644516-10645812","60","10644516","10645812","1296","1534.31159643","0.844678488394"
"SL2.50ch00:10644553-10646100","62","10644553","10646100","1547","1534.31159643","1.00826976971"
"SL2.50ch00:10651669-10652308","47","10651669","10652308","639","1534.31159643","0.416473421361"
"SL2.50ch00:10651733-10652250","47","10651733","10652250","517","1534.31159643","0.336958934028"
"SL2.50ch00:10653445-10654617","42","10653445","10654617","1172","1534.31159643","0.763860484875"
"SL2.50ch00:10653567-10654616","41","10653567","10654616","1049","1534.31159643","0.683694239449"
"SL2.50ch00:10656054-10657819","47","10656054","10657819","1765","1534.31159643","1.15035303396"
"SL2.50ch00:10656702-10657333","28","10656702","10657333","631","1534.31159643","0.411259356618"
"SL2.50ch00:10659590-10661157","17","10659590","10661157","1567","1534.31159643","1.02130493157"
"SL2.50ch00:10663998-10664883","48","10663998","10664883","885","1534.31159643","0.576805912214"
"SL2.50ch00:10664107-10664878","45","10664107","10664878","771","1534.31159643","0.502505489623"
"SL2.50ch00:10665525-10666271","87","10665525","10666271","746","1534.31159643","0.486211537301"
"SL2.50ch00:10665549-10666165","86","10665549","10666165","616","1534.31159643","0.401482985224"
"SL2.50ch00:10667219-10669649","318","10667219","10669649","2430","1534.31159643","1.58377216574"
"SL2.50ch00:10667221-10669653","318","10667221","10669653","2432","1534.31159643","1.58507568193"
"SL2.50ch00:10672295-10673041","69","10672295","10673041","746","1534.31159643","0.486211537301"
"SL2.50ch00:10672304-10672930","69","10672304","10672930","626","1534.31159643","0.408000566153"
"SL2.50ch00:10675322-10676638","127","10675322","10676638","1316","1534.31159643","0.857713650252"
"SL2.50ch00:10675696-10676599","124","10675696","10676599","903","1534.31159643","0.588537557886"
"SL2.50ch00:10680469-10686449","1001","10680469","10686449","5980","1534.31159643","3.89751339552"
"SL2.50ch00:10680581-10686405","995","10680581","10686405","5824","1534.31159643","3.79583913303"
"SL2.50ch00:10687257-10692751","925","10687257","10692751","5494","1534.31159643","3.58075896238"
"SL2.50ch00:10687260-10692761","924","10687260","10692761","5501","1534.31159643","3.58532126903"
"SL2.50ch00:10721753-10722752","23","10721753","10722752","999","1534.31159643","0.651106334804"
"SL2.50ch00:10721893-10722560","19","10721893","10722560","667","1534.31159643","0.434722647962"
"SL2.50ch00:10729271-10730740","93","10729271","10730740","1469","1534.31159643","0.957432638466"
"SL2.50ch00:10729580-10730684","93","10729580","10730684","1104","1534.31159643","0.719540934558"
"SL2.50ch00:10731598-10733261","72","10731598","10733261","1663","1534.31159643","1.08387370849"
"SL2.50ch00:10731625-10733902","85","10731625","10733902","2277","1534.31159643","1.48405317753"
"SL2.50ch00:10734439-10737127","43","10734439","10737127","2688","1534.31159643","1.75192575371"
"SL2.50ch00:10743514-10745178","39","10743514","10745178","1664","1534.31159643","1.08452546658"
"SL2.50ch00:10743570-10745184","40","10743570","10745184","1614","1534.31159643","1.05193756194"
"SL2.50ch00:10746690-10748940","36","10746690","10748940","2250","1534.31159643","1.46645570902"
"SL2.50ch00:10746769-10748824","36","10746769","10748824","2055","1534.31159643","1.3393628809"
"SL2.50ch00:10776565-10777782","28","10776565","10777782","1217","1534.31159643","0.793189599056"
"SL2.50ch00:10776577-10777822","28","10776577","10777822","1245","1534.31159643","0.811438825657"
"SL2.50ch00:10778513-10781161","46","10778513","10781161","2648","1534.31159643","1.72585542999"
"SL2.50ch00:10779975-10780768","19","10779975","10780768","793","1534.31159643","0.516844167667"
"SL2.50ch00:10782742-10784037","24","10782742","10784037","1295","1534.31159643","0.844026730301"
"SL2.50ch00:10783290-10784024","20","10783290","10784024","734","1534.31159643","0.478390440186"
"SL2.50ch00:10788553-10789259","23","10788553","10789259","706","1534.31159643","0.460141213585"
"SL2.50ch00:10788579-10789335","23","10788579","10789335","756","1534.31159643","0.49272911823"
"SL2.50ch00:10793408-10794020","16","10793408","10794020","612","1534.31159643","0.398875952853"
"SL2.50ch00:10793503-10794068","17","10793503","10794068","565","1534.31159643","0.368243322487"
"SL2.50ch00:10798377-10803492","102","10798377","10803492","5115","1534.31159643","3.33374264517"
"SL2.50ch00:10799123-10801716","68","10799123","10801716","2593","1534.31159643","1.69000873488"
"SL2.50ch00:10802224-10803463","22","10802224","10803463","1239","1534.31159643","0.807528277099"
"SL2.50ch00:10830671-10832340","89","10830671","10832340","1669","1534.31159643","1.08778425704"
"SL2.50ch00:10830806-10832251","89","10830806","10832251","1445","1534.31159643","0.941790444236"
"SL2.50ch00:10834870-10835856","58","10834870","10835856","986","1534.31159643","0.642633479596"
"SL2.50ch00:10834926-10835824","58","10834926","10835824","898","1534.31159643","0.585278767421"
"SL2.50ch00:10842008-10842648","7","10842008","10842648","640","1534.31159643","0.417125179454"
"SL2.50ch00:10842053-10842619","7","10842053","10842619","566","1534.31159643","0.36889508058"
"SL2.50ch00:10843914-10845152","31","10843914","10845152","1238","1534.31159643","0.806876519006"
"SL2.50ch00:10843953-10845180","30","10843953","10845180","1227","1534.31159643","0.799707179984"
"SL2.50ch00:10846121-10847059","61","10846121","10847059","938","1534.31159643","0.611349091137"
"SL2.50ch00:10846196-10847084","61","10846196","10847084","888","1534.31159643","0.578761186492"
"SL2.50ch00:10848766-10850022","41","10848766","10850022","1256","1534.31159643","0.818608164678"
"SL2.50ch00:10848805-10849925","40","10848805","10849925","1120","1534.31159643","0.729969064045"
"SL2.50ch00:10854412-10857486","88","10854412","10857486","3074","1534.31159643","2.00350437757"
"SL2.50ch00:10854918-10857521","66","10854918","10857521","2603","1534.31159643","1.69652631581"
"SL2.50ch00:10910102-10911481","48","10910102","10911481","1379","1534.31159643","0.898774410105"
"SL2.50ch00:10910311-10911494","47","10910311","10911494","1183","1534.31159643","0.771029823897"
"SL2.50ch00:10913428-10914869","26","10913428","10914869","1441","1534.31159643","0.939183411864"
"SL2.50ch00:10914169-10914811","24","10914169","10914811","642","1534.31159643","0.41842869564"
"SL2.50ch00:10917251-10919712","148","10917251","10919712","2461","1534.31159643","1.60397666662"
"SL2.50ch00:10917300-10919792","146","10917300","10919792","2492","1534.31159643","1.6241811675"
"SL2.50ch00:10926668-10929216","65","10926668","10929216","2548","1534.31159643","1.6606796207"
"SL2.50ch00:10926758-10928802","57","10926758","10928802","2044","1534.31159643","1.33219354188"
"SL2.50ch00:10931044-10933170","73","10931044","10933170","2126","1534.31159643","1.3856377055"
"SL2.50ch00:10931734-10933100","58","10931734","10933100","1366","1534.31159643","0.890301554897"
"SL2.50ch00:10935727-10937883","35","10935727","10937883","2156","1534.31159643","1.40519044829"
"SL2.50ch00:10938577-10943962","85","10938577","10943962","5385","1534.31159643","3.50971733025"
"SL2.50ch00:10945239-10960714","205","10945239","10960714","15475","1534.31159643","10.0859564876"
"SL2.50ch00:10963562-10964175","7","10963562","10964175","613","1534.31159643","0.399527710946"
"SL2.50ch00:10971080-10972214","25","10971080","10972214","1134","1534.31159643","0.739093677345"
"SL2.50ch00:10984444-10986807","50","10984444","10986807","2363","1534.31159643","1.54010437352"
"SL2.50ch00:10985206-10986760","43","10985206","10986760","1554","1534.31159643","1.01283207636"
"SL2.50ch00:10990730-10992093","39","10990730","10992093","1363","1534.31159643","0.888346280618"
"SL2.50ch00:10990771-10995810","100","10990771","10995810","5039","1534.31159643","3.28420903011"
"SL2.50ch00:10994218-10995817","20","10994218","10995817","1599","1534.31159643","1.04216119054"
"SL2.50ch00:10998634-11000359","75","10998634","11000359","1725","1534.31159643","1.12428271025"
"SL2.50ch00:10998654-11000328","75","10998654","11000328","1674","1534.31159643","1.09104304751"
"SL2.50ch00:11004911-11007134","73","11004911","11007134","2223","1534.31159643","1.44885824051"
"SL2.50ch00:11004923-11006797","69","11004923","11006797","1874","1534.31159643","1.22139466609"
"SL2.50ch00:11012419-11012887","11","11012419","11012887","468","1534.31159643","0.305022787476"
"SL2.50ch00:11016290-11017393","15","11016290","11017393","1103","1534.31159643","0.718889176465"
"SL2.50ch00:11028979-11029941","5","11028979","11029941","962","1534.31159643","0.626991285367"
"SL2.50ch00:11031485-11032090","15","11031485","11032090","605","1534.31159643","0.394313646203"
"SL2.50ch00:11049670-11050591","6","11049670","11050591","921","1534.31159643","0.600269203558"
"SL2.50ch00:11054991-11077454","3070","11054991","11077454","22463","1534.31159643","14.6404420407"
"SL2.50ch00:11055017-11077585","3070","11055017","11077585","22568","1534.31159643","14.7088766405"
"SL2.50ch00:11141791-11146360","75","11141791","11146360","4569","1534.31159643","2.97788272645"
"SL2.50ch00:11147045-11148514","47","11147045","11148514","1469","1534.31159643","0.957432638466"
"SL2.50ch00:11147182-11148410","45","11147182","11148410","1228","1534.31159643","0.800358938077"
"SL2.50ch00:11154592-11157099","27","11154592","11157099","2507","1534.31159643","1.63395753889"
"SL2.50ch00:11154826-11155353","6","11154826","11155353","527","1534.31159643","0.343476514957"
"SL2.50ch00:11160641-11161016","10","11160641","11161016","375","1534.31159643","0.244409284836"
"SL2.50ch00:11182279-11182999","17","11182279","11182999","720","1534.31159643","0.469265826886"
"SL2.50ch00:11184514-11185940","17","11184514","11185940","1426","1534.31159643","0.929407040471"
"SL2.50ch00:11239906-11240870","15","11239906","11240870","964","1534.31159643","0.628294801553"
"SL2.50ch00:11239935-11240870","15","11239935","11240870","935","1534.31159643","0.609393816859"
"SL2.50ch00:11242494-11243677","22","11242494","11243677","1183","1534.31159643","0.771029823897"
"SL2.50ch00:11242536-11243721","22","11242536","11243721","1185","1534.31159643","0.772333340083"
"SL2.50ch00:11244921-11246560","39","11244921","11246560","1639","1534.31159643","1.06823151426"
"SL2.50ch00:11245111-11246527","32","11245111","11246527","1416","1534.31159643","0.922889459542"
"SL2.50ch00:11251420-11254477","55","11251420","11254477","3057","1534.31159643","1.99242448999"
"SL2.50ch00:11251474-11254488","55","11251474","11254488","3014","1534.31159643","1.96439889199"
"SL2.50ch00:11256104-11258743","54","11256104","11258743","2639","1534.31159643","1.71998960715"
"SL2.50ch00:11256374-11257628","38","11256374","11257628","1254","1534.31159643","0.817304648493"
"SL2.50ch00:11295429-11296112","10","11295429","11296112","683","1534.31159643","0.445150777449"
"SL2.50ch00:11297140-11297876","11","11297140","11297876","736","1534.31159643","0.479693956372"
"SL2.50ch00:11297467-11297869","9","11297467","11297869","402","1534.31159643","0.262006753345"
"SL2.50ch00:11301310-11301925","8","11301310","11301925","615","1534.31159643","0.400831227132"
"SL2.50ch00:11301387-11302198","11","11301387","11302198","811","1534.31159643","0.528575813339"
"SL2.50ch00:11302688-11304930","25","11302688","11304930","2242","1534.31159643","1.46124164427"
"SL2.50ch00:11307746-11308433","7","11307746","11308433","687","1534.31159643","0.44775780982"
"SL2.50ch00:11310302-11313701","155","11310302","11313701","3399","1534.31159643","2.21532575776"
"SL2.50ch00:11311042-11313666","149","11311042","11313666","2624","1534.31159643","1.71021323576"
"SL2.50ch00:11314480-11315945","65","11314480","11315945","1465","1534.31159643","0.954825606094"
"SL2.50ch00:11314530-11315863","63","11314530","11315863","1333","1534.31159643","0.868793537832"
"SL2.50ch00:11316956-11318788","29","11316956","11318788","1832","1534.31159643","1.19402082619"
"SL2.50ch00:11317113-11318869","29","11317113","11318869","1756","1534.31159643","1.14448721113"
"SL2.50ch00:11321897-11325977","89","11321897","11325977","4080","1534.31159643","2.65917301902"
"SL2.50ch00:11327058-11336556","143","11327058","11336556","9498","1534.31159643","6.19039836633"
"SL2.50ch00:11337168-11343493","100","11337168","11343493","6325","1534.31159643","4.12236993757"
"SL2.50ch00:11337773-11339163","22","11337773","11339163","1390","1534.31159643","0.905943749127"
"SL2.50ch00:11343876-11345462","22","11343876","11345462","1586","1534.31159643","1.03368833533"
"SL2.50ch00:11362940-11363777","22","11362940","11363777","837","1534.31159643","0.545521523755"
"SL2.50ch00:11362979-11363782","22","11362979","11363782","803","1534.31159643","0.523361748596"
"SL2.50ch00:11369292-11373961","52","11369292","11373961","4669","1534.31159643","3.04305853574"
"SL2.50ch00:11373131-11374061","15","11373131","11374061","930","1534.31159643","0.606135026394"
"SL2.50ch00:11377817-11379373","44","11377817","11379373","1556","1534.31159643","1.01413559255"
"SL2.50ch00:11377836-11379479","44","11377836","11379479","1643","1534.31159643","1.07083854663"
"SL2.50ch00:11396266-11398043","67","11396266","11398043","1777","1534.31159643","1.15817413108"
"SL2.50ch00:11396295-11398007","66","11396295","11398007","1712","1534.31159643","1.11580985504"
"SL2.50ch00:11398903-11404492","192","11398903","11404492","5589","1534.31159643","3.6426759812"
"SL2.50ch00:11398925-11404518","192","11398925","11404518","5593","1534.31159643","3.64528301357"
"SL2.50ch00:11411150-11412562","38","11411150","11412562","1412","1534.31159643","0.92028242717"
"SL2.50ch00:11411231-11412588","38","11411231","11412588","1357","1534.31159643","0.884435732061"
"SL2.50ch00:11443795-11444573","13","11443795","11444573","778","1534.31159643","0.507067796274"
"SL2.50ch00:11490691-11491635","27","11490691","11491635","944","1534.31159643","0.615259639695"
"SL2.50ch00:11490713-11491534","27","11490713","11491534","821","1534.31159643","0.535093394268"
"SL2.50ch00:11492659-11494444","39","11492659","11494444","1785","1534.31159643","1.16338819582"
"SL2.50ch00:11495655-11497053","37","11495655","11497053","1398","1534.31159643","0.91115781387"
"SL2.50ch00:11495656-11497040","37","11495656","11497040","1384","1534.31159643","0.902033200569"
"SL2.50ch00:11499356-11501332","37","11499356","11501332","1976","1534.31159643","1.28787399156"
"SL2.50ch00:11499356-11501348","37","11499356","11501348","1992","1534.31159643","1.29830212105"
"SL2.50ch00:11501840-11503210","36","11501840","11503210","1370","1534.31159643","0.892908587269"
"SL2.50ch00:11501878-11503235","36","11501878","11503235","1357","1534.31159643","0.884435732061"
"SL2.50ch00:11504335-11505258","29","11504335","11505258","923","1534.31159643","0.601572719744"
"SL2.50ch00:11504386-11505195","29","11504386","11505195","809","1534.31159643","0.527272297154"
"SL2.50ch00:11510011-11512517","32","11510011","11512517","2506","1534.31159643","1.6333057808"
"SL2.50ch00:11516726-11517650","8","11516726","11517650","924","1534.31159643","0.602224477837"
"SL2.50ch00:11534144-11548092","508","11534144","11548092","13948","1534.31159643","9.09072187973"
"SL2.50ch00:11534489-11535256","27","11534489","11535256","767","1534.31159643","0.499898457252"
"SL2.50ch00:11542527-11545428","127","11542527","11545428","2901","1534.31159643","1.89075022749"
"SL2.50ch00:11545960-11547723","66","11545960","11547723","1763","1534.31159643","1.14904951778"
"SL2.50ch00:11565406-11566479","13","11565406","11566479","1073","1534.31159643","0.699336433678"
"SL2.50ch00:11569964-11571143","16","11569964","11571143","1179","1534.31159643","0.768422791525"
"SL2.50ch00:11570173-11570575","8","11570173","11570575","402","1534.31159643","0.262006753345"
"SL2.50ch00:11573020-11573805","15","11573020","11573805","785","1534.31159643","0.511630102924"
"SL2.50ch00:11576933-11591013","276","11576933","11591013","14080","1534.31159643","9.17675394799"
"SL2.50ch00:11577013-11583000","143","11577013","11583000","5987","1534.31159643","3.90207570217"
"SL2.50ch00:11655359-11656929","145","11655359","11656929","1570","1534.31159643","1.02326020585"
"SL2.50ch00:11655417-11656972","141","11655417","11656972","1555","1534.31159643","1.01348383445"
"SL2.50ch00:11658393-11659374","34","11658393","11659374","981","1534.31159643","0.639374689132"
"SL2.50ch00:11658447-11659399","34","11658447","11659399","952","1534.31159643","0.620473704438"
"SL2.50ch00:11685655-11686839","29","11685655","11686839","1184","1534.31159643","0.77168158199"
"SL2.50ch00:11685700-11686817","29","11685700","11686817","1117","1534.31159643","0.728013789766"
"SL2.50ch00:11687539-11689544","51","11687539","11689544","2005","1534.31159643","1.30677497626"
"SL2.50ch00:11687544-11689658","51","11687544","11689658","2114","1534.31159643","1.37781660838"
"SL2.50ch00:11690433-11694263","82","11690433","11694263","3830","1534.31159643","2.4962334958"
"SL2.50ch00:11690522-11694248","81","11690522","11694248","3726","1534.31159643","2.42845065413"
"SL2.50ch00:11695274-11695742","5","11695274","11695742","468","1534.31159643","0.305022787476"
"SL2.50ch00:11697453-11698498","29","11697453","11698498","1045","1534.31159643","0.681087207077"
"SL2.50ch00:11697579-11698449","28","11697579","11698449","870","1534.31159643","0.56702954082"
"SL2.50ch00:11736294-11738166","113","11736294","11738166","1872","1534.31159643","1.2200911499"
"SL2.50ch00:11736370-11738125","113","11736370","11738125","1755","1534.31159643","1.14383545303"
"SL2.50ch00:11740279-11741152","14","11740279","11741152","873","1534.31159643","0.568984815099"
"SL2.50ch00:11773889-11775693","202","11773889","11775693","1804","1534.31159643","1.17577159959"
"SL2.50ch00:11773930-11775744","202","11773930","11775744","1814","1534.31159643","1.18228918051"
"SL2.50ch00:11777422-11778524","136","11777422","11778524","1102","1534.31159643","0.718237418372"
"SL2.50ch00:11777442-11778421","136","11777442","11778421","979","1534.31159643","0.638071172946"
"SL2.50ch00:11780867-11786256","481","11780867","11786256","5389","1534.31159643","3.51232436262"
"SL2.50ch00:11780912-11782044","114","11780912","11782044","1132","1534.31159643","0.737790161159"
"SL2.50ch00:11782605-11786189","367","11782605","11786189","3584","1534.31159643","2.33590100494"
"SL2.50ch00:11789557-11790432","8","11789557","11790432","875","1534.31159643","0.570288331285"
"SL2.50ch00:11796774-11810562","1893","11796774","11810562","13788","1534.31159643","8.98644058486"
"SL2.50ch00:11796775-11811812","1900","11796775","11811812","15037","1534.31159643","9.80048644289"
"SL2.50ch00:11811283-11817977","62","11811283","11817977","6694","1534.31159643","4.36286867385"
"SL2.50ch00:11818814-11820433","13","11818814","11820433","1619","1534.31159643","1.0551963524"
"SL2.50ch00:11851604-11851979","12","11851604","11851979","375","1534.31159643","0.244409284836"
"SL2.50ch00:11855458-11855833","10","11855458","11855833","375","1534.31159643","0.244409284836"
"SL2.50ch00:11857566-11868424","155","11857566","11868424","10858","1534.31159643","7.07678937267"
"SL2.50ch00:11879807-11880392","4","11879807","11880392","585","1534.31159643","0.381278484345"
"SL2.50ch00:11901041-11902147","7","11901041","11902147","1106","1534.31159643","0.720844450744"
"SL2.50ch00:11919197-11920404","1","11919197","11920404","1207","1534.31159643","0.786672018127"
"SL2.50ch00:11934789-11936007","33","11934789","11936007","1218","1534.31159643","0.793841357148"
"SL2.50ch00:11934833-11935949","32","11934833","11935949","1116","1534.31159643","0.727362031673"
"SL2.50ch00:11944452-11945184","27","11944452","11945184","732","1534.31159643","0.477086924001"
"SL2.50ch00:11944467-11945834","34","11944467","11945834","1367","1534.31159643","0.89095331299"
"SL2.50ch00:11966673-11976948","1253","11966673","11976948","10275","1534.31159643","6.69681440452"
"SL2.50ch00:11966734-11976905","1252","11966734","11976905","10171","1534.31159643","6.62903156285"
"SL2.50ch00:11986921-11988022","53","11986921","11988022","1101","1534.31159643","0.717585660279"
"SL2.50ch00:11986957-11988008","53","11986957","11988008","1051","1534.31159643","0.684997755635"
"SL2.50ch00:11990790-11991712","35","11990790","11991712","922","1534.31159643","0.600920961651"
"SL2.50ch00:11990864-11991745","35","11990864","11991745","881","1534.31159643","0.574198879842"
"SL2.50ch00:11993084-11994653","84","11993084","11994653","1569","1534.31159643","1.02260844776"
"SL2.50ch00:11993089-11994652","84","11993089","11994652","1563","1534.31159643","1.0186978992"
"SL2.50ch00:11996143-11996976","39","11996143","11996976","833","1534.31159643","0.542914491383"
"SL2.50ch00:11996180-11996906","38","11996180","11996906","726","1534.31159643","0.473176375443"
"SL2.50ch00:12006317-12016238","1797","12006317","12016238","9921","1534.31159643","6.46609203963"
"SL2.50ch00:12006345-12016217","1797","12006345","12016217","9872","1534.31159643","6.43415589308"
"SL2.50ch00:12039855-12043885","32","12039855","12043885","4030","1534.31159643","2.62658511437"
"SL2.50ch00:12088188-12089621","43","12088188","12089621","1433","1534.31159643","0.933969347121"
"SL2.50ch00:12088241-12089533","40","12088241","12089533","1292","1534.31159643","0.842071456023"
"SL2.50ch00:12090836-12091726","34","12090836","12091726","890","1534.31159643","0.580064702678"
"SL2.50ch00:12090867-12091866","34","12090867","12091866","999","1534.31159643","0.651106334804"
"SL2.50ch00:12128041-12153956","2544","12128041","12153956","25915","1534.31159643","16.8903109774"
"SL2.50ch00:12128092-12154010","2543","12128092","12154010","25918","1534.31159643","16.8922662517"
"SL2.50ch00:12212252-12219919","162","12212252","12219919","7667","1534.31159643","4.99702929824"
"SL2.50ch00:12248404-12249285","5","12248404","12249285","881","1534.31159643","0.574198879842"
"SL2.50ch00:12265906-12282052","2107","12265906","12282052","16146","1534.31159643","10.5232861679"
"SL2.50ch00:12266755-12282024","2101","12266755","12282024","15269","1534.31159643","9.95169432044"
"SL2.50ch00:12300519-12302423","21","12300519","12302423","1904","1534.31159643","1.24094740888"
"SL2.50ch00:12312461-12319857","89","12312461","12319857","7396","1534.31159643","4.82040285507"
"SL2.50ch00:12322111-12324059","28","12322111","12324059","1948","1534.31159643","1.26962476496"
"SL2.50ch00:12324604-12326161","24","12324604","12326161","1557","1534.31159643","1.01478735064"
"SL2.50ch00:12324740-12325271","10","12324740","12325271","531","1534.31159643","0.346083547328"
"SL2.50ch00:12349016-12349805","14","12349016","12349805","789","1534.31159643","0.514237135296"
"SL2.50ch00:12355984-12356471","5","12355984","12356471","487","1534.31159643","0.317406191241"
"SL2.50ch00:12441988-12442941","7","12441988","12442941","953","1534.31159643","0.621125462531"
"SL2.50ch00:12492797-12501111","136","12492797","12501111","8314","1534.31159643","5.41871678434"
"SL2.50ch00:12504563-12505488","8","12504563","12505488","925","1534.31159643","0.60287623593"
"SL2.50ch00:12504566-12506165","15","12504566","12506165","1599","1534.31159643","1.04216119054"
"SL2.50ch00:12561348-12561723","2","12561348","12561723","375","1534.31159643","0.244409284836"
"SL2.50ch00:12569894-12572562","19","12569894","12572562","2668","1534.31159643","1.73889059185"
"SL2.50ch00:12643072-12645845","33","12643072","12645845","2773","1534.31159643","1.8073251916"
"SL2.50ch00:12646403-12647798","16","12646403","12647798","1395","1534.31159643","0.909202539591"
"SL2.50ch00:12704280-12705169","7","12704280","12705169","889","1534.31159643","0.579412944585"
"SL2.50ch00:12738178-12739382","6","12738178","12739382","1204","1534.31159643","0.784716743848"
"SL2.50ch00:12754371-12754746","10","12754371","12754746","375","1534.31159643","0.244409284836"
"SL2.50ch00:12756553-12757552","36","12756553","12757552","999","1534.31159643","0.651106334804"
"SL2.50ch00:12756615-12757494","36","12756615","12757494","879","1534.31159643","0.572895363656"
"SL2.50ch00:12758316-12760172","141","12758316","12760172","1856","1534.31159643","1.20966302042"
"SL2.50ch00:12758317-12760287","141","12758317","12760287","1970","1534.31159643","1.28396344301"
"SL2.50ch00:12772510-12779644","118","12772510","12779644","7134","1534.31159643","4.64964223473"
"SL2.50ch00:12772651-12779661","118","12772651","12779661","7010","1534.31159643","4.56882423121"
"SL2.50ch00:12781953-12784325","29","12781953","12784325","2372","1534.31159643","1.54597019635"
"SL2.50ch00:12953345-12958549","495","12953345","12958549","5204","1534.31159643","3.39174911544"
"SL2.50ch00:12953394-12958782","495","12953394","12958782","5388","1534.31159643","3.51167260453"
"SL2.50ch00:12971641-12972651","6","12971641","12972651","1010","1534.31159643","0.658275673826"
"SL2.50ch00:12976046-12981524","75","12976046","12981524","5478","1534.31159643","3.57033083289"
"SL2.50ch00:13042994-13043992","6","13042994","13043992","998","1534.31159643","0.650454576711"
"SL2.50ch00:13048685-13050095","19","13048685","13050095","1410","1534.31159643","0.918978910985"
"SL2.50ch00:13050589-13050964","3","13050589","13050964","375","1534.31159643","0.244409284836"
"SL2.50ch00:13052284-13053828","34","13052284","13053828","1544","1534.31159643","1.00631449543"
"SL2.50ch00:13052293-13053790","34","13052293","13053790","1497","1534.31159643","0.975681865067"
"SL2.50ch00:13173739-13179206","138","13173739","13179206","5467","1534.31159643","3.56316149387"
"SL2.50ch00:13173987-13179068","138","13173987","13179068","5081","1534.31159643","3.31158287001"
"SL2.50ch00:13219018-13220754","18","13219018","13220754","1736","1534.31159643","1.13145204927"
"SL2.50ch00:13258573-13258948","8","13258573","13258948","375","1534.31159643","0.244409284836"
"SL2.50ch00:13301695-13302466","35","13301695","13302466","771","1534.31159643","0.502505489623"
"SL2.50ch00:13301745-13303148","42","13301745","13303148","1403","1534.31159643","0.914416604334"
"SL2.50ch00:13305430-13306986","28","13305430","13306986","1556","1534.31159643","1.01413559255"
"SL2.50ch00:13306127-13306954","26","13306127","13306954","827","1534.31159643","0.539003942826"
"SL2.50ch00:13374936-13375835","74","13374936","13375835","899","1534.31159643","0.585930525514"
"SL2.50ch00:13374993-13375822","74","13374993","13375822","829","1534.31159643","0.540307459012"
"SL2.50ch00:13379464-13380319","123","13379464","13380319","855","1534.31159643","0.557253169427"
"SL2.50ch00:13379546-13380280","121","13379546","13380280","734","1534.31159643","0.478390440186"
"SL2.50ch00:13386849-13388170","24","13386849","13388170","1321","1534.31159643","0.860972440717"
"SL2.50ch00:13447403-13448475","8","13447403","13448475","1072","1534.31159643","0.698684675585"
"SL2.50ch00:13460469-13460993","6","13460469","13460993","524","1534.31159643","0.341521240678"
"SL2.50ch00:13492816-13494529","38","13492816","13494529","1713","1534.31159643","1.11646161313"
"SL2.50ch00:13493331-13494493","37","13493331","13494493","1162","1534.31159643","0.757342903946"
"SL2.50ch00:13496795-13498327","25","13496795","13498327","1532","1534.31159643","0.998493398318"
"SL2.50ch00:13496804-13497997","22","13496804","13497997","1193","1534.31159643","0.777547404826"
"SL2.50ch00:13503303-13508274","262","13503303","13508274","4971","1534.31159643","3.23988947979"
"SL2.50ch00:13503345-13507608","262","13503345","13507608","4263","1534.31159643","2.77844475002"
"SL2.50ch00:13603324-13608439","530","13603324","13608439","5115","1534.31159643","3.33374264517"
"SL2.50ch00:13603418-13608360","529","13603418","13608360","4942","1534.31159643","3.2209884951"
"SL2.50ch00:13689138-13689838","27","13689138","13689838","700","1534.31159643","0.456230665028"
"SL2.50ch00:13689215-13689887","26","13689215","13689887","672","1534.31159643","0.437981438427"
"SL2.50ch00:13690527-13691502","11","13690527","13691502","975","1534.31159643","0.635464140574"
"SL2.50ch00:13764405-13769492","511","13764405","13769492","5087","1534.31159643","3.31549341857"
"SL2.50ch00:13764739-13769522","511","13764739","13769522","4783","1534.31159643","3.11735895833"
"SL2.50ch00:14016578-14019015","24","14016578","14019015","2437","1534.31159643","1.58833447239"
"SL2.50ch00:14094989-14095741","6","14094989","14095741","752","1534.31159643","0.490122085858"
"SL2.50ch00:14120397-14121433","39","14120397","14121433","1036","1534.31159643","0.675221384241"
"SL2.50ch00:14120464-14121414","39","14120464","14121414","950","1534.31159643","0.619170188252"
"SL2.50ch00:14123247-14124871","32","14123247","14124871","1624","1534.31159643","1.05845514286"
"SL2.50ch00:14123639-14124892","28","14123639","14124892","1253","1534.31159643","0.8166528904"
"SL2.50ch00:14257651-14258925","13","14257651","14258925","1274","1534.31159643","0.830339810351"
"SL2.50ch00:14287141-14287908","15","14287141","14287908","767","1534.31159643","0.499898457252"
"SL2.50ch00:14287299-14287967","16","14287299","14287967","668","1534.31159643","0.435374406055"
"SL2.50ch00:14290568-14291564","75","14290568","14291564","996","1534.31159643","0.649151060525"
"SL2.50ch00:14290600-14291614","75","14290600","14291614","1014","1534.31159643","0.660882706197"
"SL2.50ch00:14292320-14292792","2","14292320","14292792","472","1534.31159643","0.307629819847"
"SL2.50ch00:14299681-14300277","7","14299681","14300277","596","1534.31159643","0.388447823367"
"SL2.50ch00:14314021-14314511","11","14314021","14314511","490","1534.31159643","0.319361465519"
"SL2.50ch00:14314090-14314978","15","14314090","14314978","888","1534.31159643","0.578761186492"
"SL2.50ch00:14316774-14318231","29","14316774","14318231","1457","1534.31159643","0.949611541351"
"SL2.50ch00:14409505-14410967","33","14409505","14410967","1462","1534.31159643","0.952870331815"
"SL2.50ch00:14409706-14410980","30","14409706","14410980","1274","1534.31159643","0.830339810351"
"SL2.50ch00:14437531-14441662","187","14437531","14441662","4131","1534.31159643","2.69241268176"
"SL2.50ch00:14437552-14441686","187","14437552","14441686","4134","1534.31159643","2.69436795604"
"SL2.50ch00:14505167-14506310","21","14505167","14506310","1143","1534.31159643","0.744959500181"
"SL2.50ch00:14505245-14506926","28","14505245","14506926","1681","1534.31159643","1.09560535416"
"SL2.50ch00:14507589-14508079","38","14507589","14508079","490","1534.31159643","0.319361465519"
"SL2.50ch00:14510907-14511410","18","14510907","14511410","503","1534.31159643","0.327834320727"
"SL2.50ch00:14510996-14511371","14","14510996","14511371","375","1534.31159643","0.244409284836"
"SL2.50ch00:14514668-14515895","15","14514668","14515895","1227","1534.31159643","0.799707179984"
"SL2.50ch00:14514736-14515408","9","14514736","14515408","672","1534.31159643","0.437981438427"
"SL2.50ch00:14520230-14525038","73","14520230","14525038","4808","1534.31159643","3.13365291065"
"SL2.50ch00:14545956-14550551","878","14545956","14550551","4595","1534.31159643","2.99482843686"
"SL2.50ch00:14545963-14550341","878","14545963","14550341","4378","1534.31159643","2.8533969307"
"SL2.50ch00:14558944-14559319","3","14558944","14559319","375","1534.31159643","0.244409284836"
"SL2.50ch00:14561327-14562517","23","14561327","14562517","1190","1534.31159643","0.775592130547"
"SL2.50ch00:14571931-14572899","14","14571931","14572899","968","1534.31159643","0.630901833924"
"SL2.50ch00:14575076-14576030","14","14575076","14576030","954","1534.31159643","0.621777220624"
"SL2.50ch00:14635309-14636138","11","14635309","14636138","829","1534.31159643","0.540307459012"
"SL2.50ch00:14637586-14637961","4","14637586","14637961","375","1534.31159643","0.244409284836"
"SL2.50ch00:14644994-14645671","8","14644994","14645671","677","1534.31159643","0.441240228891"
"SL2.50ch00:14648440-14648944","1","14648440","14648944","504","1534.31159643","0.32848607882"
"SL2.50ch00:14656365-14657036","5","14656365","14657036","671","1534.31159643","0.437329680334"
"SL2.50ch00:14662175-14662732","6","14662175","14662732","557","1534.31159643","0.363029257744"
"SL2.50ch00:14665278-14665926","11","14665278","14665926","648","1534.31159643","0.422339244197"
"SL2.50ch00:14665313-14665877","11","14665313","14665877","564","1534.31159643","0.367591564394"
"SL2.50ch00:14670501-14675782","327","14670501","14675782","5281","1534.31159643","3.44193448859"
"SL2.50ch00:14670522-14675771","327","14670522","14675771","5249","1534.31159643","3.42107822962"
"SL2.50ch00:14677217-14679031","123","14677217","14679031","1814","1534.31159643","1.18228918051"
"SL2.50ch00:14677253-14679141","124","14677253","14679141","1888","1534.31159643","1.23051927939"
"SL2.50ch00:14696361-14697794","18","14696361","14697794","1433","1534.31159643","0.933969347121"
"SL2.50ch00:14763890-14767757","46","14763890","14767757","3867","1534.31159643","2.52034854523"
"SL2.50ch00:14796450-14797304","13","14796450","14797304","854","1534.31159643","0.556601411334"
"SL2.50ch00:14801775-14802268","6","14801775","14802268","493","1534.31159643","0.321316739798"
"SL2.50ch00:14801812-14802187","6","14801812","14802187","375","1534.31159643","0.244409284836"
"SL2.50ch00:14804036-14805741","85","14804036","14805741","1705","1534.31159643","1.11124754839"
"SL2.50ch00:14804047-14805761","85","14804047","14805761","1714","1534.31159643","1.11711337123"
"SL2.50ch00:14887886-14889159","18","14887886","14889159","1273","1534.31159643","0.829688052258"
"SL2.50ch00:14959706-14961350","19","14959706","14961350","1644","1534.31159643","1.07149030472"
"SL2.50ch00:14962620-14963671","28","14962620","14963671","1051","1534.31159643","0.684997755635"
"SL2.50ch00:14962621-14963717","28","14962621","14963717","1096","1534.31159643","0.714326869815"
"SL2.50ch00:14992372-14993724","13","14992372","14993724","1352","1534.31159643","0.881176941597"
"SL2.50ch00:14994688-14996344","22","14994688","14996344","1656","1534.31159643","1.07931140184"
"SL2.50ch00:14999654-15000532","17","14999654","15000532","878","1534.31159643","0.572243605563"
"SL2.50ch00:14999679-15000674","17","14999679","15000674","995","1534.31159643","0.648499302432"
"SL2.50ch00:15070855-15071640","17","15070855","15071640","785","1534.31159643","0.511630102924"
"SL2.50ch00:15134766-15135403","2","15134766","15135403","637","1534.31159643","0.415169905175"
"SL2.50ch00:15136958-15137695","1","15136958","15137695","737","1534.31159643","0.480345714465"
"SL2.50ch00:15138696-15139752","13","15138696","15139752","1056","1534.31159643","0.688256546099"
"SL2.50ch00:15142584-15146512","78","15142584","15146512","3928","1534.31159643","2.5601057889"
"SL2.50ch00:15144506-15146445","43","15144506","15146445","1939","1534.31159643","1.26375894213"
"SL2.50ch00:15289995-15291411","43","15289995","15291411","1416","1534.31159643","0.922889459542"
"SL2.50ch00:15290061-15291623","44","15290061","15291623","1562","1534.31159643","1.0180461411"
"SL2.50ch00:15292978-15293623","7","15292978","15293623","645","1534.31159643","0.420383969918"
"SL2.50ch00:15313988-15314494","7","15313988","15314494","506","1534.31159643","0.329789595006"
"SL2.50ch00:15316587-15317171","9","15316587","15317171","584","1534.31159643","0.380626726252"
"SL2.50ch00:15321351-15322481","52","15321351","15322481","1130","1534.31159643","0.736486644973"
"SL2.50ch00:15321397-15322339","52","15321397","15322339","942","1534.31159643","0.613956123509"
"SL2.50ch00:15324295-15325261","46","15324295","15325261","966","1534.31159643","0.629598317738"
"SL2.50ch00:15324356-15325273","46","15324356","15325273","917","1534.31159643","0.597662171186"
"SL2.50ch00:15345089-15346312","17","15345089","15346312","1223","1534.31159643","0.797100147613"
"SL2.50ch00:15348029-15348863","27","15348029","15348863","834","1534.31159643","0.543566249476"
"SL2.50ch00:15348054-15348898","27","15348054","15348898","844","1534.31159643","0.550083830405"
"SL2.50ch00:15360589-15361715","24","15360589","15361715","1126","1534.31159643","0.733879612602"
"SL2.50ch00:15360750-15361620","24","15360750","15361620","870","1534.31159643","0.56702954082"
"SL2.50ch00:15363027-15364516","26","15363027","15364516","1489","1534.31159643","0.970467800323"
"SL2.50ch00:15385655-15387683","25","15385655","15387683","2028","1534.31159643","1.32176541239"
"SL2.50ch00:15450306-15451191","18","15450306","15451191","885","1534.31159643","0.576805912214"
"SL2.50ch00:15452774-15453783","14","15452774","15453783","1009","1534.31159643","0.657623915733"
"SL2.50ch00:15452872-15453851","14","15452872","15453851","979","1534.31159643","0.638071172946"
"SL2.50ch00:15473228-15477148","117","15473228","15477148","3920","1534.31159643","2.55489172416"
"SL2.50ch00:15473356-15477106","117","15473356","15477106","3750","1534.31159643","2.44409284836"
"SL2.50ch00:15526084-15526576","1","15526084","15526576","492","1534.31159643","0.320664981705"
"SL2.50ch00:15534724-15536198","175","15534724","15536198","1474","1534.31159643","0.96069142893"
"SL2.50ch00:15534728-15536278","175","15534728","15536278","1550","1534.31159643","1.01022504399"
"SL2.50ch00:15538066-15542541","587","15538066","15542541","4475","1534.31159643","2.91661746571"
"SL2.50ch00:15538082-15542586","587","15538082","15542586","4504","1534.31159643","2.93551845041"
"SL2.50ch00:15813963-15814651","31","15813963","15814651","688","1534.31159643","0.448409567913"
"SL2.50ch00:15813982-15814619","31","15813982","15814619","637","1534.31159643","0.415169905175"
"SL2.50ch00:15816197-15816760","9","15816197","15816760","563","1534.31159643","0.366939806301"
"SL2.50ch00:15864409-15865185","6","15864409","15865185","776","1534.31159643","0.505764280088"
"SL2.50ch00:15877069-15880573","109","15877069","15880573","3504","1534.31159643","2.28376035751"
"SL2.50ch00:15877180-15880658","106","15877180","15880658","3478","1534.31159643","2.2668146471"
"SL2.50ch00:15884540-15887881","45","15884540","15887881","3341","1534.31159643","2.17752378837"
"SL2.50ch00:15902889-15903811","17","15902889","15903811","922","1534.31159643","0.600920961651"
"SL2.50ch00:15905703-15906313","7","15905703","15906313","610","1534.31159643","0.397572436667"
"SL2.50ch00:15905756-15906358","7","15905756","15906358","602","1534.31159643","0.392358371924"
"SL2.50ch00:15917581-15920900","21","15917581","15920900","3319","1534.31159643","2.16318511032"
"SL2.50ch00:15961446-15961917","12","15961446","15961917","471","1534.31159643","0.306978061754"
"SL2.50ch00:15963788-15964915","19","15963788","15964915","1127","1534.31159643","0.734531370695"
"SL2.50ch00:15964462-15964952","15","15964462","15964952","490","1534.31159643","0.319361465519"
"SL2.50ch00:15997704-16001211","54","15997704","16001211","3507","1534.31159643","2.28571563179"
"SL2.50ch00:16026783-16030116","111","16026783","16030116","3333","1534.31159643","2.17230972363"
"SL2.50ch00:16026828-16030185","110","16026828","16030185","3357","1534.31159643","2.18795191785"
"SL2.50ch00:16051815-16055485","522","16051815","16055485","3670","1534.31159643","2.39195220093"
"SL2.50ch00:16051850-16055438","522","16051850","16055438","3588","1534.31159643","2.33850803731"
"SL2.50ch00:16145175-16146605","11","16145175","16146605","1430","1534.31159643","0.932014072843"
"SL2.50ch00:16180766-16184283","414","16180766","16184283","3517","1534.31159643","2.29223321272"
"SL2.50ch00:16180773-16184261","413","16180773","16184261","3488","1534.31159643","2.27333222802"
"SL2.50ch00:16195117-16198253","39","16195117","16198253","3136","1534.31159643","2.04391337932"
"SL2.50ch00:16243371-16243856","6","16243371","16243856","485","1534.31159643","0.316102675055"
"SL2.50ch00:16246848-16247320","9","16246848","16247320","472","1534.31159643","0.307629819847"
"SL2.50ch00:16302660-16303035","8","16302660","16303035","375","1534.31159643","0.244409284836"
"SL2.50ch00:16310899-16312329","62","16310899","16312329","1430","1534.31159643","0.932014072843"
"SL2.50ch00:16310933-16312394","62","16310933","16312394","1461","1534.31159643","0.952218573722"
"SL2.50ch00:16313954-16314469","6","16313954","16314469","515","1534.31159643","0.335655417842"
"SL2.50ch00:16313979-16314448","6","16313979","16314448","469","1534.31159643","0.305674545569"
"SL2.50ch00:16384258-16388143","68","16384258","16388143","3885","1534.31159643","2.5320801909"
"SL2.50ch00:16390456-16390831","1","16390456","16390831","375","1534.31159643","0.244409284836"
"SL2.50ch00:16397852-16401510","371","16397852","16401510","3658","1534.31159643","2.38413110382"
"SL2.50ch00:16397959-16401520","370","16397959","16401520","3561","1534.31159643","2.32091056881"
"SL2.50ch00:16531803-16534845","33","16531803","16534845","3042","1534.31159643","1.98264811859"
"SL2.50ch00:16548958-16549602","11","16548958","16549602","644","1534.31159643","0.419732211826"
"SL2.50ch00:16562327-16565754","76","16562327","16565754","3427","1534.31159643","2.23357498436"
"SL2.50ch00:16562526-16565671","76","16562526","16565671","3145","1534.31159643","2.04977920216"
"SL2.50ch00:16636903-16639894","182","16636903","16639894","2991","1534.31159643","1.94940845585"
"SL2.50ch00:16636951-16639807","180","16636951","16639807","2856","1534.31159643","1.86142111331"
"SL2.50ch00:16661189-16666628","84","16661189","16666628","5439","1534.31159643","3.54491226727"
"SL2.50ch00:16797300-16797965","4","16797300","16797965","665","1534.31159643","0.433419131776"
"SL2.50ch00:16901241-16904600","163","16901241","16904600","3359","1534.31159643","2.18925543404"
"SL2.50ch00:16901244-16904630","163","16901244","16904630","3386","1534.31159643","2.20685290255"
"SL2.50ch00:16950123-16951238","43","16950123","16951238","1115","1534.31159643","0.72671027358"
"SL2.50ch00:16950220-16951183","43","16950220","16951183","963","1534.31159643","0.62764304346"
"SL2.50ch00:16952572-16953439","38","16952572","16953439","867","1534.31159643","0.565074266542"
"SL2.50ch00:16952601-16953386","38","16952601","16953386","785","1534.31159643","0.511630102924"
"SL2.50ch00:16962948-16963999","54","16962948","16963999","1051","1534.31159643","0.684997755635"
"SL2.50ch00:16963037-16964051","54","16963037","16964051","1014","1534.31159643","0.660882706197"
"SL2.50ch00:16965773-16966395","37","16965773","16966395","622","1534.31159643","0.405393533782"
"SL2.50ch00:16965798-16966412","37","16965798","16966412","614","1534.31159643","0.400179469039"
"SL2.50ch00:17011555-17014738","73","17011555","17014738","3183","1534.31159643","2.07454600969"
"SL2.50ch00:17011559-17012573","34","17011559","17012573","1014","1534.31159643","0.660882706197"
"SL2.50ch00:17013165-17014373","30","17013165","17014373","1208","1534.31159643","0.787323776219"
"SL2.50ch00:17108285-17108956","8","17108285","17108956","671","1534.31159643","0.437329680334"
"SL2.50ch00:17155453-17158858","385","17155453","17158858","3405","1534.31159643","2.21923630631"
"SL2.50ch00:17155518-17158822","385","17155518","17158822","3304","1534.31159643","2.15340873893"
"SL2.50ch00:17231414-17234424","59","17231414","17234424","3010","1534.31159643","1.96179185962"
"SL2.50ch00:17232073-17233272","21","17232073","17233272","1199","1534.31159643","0.781457953383"
"SL2.50ch00:17297353-17300479","51","17297353","17300479","3126","1534.31159643","2.0373957984"
"SL2.50ch00:17347262-17350306","72","17347262","17350306","3044","1534.31159643","1.98395163478"
"SL2.50ch00:17347394-17350094","72","17347394","17350094","2700","1534.31159643","1.75974685082"
"SL2.50ch00:17458431-17461337","72","17458431","17461337","2906","1534.31159643","1.89400901796"
"SL2.50ch00:17458519-17461249","72","17458519","17461249","2730","1534.31159643","1.77929959361"
"SL2.50ch00:17522838-17525278","149","17522838","17525278","2440","1534.31159643","1.59028974667"
"SL2.50ch00:17522877-17525089","146","17522877","17525089","2212","1534.31159643","1.44168890149"
"SL2.50ch00:17634706-17637644","226","17634706","17637644","2938","1534.31159643","1.91486527693"
"SL2.50ch00:17634719-17637657","226","17634719","17637657","2938","1534.31159643","1.91486527693"
"SL2.50ch00:17652904-17654436","14","17652904","17654436","1532","1534.31159643","0.998493398318"
"SL2.50ch00:17676871-17678777","17","17676871","17678777","1906","1534.31159643","1.24225092506"
"SL2.50ch00:17745760-17747595","29","17745760","17747595","1835","1534.31159643","1.19597610047"
"SL2.50ch00:17769299-17772197","46","17769299","17772197","2898","1534.31159643","1.88879495322"
"SL2.50ch00:17769615-17772018","44","17769615","17772018","2403","1534.31159643","1.56617469723"
"SL2.50ch00:17840045-17843138","317","17840045","17843138","3093","1534.31159643","2.01588778133"
"SL2.50ch00:17840185-17843265","317","17840185","17843265","3080","1534.31159643","2.00741492612"
"SL2.50ch00:17905540-17907366","21","17905540","17907366","1826","1534.31159643","1.19011027763"
"SL2.50ch00:18009693-18011842","25","18009693","18011842","2149","1534.31159643","1.40062814164"
"SL2.50ch00:18038596-18041304","33","18038596","18041304","2708","1534.31159643","1.76496091556"
"SL2.50ch00:18047321-18054356","121","18047321","18054356","7035","1534.31159643","4.58511818353"
"SL2.50ch00:18049820-18050552","27","18049820","18050552","732","1534.31159643","0.477086924001"
"SL2.50ch00:18051280-18053653","62","18051280","18053653","2373","1534.31159643","1.54662195444"
"SL2.50ch00:18116521-18121684","97","18116521","18121684","5163","1534.31159643","3.36502703363"
"SL2.50ch00:18118169-18120210","55","18118169","18120210","2041","1534.31159643","1.3302382676"
"SL2.50ch00:18193929-18194470","3","18193929","18194470","541","1534.31159643","0.352601128257"
"SL2.50ch00:18228173-18230903","70","18228173","18230903","2730","1534.31159643","1.77929959361"
"SL2.50ch00:18228196-18232576","89","18228196","18232576","4380","1534.31159643","2.85470044689"
"SL2.50ch00:18254468-18256503","30","18254468","18256503","2035","1534.31159643","1.32632771905"
"SL2.50ch00:18254666-18256425","28","18254666","18256425","1759","1534.31159643","1.14644248541"
"SL2.50ch00:1830139-1830734","6","1830139","1830734","595","1534.31159643","0.387796065274"
"SL2.50ch00:18315727-18318694","134","18315727","18318694","2967","1534.31159643","1.93376626163"
"SL2.50ch00:18315918-18318654","131","18315918","18318654","2736","1534.31159643","1.78321014217"
"SL2.50ch00:18352239-18355419","465","18352239","18355419","3180","1534.31159643","2.07259073541"
"SL2.50ch00:18352393-18355388","464","18352393","18355388","2995","1534.31159643","1.95201548823"
"SL2.50ch00:1836924-1838142","7","1836924","1838142","1218","1534.31159643","0.793841357148"
"SL2.50ch00:18372252-18372987","1","18372252","18372987","735","1534.31159643","0.479042198279"
"SL2.50ch00:18432610-18433394","9","18432610","18433394","784","1534.31159643","0.510978344831"
"SL2.50ch00:18432644-18433447","9","18432644","18433447","803","1534.31159643","0.523361748596"
"SL2.50ch00:18444937-18445406","6","18444937","18445406","469","1534.31159643","0.305674545569"
"SL2.50ch00:18489945-18491175","39","18489945","18491175","1230","1534.31159643","0.801662454263"
"SL2.50ch00:18490219-18491195","35","18490219","18491195","976","1534.31159643","0.636115898667"
"SL2.50ch00:18581801-18582319","10","18581801","18582319","518","1534.31159643","0.337610692121"
"SL2.50ch00:18581886-18583006","18","18581886","18583006","1120","1534.31159643","0.729969064045"
"SL2.50ch00:18649038-18651648","38","18649038","18651648","2610","1534.31159643","1.70108862246"
"SL2.50ch00:18776724-18779463","138","18776724","18779463","2739","1534.31159643","1.78516541644"
"SL2.50ch00:18776886-18779460","138","18776886","18779460","2574","1534.31159643","1.67762533112"
"SL2.50ch00:1883241-1883777","1","1883241","1883777","536","1534.31159643","0.349342337793"
"SL2.50ch00:18865873-18866449","6","18865873","18866449","576","1534.31159643","0.375412661509"
"SL2.50ch00:18867384-18867973","2","18867384","18867973","589","1534.31159643","0.383885516716"
"SL2.50ch00:18909152-18911104","28","18909152","18911104","1952","1534.31159643","1.27223179733"
"SL2.50ch00:19091722-19094319","94","19091722","19094319","2597","1534.31159643","1.69261576725"
"SL2.50ch00:19091741-19094360","94","19091741","19094360","2619","1534.31159643","1.7069544453"
"SL2.50ch00:19120479-19124133","303","19120479","19124133","3654","1534.31159643","2.38152407145"
"SL2.50ch00:19120488-19123280","289","19120488","19123280","2792","1534.31159643","1.81970859537"
"SL2.50ch00:19155843-19156218","2","19155843","19156218","375","1534.31159643","0.244409284836"
"SL2.50ch00:19180993-19181586","10","19180993","19181586","593","1534.31159643","0.386492549088"
"SL2.50ch00:19308101-19310396","52","19308101","19310396","2295","1534.31159643","1.4957848232"
"SL2.50ch00:19308172-19311107","52","19308172","19311107","2935","1534.31159643","1.91291000265"
"SL2.50ch00:19321130-19323261","19","19321130","19323261","2131","1534.31159643","1.38889649596"
"SL2.50ch00:19374797-19377125","48","19374797","19377125","2328","1534.31159643","1.51729284026"
"SL2.50ch00:19374876-19377056","47","19374876","19377056","2180","1534.31159643","1.42083264252"
"SL2.50ch00:19408083-19410487","59","19408083","19410487","2404","1534.31159643","1.56682645532"
"SL2.50ch00:19408199-19410489","57","19408199","19410489","2290","1534.31159643","1.49252603273"
"SL2.50ch00:19415732-19418158","15","19415732","19418158","2426","1534.31159643","1.58116513337"
"SL2.50ch00:19613012-19615919","722","19613012","19615919","2907","1534.31159643","1.89466077605"
"SL2.50ch00:19613176-19615825","722","19613176","19615825","2649","1534.31159643","1.72650718808"
"SL2.50ch00:19656464-19656866","33","19656464","19656866","402","1534.31159643","0.262006753345"
"SL2.50ch00:19703176-19705907","220","19703176","19705907","2731","1534.31159643","1.7799513517"
"SL2.50ch00:19703304-19705795","220","19703304","19705795","2491","1534.31159643","1.62352940941"
"SL2.50ch00:19810081-19812489","86","19810081","19812489","2408","1534.31159643","1.5694334877"
"SL2.50ch00:19810215-19812401","86","19810215","19812401","2186","1534.31159643","1.42474319107"
"SL2.50ch00:19862505-19864234","17","19862505","19864234","1729","1534.31159643","1.12688974262"
"SL2.50ch00:19915870-19918441","246","19915870","19918441","2571","1534.31159643","1.67567005684"
"SL2.50ch00:19915931-19918385","246","19915931","19918385","2454","1534.31159643","1.59941435997"
"SL2.50ch00:19964876-19967243","123","19964876","19967243","2367","1534.31159643","1.54271140589"
"SL2.50ch00:19964877-19967210","123","19964877","19967210","2333","1534.31159643","1.52055163073"
"SL2.50ch00:19980390-19980765","1","19980390","19980765","375","1534.31159643","0.244409284836"
"SL2.50ch00:19987604-19989029","24","19987604","19989029","1425","1534.31159643","0.928755282378"
"SL2.50ch00:19987776-19988410","22","19987776","19988410","634","1534.31159643","0.413214630897"
"SL2.50ch00:20025559-20028106","52","20025559","20028106","2547","1534.31159643","1.66002786261"
"SL2.50ch00:20025779-20028021","52","20025779","20028021","2242","1534.31159643","1.46124164427"
"SL2.50ch00:20087085-20087673","7","20087085","20087673","588","1534.31159643","0.383233758623"
"SL2.50ch00:20105409-20107747","39","20105409","20107747","2338","1534.31159643","1.52381042119"
"SL2.50ch00:20154072-20154447","1","20154072","20154447","375","1534.31159643","0.244409284836"
"SL2.50ch00:20160747-20163181","351","20160747","20163181","2434","1534.31159643","1.58637919811"
"SL2.50ch00:20160753-20164220","353","20160753","20164220","3467","1534.31159643","2.25964530807"
"SL2.50ch00:20274369-20275198","1","20274369","20275198","829","1534.31159643","0.540307459012"
"SL2.50ch00:20292130-20292754","27","20292130","20292754","624","1534.31159643","0.406697049968"
"SL2.50ch00:20292136-20292792","27","20292136","20292792","656","1534.31159643","0.42755330894"
"SL2.50ch00:20365202-20366162","17","20365202","20366162","960","1534.31159643","0.625687769181"
"SL2.50ch00:20365252-20366596","26","20365252","20366596","1344","1534.31159643","0.875962876853"
"SL2.50ch00:20415259-20416048","4","20415259","20416048","789","1534.31159643","0.514237135296"
"SL2.50ch00:20426279-20428437","21","20426279","20428437","2158","1534.31159643","1.40649396447"
"SL2.50ch00:20491822-20493794","62","20491822","20493794","1972","1534.31159643","1.28526695919"
"SL2.50ch00:20491861-20493799","63","20491861","20493799","1938","1534.31159643","1.26310718403"
"SL2.50ch00:20541255-20542338","29","20541255","20542338","1083","1534.31159643","0.705854014607"
"SL2.50ch00:20624146-20626211","23","20624146","20626211","2065","1534.31159643","1.34588046183"
"SL2.50ch00:20749039-20749529","35","20749039","20749529","490","1534.31159643","0.319361465519"
"SL2.50ch00:20777892-20780054","46","20777892","20780054","2162","1534.31159643","1.40910099684"
"SL2.50ch00:20777928-20780073","46","20777928","20780073","2145","1534.31159643","1.39802110926"
"SL2.50ch00:20830117-20830945","18","20830117","20830945","828","1534.31159643","0.539655700919"
"SL2.50ch00:20831384-20832346","28","20831384","20832346","962","1534.31159643","0.626991285367"
"SL2.50ch00:20864130-20866078","7","20864130","20866078","1948","1534.31159643","1.26962476496"
"SL2.50ch00:20877605-20879666","24","20877605","20879666","2061","1534.31159643","1.34327342946"
"SL2.50ch00:20882046-20884435","227","20882046","20884435","2389","1534.31159643","1.55705008393"
"SL2.50ch00:20882211-20884411","227","20882211","20884411","2200","1534.31159643","1.43386780437"
"SL2.50ch00:20906990-20907526","12","20906990","20907526","536","1534.31159643","0.349342337793"
"SL2.50ch00:20907076-20907657","12","20907076","20907657","581","1534.31159643","0.378671451973"
"SL2.50ch00:20997901-20998276","5","20997901","20998276","375","1534.31159643","0.244409284836"
"SL2.50ch00:21017370-21018552","5","21017370","21018552","1182","1534.31159643","0.770378065804"
"SL2.50ch00:21068452-21068922","3","21068452","21068922","470","1534.31159643","0.306326303662"
"SL2.50ch00:21112860-21114851","21","21112860","21114851","1991","1534.31159643","1.29765036296"
"SL2.50ch00:21135383-21137048","37","21135383","21137048","1665","1534.31159643","1.08517722467"
"SL2.50ch00:21140175-21141383","7","21140175","21141383","1208","1534.31159643","0.787323776219"
"SL2.50ch00:21146047-21148307","132","21146047","21148307","2260","1534.31159643","1.47297328995"
"SL2.50ch00:21146234-21148270","129","21146234","21148270","2036","1534.31159643","1.32697947714"
"SL2.50ch00:2114778-2115273","5","2114778","2115273","495","1534.31159643","0.322620255984"
"SL2.50ch00:21175156-21176844","21","21175156","21176844","1688","1534.31159643","1.10016766081"
"SL2.50ch00:21199214-21203993","114","21199214","21203993","4779","1534.31159643","3.11475192595"
"SL2.50ch00:21260908-21263725","16","21260908","21263725","2817","1534.31159643","1.83600254769"
"SL2.50ch00:21271895-21273771","26","21271895","21273771","1876","1534.31159643","1.22269818227"
"SL2.50ch00:21272346-21273820","25","21272346","21273820","1474","1534.31159643","0.96069142893"
"SL2.50ch00:21287473-21289324","16","21287473","21289324","1851","1534.31159643","1.20640422995"
"SL2.50ch00:21346188-21348062","20","21346188","21348062","1874","1534.31159643","1.22139466609"
"SL2.50ch00:21458881-21460878","50","21458881","21460878","1997","1534.31159643","1.30156091152"
"SL2.50ch00:21459024-21459995","38","21459024","21459995","971","1534.31159643","0.632857108203"
"SL2.50ch00:21473169-21473936","17","21473169","21473936","767","1534.31159643","0.499898457252"
"SL2.50ch00:2151036-2151770","20","2151036","2151770","734","1534.31159643","0.478390440186"
"SL2.50ch00:2151057-2151741","20","2151057","2151741","684","1534.31159643","0.445802535541"
"SL2.50ch00:2152489-2152891","7","2152489","2152891","402","1534.31159643","0.262006753345"
"SL2.50ch00:21534339-21536482","215","21534339","21536482","2143","1534.31159643","1.39671759308"
"SL2.50ch00:21534363-21537085","215","21534363","21537085","2722","1534.31159643","1.77408552887"
"SL2.50ch00:21544987-21546892","69","21544987","21546892","1905","1534.31159643","1.24159916697"
"SL2.50ch00:21545035-21546976","69","21545035","21546976","1941","1534.31159643","1.26506245831"
"SL2.50ch00:2157345-2158512","9","2157345","2158512","1167","1534.31159643","0.760601694411"
"SL2.50ch00:21609018-21609938","39","21609018","21609938","920","1534.31159643","0.599617445465"
"SL2.50ch00:21609031-21609863","38","21609031","21609863","832","1534.31159643","0.54226273329"
"SL2.50ch00:21610783-21611254","1","21610783","21611254","471","1534.31159643","0.306978061754"
"SL2.50ch00:2165440-2166114","12","2165440","2166114","674","1534.31159643","0.439284954612"
"SL2.50ch00:2165627-2166029","12","2165627","2166029","402","1534.31159643","0.262006753345"
"SL2.50ch00:21668893-21669745","3","21668893","21669745","852","1534.31159643","0.555297895148"
"SL2.50ch00:21692017-21694258","222","21692017","21694258","2241","1534.31159643","1.46058988618"
"SL2.50ch00:21692070-21694331","222","21692070","21694331","2261","1534.31159643","1.47362504804"
"SL2.50ch00:21703332-21704354","14","21703332","21704354","1022","1534.31159643","0.666096770941"
"SL2.50ch00:21747207-21748979","35","21747207","21748979","1772","1534.31159643","1.15491534061"
"SL2.50ch00:21747247-21748966","35","21747247","21748966","1719","1534.31159643","1.12037216169"
"SL2.50ch00:21751352-21752240","7","21751352","21752240","888","1534.31159643","0.578761186492"
"SL2.50ch00:21763890-21765924","35","21763890","21765924","2034","1534.31159643","1.32567596095"
"SL2.50ch00:21763905-21765944","35","21763905","21765944","2039","1534.31159643","1.32893475142"
"SL2.50ch00:21774465-21776250","38","21774465","21776250","1785","1534.31159643","1.16338819582"
"SL2.50ch00:21774521-21776451","37","21774521","21776451","1930","1534.31159643","1.25789311929"
"SL2.50ch00:2348499-2348989","7","2348499","2348989","490","1534.31159643","0.319361465519"
"SL2.50ch00:2742385-2742760","0","2742385","2742760","375","1534.31159643","0.244409284836"
"SL2.50ch00:2919366-2920938","14","2919366","2920938","1572","1534.31159643","1.02456372203"
"SL2.50ch00:4157735-4160963","504","4157735","4160963","3228","1534.31159643","2.10387512387"
"SL2.50ch00:4157848-4160945","504","4157848","4160945","3097","1534.31159643","2.0184948137"
"SL2.50ch00:4161576-4164455","168","4161576","4164455","2879","1534.31159643","1.87641154945"
"SL2.50ch00:4161731-4164605","166","4161731","4164605","2874","1534.31159643","1.87315275899"
"SL2.50ch00:4167825-4177058","426","4167825","4177058","9233","1534.31159643","6.01768247172"
"SL2.50ch00:4167834-4176955","426","4167834","4176955","9121","1534.31159643","5.94468556531"
"SL2.50ch00:4197207-4198392","751","4197207","4198392","1185","1534.31159643","0.772333340083"
"SL2.50ch00:4276977-4277379","34","4276977","4277379","402","1534.31159643","0.262006753345"
"SL2.50ch00:4773375-4774141","14","4773375","4774141","766","1534.31159643","0.499246699159"
"SL2.50ch00:5602034-5602409","3","5602034","5602409","375","1534.31159643","0.244409284836"
"SL2.50ch00:5616669-5620459","59","5616669","5620459","3790","1534.31159643","2.47016317208"
"SL2.50ch00:5642165-5643281","25","5642165","5643281","1116","1534.31159643","0.727362031673"
"SL2.50ch00:5659910-5662237","21","5659910","5662237","2327","1534.31159643","1.51664108217"
"SL2.50ch00:5662920-5664620","13","5662920","5664620","1700","1534.31159643","1.10798875792"
"SL2.50ch00:5670417-5671518","12","5670417","5671518","1101","1534.31159643","0.717585660279"
"SL2.50ch00:5670439-5671502","12","5670439","5671502","1063","1534.31159643","0.692818852749"
"SL2.50ch00:5679179-5680540","38","5679179","5680540","1361","1534.31159643","0.887042764433"
"SL2.50ch00:5688585-5688960","4","5688585","5688960","375","1534.31159643","0.244409284836"
"SL2.50ch00:5695677-5696236","9","5695677","5696236","559","1534.31159643","0.364332773929"
"SL2.50ch00:5702468-5702843","7","5702468","5702843","375","1534.31159643","0.244409284836"
"SL2.50ch00:5732107-5733246","24","5732107","5733246","1139","1534.31159643","0.74235246781"
"SL2.50ch00:6142753-6143436","0","6142753","6143436","683","1534.31159643","0.445150777449"
"SL2.50ch00:7117964-7119699","24","7117964","7119699","1735","1534.31159643","1.13080029118"
"SL2.50ch00:7130210-7132708","8","7130210","7132708","2498","1534.31159643","1.62809171606"
"SL2.50ch00:7367820-7369727","78","7367820","7369727","1907","1534.31159643","1.24290268315"
"SL2.50ch00:7367872-7369698","78","7367872","7369698","1826","1534.31159643","1.19011027763"
"SL2.50ch00:7371640-7372542","28","7371640","7372542","902","1534.31159643","0.587885799793"
"SL2.50ch00:7371735-7372618","26","7371735","7372618","883","1534.31159643","0.575502396028"
"SL2.50ch00:7384065-7384798","10","7384065","7384798","733","1534.31159643","0.477738682093"
"SL2.50ch00:7397012-7399682","30","7397012","7399682","2670","1534.31159643","1.74019410803"
"SL2.50ch00:7401785-7404433","25","7401785","7404433","2648","1534.31159643","1.72585542999"
"SL2.50ch00:7416709-7434427","590","7416709","7434427","17718","1534.31159643","11.5478498899"
"SL2.50ch00:7416807-7433524","587","7416807","7433524","16717","1534.31159643","10.895440039"
"SL2.50ch00:7439145-7440035","17","7439145","7440035","890","1534.31159643","0.580064702678"
"SL2.50ch00:7439325-7440043","17","7439325","7440043","718","1534.31159643","0.4679623107"
"SL2.50ch00:7445572-7446525","11","7445572","7446525","953","1534.31159643","0.621125462531"
"SL2.50ch00:7445981-7446383","3","7445981","7446383","402","1534.31159643","0.262006753345"
"SL2.50ch00:7446992-7448000","13","7446992","7448000","1008","1534.31159643","0.65697215764"
"SL2.50ch00:7447280-7447799","9","7447280","7447799","519","1534.31159643","0.338262450213"
"SL2.50ch00:7450965-7451996","29","7450965","7451996","1031","1534.31159643","0.671962593777"
"SL2.50ch00:7451097-7452137","31","7451097","7452137","1040","1534.31159643","0.677828416613"
"SL2.50ch00:7460262-7460761","2","7460262","7460761","499","1534.31159643","0.325227288356"
"SL2.50ch00:7471507-7476253","68","7471507","7476253","4746","1534.31159643","3.09324390889"
"SL2.50ch00:7479522-7487142","105","7479522","7487142","7620","1534.31159643","4.96639666787"
"SL2.50ch00:7490725-7500229","125","7490725","7500229","9504","1534.31159643","6.19430891489"
"SL2.50ch00:7491792-7492302","15","7491792","7492302","510","1534.31159643","0.332396627377"
"SL2.50ch00:7498586-7501310","20","7498586","7501310","2724","1534.31159643","1.77538904505"
"SL2.50ch00:7500620-7506914","79","7500620","7506914","6294","1534.31159643","4.10216543669"
"SL2.50ch00:7509669-7510801","3","7509669","7510801","1132","1534.31159643","0.737790161159"
"SL2.50ch00:7541050-7541518","3","7541050","7541518","468","1534.31159643","0.305022787476"
"SL2.50ch00:7579530-7579932","2","7579530","7579932","402","1534.31159643","0.262006753345"
"SL2.50ch00:7590284-7591139","15","7590284","7591139","855","1534.31159643","0.557253169427"
"SL2.50ch00:7606252-7607258","11","7606252","7607258","1006","1534.31159643","0.655668641454"
"SL2.50ch00:7616018-7616990","11","7616018","7616990","972","1534.31159643","0.633508866296"
"SL2.50ch00:7620526-7621681","13","7620526","7621681","1155","1534.31159643","0.752780597296"
"SL2.50ch00:7656885-7660433","52","7656885","7660433","3548","1534.31159643","2.3124377136"
"SL2.50ch00:7661081-7669795","100","7661081","7669795","8714","1534.31159643","5.6794200215"
"SL2.50ch00:7662946-7664855","24","7662946","7664855","1909","1534.31159643","1.24420619934"
"SL2.50ch00:7672626-7673795","7","7672626","7673795","1169","1534.31159643","0.761905210596"
"SL2.50ch00:7691533-7692347","7","7691533","7692347","814","1534.31159643","0.530531087618"
"SL2.50ch00:7713420-7713893","2","7713420","7713893","473","1534.31159643","0.30828157794"
"SL2.50ch00:7719006-7719514","6","7719006","7719514","508","1534.31159643","0.331093111192"
"SL2.50ch00:7721181-7722021","16","7721181","7722021","840","1534.31159643","0.547476798033"
"SL2.50ch00:7721239-7722046","17","7721239","7722046","807","1534.31159643","0.525968780968"
"SL2.50ch00:7730321-7731140","3","7730321","7731140","819","1534.31159643","0.533789878083"
"SL2.50ch00:7739489-7740197","10","7739489","7740197","708","1534.31159643","0.461444729771"
"SL2.50ch00:7754040-7755275","11","7754040","7755275","1235","1534.31159643","0.804921244728"
"SL2.50ch00:7756901-7757369","5","7756901","7757369","468","1534.31159643","0.305022787476"
"SL2.50ch00:7766690-7769066","18","7766690","7769066","2376","1534.31159643","1.54857722872"
"SL2.50ch00:7785059-7785575","4","7785059","7785575","516","1534.31159643","0.336307175935"
"SL2.50ch00:7799390-7806858","190","7799390","7806858","7468","1534.31159643","4.86732943775"
"SL2.50ch00:7799454-7806901","190","7799454","7806901","7447","1534.31159643","4.8536425178"
"SL2.50ch00:7809268-7810269","8","7809268","7810269","1001","1534.31159643","0.65240985099"
"SL2.50ch00:7809711-7810220","8","7809711","7810220","509","1534.31159643","0.331744869285"
"SL2.50ch00:7814168-7815414","16","7814168","7815414","1246","1534.31159643","0.81209058375"
"SL2.50ch00:7818076-7820680","92","7818076","7820680","2604","1534.31159643","1.6971780739"
"SL2.50ch00:7818077-7820656","92","7818077","7820656","2579","1534.31159643","1.68088412158"
"SL2.50ch00:7828668-7844046","244","7828668","7844046","15378","1534.31159643","10.0227359526"
"SL2.50ch00:7831950-7832440","7","7831950","7832440","490","1534.31159643","0.319361465519"
"SL2.50ch00:7844567-7847469","56","7844567","7847469","2902","1534.31159643","1.89140198559"
"SL2.50ch00:7851428-7857297","87","7851428","7857297","5869","1534.31159643","3.82516824721"
"SL2.50ch00:7851906-7852308","1","7851906","7852308","402","1534.31159643","0.262006753345"
"SL2.50ch00:7859979-7865114","89","7859979","7865114","5135","1534.31159643","3.34677780703"
"SL2.50ch00:7874772-7875536","4","7874772","7875536","764","1534.31159643","0.497943182973"
"SL2.50ch00:7905436-7905913","9","7905436","7905913","477","1534.31159643","0.310888610312"
"SL2.50ch00:7908163-7909949","39","7908163","7909949","1786","1534.31159643","1.16403995391"
"SL2.50ch00:7908165-7909400","35","7908165","7909400","1235","1534.31159643","0.804921244728"
"SL2.50ch00:7919055-7921461","32","7919055","7921461","2406","1534.31159643","1.56812997151"
"SL2.50ch00:7954819-7956468","19","7954819","7956468","1649","1534.31159643","1.07474909519"
"SL2.50ch00:7957368-7958191","9","7957368","7958191","823","1534.31159643","0.536396910454"
"SL2.50ch00:7973260-7973939","9","7973260","7973939","679","1534.31159643","0.442543745077"
"SL2.50ch00:7981859-7984915","49","7981859","7984915","3056","1534.31159643","1.99177273189"
"SL2.50ch00:7982159-7984055","33","7982159","7984055","1896","1534.31159643","1.23573334413"
"SL2.50ch00:7992271-7995759","98","7992271","7995759","3488","1534.31159643","2.27333222802"
"SL2.50ch00:7992524-7995740","96","7992524","7995740","3216","1534.31159643","2.09605402676"
"SL2.50ch00:7997016-7999653","63","7997016","7999653","2637","1534.31159643","1.71868609097"
"SL2.50ch00:7997057-7999598","63","7997057","7999598","2541","1534.31159643","1.65611731405"
"SL2.50ch00:8003886-8008250","75","8003886","8008250","4364","1534.31159643","2.8442723174"
"SL2.50ch00:8211804-8213494","34","8211804","8213494","1690","1534.31159643","1.101471177"
"SL2.50ch00:8212114-8213523","26","8212114","8213523","1409","1534.31159643","0.918327152892"
"SL2.50ch00:8214780-8216483","10","8214780","8216483","1703","1534.31159643","1.1099440322"
"SL2.50ch00:8217389-8218215","13","8217389","8218215","826","1534.31159643","0.538352184733"
"SL2.50ch00:8220196-8221074","23","8220196","8221074","878","1534.31159643","0.572243605563"
"SL2.50ch00:8220554-8221120","14","8220554","8221120","566","1534.31159643","0.36889508058"
"SL2.50ch00:8226789-8228144","15","8226789","8228144","1355","1534.31159643","0.883132215875"
"SL2.50ch00:8233982-8234357","1","8233982","8234357","375","1534.31159643","0.244409284836"
"SL2.50ch00:8239256-8240215","15","8239256","8240215","959","1534.31159643","0.625036011088"
"SL2.50ch00:8239274-8240172","15","8239274","8240172","898","1534.31159643","0.585278767421"
"SL2.50ch00:8248125-8248879","11","8248125","8248879","754","1534.31159643","0.491425602044"
"SL2.50ch00:8250390-8251656","19","8250390","8251656","1266","1534.31159643","0.825125745607"
"SL2.50ch00:8260930-8261559","10","8260930","8261559","629","1534.31159643","0.409955840432"
"SL2.50ch00:8261046-8261677","9","8261046","8261677","631","1534.31159643","0.411259356618"
"SL2.50ch00:8266511-8267478","12","8266511","8267478","967","1534.31159643","0.630250075831"
"SL2.50ch00:8273174-8273882","17","8273174","8273882","708","1534.31159643","0.461444729771"
"SL2.50ch00:8274395-8275043","8","8274395","8275043","648","1534.31159643","0.422339244197"
"SL2.50ch00:8277960-8278553","10","8277960","8278553","593","1534.31159643","0.386492549088"
"SL2.50ch00:8286018-8286917","8","8286018","8286917","899","1534.31159643","0.585930525514"
"SL2.50ch00:8298046-8298525","10","8298046","8298525","479","1534.31159643","0.312192126498"
"SL2.50ch00:8299213-8299793","7","8299213","8299793","580","1534.31159643","0.37801969388"
"SL2.50ch00:8301750-8302320","8","8301750","8302320","570","1534.31159643","0.371502112951"
"SL2.50ch00:8308284-8309413","20","8308284","8309413","1129","1534.31159643","0.735834886881"
"SL2.50ch00:8308600-8309348","13","8308600","8309348","748","1534.31159643","0.487515053487"
"SL2.50ch00:8331144-8331519","1","8331144","8331519","375","1534.31159643","0.244409284836"
"SL2.50ch00:8336537-8338456","26","8336537","8338456","1919","1534.31159643","1.25072378027"
"SL2.50ch00:8348334-8349071","59","8348334","8349071","737","1534.31159643","0.480345714465"
"SL2.50ch00:8352081-8353231","140","8352081","8353231","1150","1534.31159643","0.749521806831"
"SL2.50ch00:836408-837180","1","836408","837180","772","1534.31159643","0.503157247716"
"SL2.50ch00:8364149-8364752","2","8364149","8364752","603","1534.31159643","0.393010130017"
"SL2.50ch00:8365580-8366246","3","8365580","8366246","666","1534.31159643","0.434070889869"
"SL2.50ch00:8373200-8375003","31","8373200","8375003","1803","1534.31159643","1.17511984149"
"SL2.50ch00:8374224-8374875","22","8374224","8374875","651","1534.31159643","0.424294518476"
"SL2.50ch00:8394451-8395726","15","8394451","8395726","1275","1534.31159643","0.830991568444"
"SL2.50ch00:8397545-8398231","13","8397545","8398231","686","1534.31159643","0.447106051727"
"SL2.50ch00:8404971-8405493","15","8404971","8405493","522","1534.31159643","0.340217724492"
"SL2.50ch00:8404993-8412933","102","8404993","8412933","7940","1534.31159643","5.1749592576"
"SL2.50ch00:8409657-8412449","45","8409657","8412449","2792","1534.31159643","1.81970859537"
"SL2.50ch00:8594402-8594804","18","8594402","8594804","402","1534.31159643","0.262006753345"
"SL2.50ch00:8607635-8611922","66","8607635","8611922","4287","1534.31159643","2.79408694425"
"SL2.50ch00:8609667-8611866","42","8609667","8611866","2199","1534.31159643","1.43321604628"
"SL2.50ch00:8613760-8615936","58","8613760","8615936","2176","1534.31159643","1.41822561014"
"SL2.50ch00:8613780-8619919","124","8613780","8619919","6139","1534.31159643","4.00114293229"
"SL2.50ch00:8620542-8625317","85","8620542","8625317","4775","1534.31159643","3.11214489358"
"SL2.50ch00:8620596-8621086","10","8620596","8621086","490","1534.31159643","0.319361465519"
"SL2.50ch00:8621586-8625260","69","8621586","8625260","3674","1534.31159643","2.3945592333"
"SL2.50ch00:8634140-8638967","104","8634140","8638967","4827","1534.31159643","3.14603631441"
"SL2.50ch00:8634193-8644031","183","8634193","8644031","9838","1534.31159643","6.41199611792"
"SL2.50ch00:8657336-8658287","9","8657336","8658287","951","1534.31159643","0.619821946345"
"SL2.50ch00:8665300-8665958","5","8665300","8665958","658","1534.31159643","0.428856825126"
"SL2.50ch00:8678644-8679455","9","8678644","8679455","811","1534.31159643","0.528575813339"
"SL2.50ch00:8682052-8684502","20","8682052","8684502","2450","1534.31159643","1.5968073276"
"SL2.50ch00:8697189-8697564","3","8697189","8697564","375","1534.31159643","0.244409284836"
"SL2.50ch00:8718456-8719765","17","8718456","8719765","1309","1534.31159643","0.853151343602"
"SL2.50ch00:8733678-8734341","14","8733678","8734341","663","1534.31159643","0.432115615591"
"SL2.50ch00:8733739-8735102","20","8733739","8735102","1363","1534.31159643","0.888346280618"
"SL2.50ch00:8949347-8949856","9","8949347","8949856","509","1534.31159643","0.331744869285"
"SL2.50ch00:8965032-8967276","22","8965032","8967276","2244","1534.31159643","1.46254516046"
"SL2.50ch00:8966600-8967244","14","8966600","8967244","644","1534.31159643","0.419732211826"
"SL2.50ch00:8968460-8969183","10","8968460","8969183","723","1534.31159643","0.471221101164"
"SL2.50ch00:8968508-8969014","9","8968508","8969014","506","1534.31159643","0.329789595006"
"SL2.50ch00:8976506-8978957","49","8976506","8978957","2451","1534.31159643","1.59745908569"
"SL2.50ch00:8987330-8987898","9","8987330","8987898","568","1534.31159643","0.370198596765"
"SL2.50ch00:9004251-9006882","27","9004251","9006882","2631","1534.31159643","1.71477554241"
"SL2.50ch00:9007593-9008123","1","9007593","9008123","530","1534.31159643","0.345431789235"
"SL2.50ch00:9015056-9015699","15","9015056","9015699","643","1534.31159643","0.419080453733"
"SL2.50ch00:9015108-9015777","16","9015108","9015777","669","1534.31159643","0.436026164148"
"SL2.50ch00:9017736-9019183","28","9017736","9019183","1447","1534.31159643","0.943093960422"
"SL2.50ch00:9030365-9032047","32","9030365","9032047","1682","1534.31159643","1.09625711225"
"SL2.50ch00:9031514-9032021","13","9031514","9032021","507","1534.31159643","0.330441353099"
"SL2.50ch00:9035254-9036052","19","9035254","9036052","798","1534.31159643","0.520102958132"
"SL2.50ch00:9039219-9040022","8","9039219","9040022","803","1534.31159643","0.523361748596"
"SL2.50ch00:9046167-9047924","36","9046167","9047924","1757","1534.31159643","1.14513896922"
"SL2.50ch00:9046176-9047912","36","9046176","9047912","1736","1534.31159643","1.13145204927"
"SL2.50ch00:9049665-9051627","70","9049665","9051627","1962","1534.31159643","1.27874937826"
"SL2.50ch00:9049695-9051709","70","9049695","9051709","2014","1534.31159643","1.31264079909"
"SL2.50ch00:9055371-9056476","40","9055371","9056476","1105","1534.31159643","0.720192692651"
"SL2.50ch00:9055408-9056471","40","9055408","9056471","1063","1534.31159643","0.692818852749"
"SL2.50ch00:9058126-9062340","168","9058126","9062340","4214","1534.31159643","2.74650860347"
"SL2.50ch00:9058131-9062430","168","9058131","9062430","4299","1534.31159643","2.80190804136"
"SL2.50ch00:9068649-9071610","73","9068649","9071610","2961","1534.31159643","1.92985571307"
"SL2.50ch00:9068703-9071632","72","9068703","9071632","2929","1534.31159643","1.90899945409"
"SL2.50ch00:9078187-9081426","75","9078187","9081426","3239","1534.31159643","2.11104446289"
"SL2.50ch00:9078187-9081497","75","9078187","9081497","3310","1534.31159643","2.15731928749"
"SL2.50ch00:9090083-9091282","39","9090083","9091282","1199","1534.31159643","0.781457953383"
"SL2.50ch00:9090109-9091331","39","9090109","9091331","1222","1534.31159643","0.79644838952"
"SL2.50ch00:9096292-9103662","68","9096292","9103662","7370","1534.31159643","4.80345714465"
"SL2.50ch00:9109805-9110738","3","9109805","9110738","933","1534.31159643","0.608090300673"
"SL2.50ch00:9239207-9242470","43","9239207","9242470","3263","1534.31159643","2.12668665712"
"SL2.50ch00:9244498-9247637","36","9244498","9247637","3139","1534.31159643","2.0458686536"
"SL2.50ch00:9254917-9256554","59","9254917","9256554","1637","1534.31159643","1.06692799807"
"SL2.50ch00:9254982-9256545","59","9254982","9256545","1563","1534.31159643","1.0186978992"
"SL2.50ch00:9259001-9260385","25","9259001","9260385","1384","1534.31159643","0.902033200569"
"SL2.50ch00:9261165-9262649","16","9261165","9262649","1484","1534.31159643","0.967209009859"
"SL2.50ch00:9271885-9272489","6","9271885","9272489","604","1534.31159643","0.39366188811"
"SL2.50ch00:9278565-9279331","13","9278565","9279331","766","1534.31159643","0.499246699159"
"SL2.50ch00:9302677-9303951","20","9302677","9303951","1274","1534.31159643","0.830339810351"
"SL2.50ch00:930971-931346","4","930971","931346","375","1534.31159643","0.244409284836"
"SL2.50ch00:9316406-9316781","8","9316406","9316781","375","1534.31159643","0.244409284836"
"SL2.50ch00:9324487-9325533","9","9324487","9325533","1046","1534.31159643","0.68173896517"
"SL2.50ch00:9326434-9326903","6","9326434","9326903","469","1534.31159643","0.305674545569"
"SL2.50ch00:9337835-9338504","12","9337835","9338504","669","1534.31159643","0.436026164148"
"SL2.50ch00:9342636-9344852","32","9342636","9344852","2216","1534.31159643","1.44429593386"
"SL2.50ch00:9351642-9353215","30","9351642","9353215","1573","1534.31159643","1.02521548013"
"SL2.50ch00:9352340-9352978","26","9352340","9352978","638","1534.31159643","0.415821663268"
"SL2.50ch00:9366834-9367623","15","9366834","9367623","789","1534.31159643","0.514237135296"
"SL2.50ch00:9369235-9370606","32","9369235","9370606","1371","1534.31159643","0.893560345362"
"SL2.50ch00:9383843-9384333","10","9383843","9384333","490","1534.31159643","0.319361465519"
"SL2.50ch00:9405612-9406254","4","9405612","9406254","642","1534.31159643","0.41842869564"
"SL2.50ch00:9408014-9410178","48","9408014","9410178","2164","1534.31159643","1.41040451303"
"SL2.50ch00:9413239-9417348","82","9413239","9417348","4109","1534.31159643","2.67807400371"
"SL2.50ch00:9414793-9417223","49","9414793","9417223","2430","1534.31159643","1.58377216574"
"SL2.50ch00:9418288-9423072","88","9418288","9423072","4784","1534.31159643","3.11801071642"
"SL2.50ch00:9421065-9423040","33","9421065","9423040","1975","1534.31159643","1.28722223347"
"SL2.50ch00:9423714-9427876","96","9423714","9427876","4162","1534.31159643","2.71261718264"
"SL2.50ch00:9425705-9427662","64","9425705","9427662","1957","1534.31159643","1.2754905878"
"SL2.50ch00:9432720-9435921","63","9432720","9435921","3201","1534.31159643","2.08627765536"
"SL2.50ch00:9441532-9442005","7","9441532","9442005","473","1534.31159643","0.30828157794"
"SL2.50ch00:9450055-9458167","140","9450055","9458167","8112","1534.31159643","5.28706164958"
"SL2.50ch00:9453165-9458132","100","9453165","9458132","4967","1534.31159643","3.23728244742"
"SL2.50ch00:9459682-9461136","21","9459682","9461136","1454","1534.31159643","0.947656267072"
"SL2.50ch00:9469103-9469726","18","9469103","9469726","623","1534.31159643","0.406045291875"
"SL2.50ch00:9469151-9469553","18","9469151","9469553","402","1534.31159643","0.262006753345"
"SL2.50ch00:9472005-9474716","49","9472005","9474716","2711","1534.31159643","1.76691618984"
"SL2.50ch00:9472134-9472624","11","9472134","9472624","490","1534.31159643","0.319361465519"
"SL2.50ch00:9477989-9485776","167","9477989","9485776","7787","1534.31159643","5.07524026939"
"SL2.50ch00:9480354-9481499","51","9480354","9481499","1145","1534.31159643","0.746263016367"
"SL2.50ch00:9481943-9484278","30","9481943","9484278","2335","1534.31159643","1.52185514691"
"SL2.50ch00:9499005-9501565","16","9499005","9501565","2560","1534.31159643","1.66850071782"
"SL2.50ch00:9563160-9565723","36","9563160","9565723","2563","1534.31159643","1.67045599209"
"SL2.50ch00:9564596-9565633","24","9564596","9565633","1037","1534.31159643","0.675873142334"
"SL2.50ch00:9571890-9574712","38","9571890","9574712","2822","1534.31159643","1.83926133815"
"SL2.50ch00:9574103-9574879","19","9574103","9574879","776","1534.31159643","0.505764280088"
"SL2.50ch00:9588291-9589618","29","9588291","9589618","1327","1534.31159643","0.864882989274"
"SL2.50ch00:9588353-9589343","24","9588353","9589343","990","1534.31159643","0.645240511968"
"SL2.50ch00:9598709-9599994","10","9598709","9599994","1285","1534.31159643","0.837509149372"
"SL2.50ch00:9600734-9601870","12","9600734","9601870","1136","1534.31159643","0.740397193531"
"SL2.50ch00:9607833-9610848","38","9607833","9610848","3015","1534.31159643","1.96505065008"
"SL2.50ch00:9610195-9610685","9","9610195","9610685","490","1534.31159643","0.319361465519"
"SL2.50ch00:9619046-9619554","11","9619046","9619554","508","1534.31159643","0.331093111192"
"SL2.50ch00:9619197-9619572","8","9619197","9619572","375","1534.31159643","0.244409284836"
"SL2.50ch00:9621331-9625049","79","9621331","9625049","3718","1534.31159643","2.42323658939"
"SL2.50ch00:9621350-9621936","16","9621350","9621936","586","1534.31159643","0.381930242438"
"SL2.50ch00:9622732-9623510","21","9622732","9623510","778","1534.31159643","0.507067796274"
"SL2.50ch00:9626009-9628452","29","9626009","9628452","2443","1534.31159643","1.59224502095"
"SL2.50ch00:9626103-9628743","30","9626103","9628743","2640","1534.31159643","1.72064136525"
"SL2.50ch00:9629835-9630325","21","9629835","9630325","490","1534.31159643","0.319361465519"
"SL2.50ch00:9629835-9630333","21","9629835","9630333","498","1534.31159643","0.324575530263"
"SL2.50ch00:9643147-9643651","3","9643147","9643651","504","1534.31159643","0.32848607882"
"SL2.50ch00:9715123-9716924","14","9715123","9716924","1801","1534.31159643","1.17381632531"
"SL2.50ch00:9722305-9729386","194","9722305","9729386","7081","1534.31159643","4.6150990558"
"SL2.50ch00:9722376-9729263","193","9722376","9729263","6887","1534.31159643","4.48865798578"
"SL2.50ch00:9745483-9746285","4","9745483","9746285","802","1534.31159643","0.522709990503"
"SL2.50ch00:9753018-9755103","38","9753018","9755103","2085","1534.31159643","1.35891562369"
"SL2.50ch00:9753212-9754492","22","9753212","9754492","1280","1534.31159643","0.834250358908"
"SL2.50ch00:9757267-9760747","60","9757267","9760747","3480","1534.31159643","2.26811816328"
"SL2.50ch00:9771910-9776224","123","9771910","9776224","4314","1534.31159643","2.81168441276"
"SL2.50ch00:9771946-9776178","121","9771946","9776178","4232","1534.31159643","2.75824024914"
"SL2.50ch00:9781174-9782758","42","9781174","9782758","1584","1534.31159643","1.03238481915"
"SL2.50ch00:9781229-9782608","40","9781229","9782608","1379","1534.31159643","0.898774410105"
"SL2.50ch00:9784466-9784841","2","9784466","9784841","375","1534.31159643","0.244409284836"
"SL2.50ch00:9788332-9788851","13","9788332","9788851","519","1534.31159643","0.338262450213"
"SL2.50ch00:9788349-9788819","13","9788349","9788819","470","1534.31159643","0.306326303662"
"SL2.50ch00:9790540-9791015","17","9790540","9791015","475","1534.31159643","0.309585094126"
"SL2.50ch00:9790548-9791053","16","9790548","9791053","505","1534.31159643","0.329137836913"
"SL2.50ch00:9794301-9796006","118","9794301","9796006","1705","1534.31159643","1.11124754839"
"SL2.50ch00:9801994-9804879","50","9801994","9804879","2885","1534.31159643","1.88032209801"
"SL2.50ch00:9813087-9815757","33","9813087","9815757","2670","1534.31159643","1.74019410803"
"SL2.50ch00:9816688-9818251","15","9816688","9818251","1563","1534.31159643","1.0186978992"
"SL2.50ch00:9833349-9834217","225","9833349","9834217","868","1534.31159643","0.565726024634"
"SL2.50ch00:9834909-9836656","45","9834909","9836656","1747","1534.31159643","1.13862138829"
"SL2.50ch00:9834961-9836717","43","9834961","9836717","1756","1534.31159643","1.14448721113"
"SL2.50ch00:9837927-9838984","27","9837927","9838984","1057","1534.31159643","0.688908304192"
"SL2.50ch00:9837935-9838982","27","9837935","9838982","1047","1534.31159643","0.682390723263"
"SL2.50ch00:9862018-9862746","30","9862018","9862746","728","1534.31159643","0.474479891629"
"SL2.50ch00:9863675-9864396","6","9863675","9864396","721","1534.31159643","0.469917584979"
"SL2.50ch00:9864924-9865938","18","9864924","9865938","1014","1534.31159643","0.660882706197"
"SL2.50ch00:9880979-9881624","11","9880979","9881624","645","1534.31159643","0.420383969918"
"SL2.50ch00:9954273-9959938","119","9954273","9959938","5665","1534.31159643","3.69220959626"
"SL2.50ch00:9963859-9971474","112","9963859","9971474","7615","1534.31159643","4.96313787741"
"SL2.50ch00:9963863-9967780","64","9963863","9967780","3917","1534.31159643","2.55293644988"
"SL2.50ch00:9972925-9982340","136","9972925","9982340","9415","1534.31159643","6.13630244462"
"SL2.50ch00:9983544-9987670","64","9983544","9987670","4126","1534.31159643","2.68915389129"
"SL2.50ch00:9987060-9987601","13","9987060","9987601","541","1534.31159643","0.352601128257"
"SL2.50ch00:9990015-9993899","63","9990015","9993899","3884","1534.31159643","2.53142843281"
"SL2.50ch00:9990037-9993723","60","9990037","9993723","3686","1534.31159643","2.40238033042"
"SL2.50ch00:9995340-9995715","6","9995340","9995715","375","1534.31159643","0.244409284836"
"SL2.50ch00:9998688-10000097","26","9998688","10000097","1409","1534.31159643","0.918327152892"
"SL2.50ch00:9998871-10002252","64","9998871","10002252","3381","1534.31159643","2.20359411208"
"SL2.50ch01:11968793-11969168","1","11968793","11969168","375","1534.31159643","0.244409284836"
"SL2.50ch01:1333557-1333932","2","1333557","1333932","375","1534.31159643","0.244409284836"
"SL2.50ch01:13846783-13847447","3","13846783","13847447","664","1534.31159643","0.432767373684"
"SL2.50ch01:14004258-14005349","8","14004258","14005349","1091","1534.31159643","0.71106807935"
"SL2.50ch01:14800828-14801745","1","14800828","14801745","917","1534.31159643","0.597662171186"
"SL2.50ch01:14955717-14956237","4","14955717","14956237","520","1534.31159643","0.338914208306"
"SL2.50ch01:15605657-15606264","21","15605657","15606264","607","1534.31159643","0.395617162388"
"SL2.50ch01:15605717-15606285","19","15605717","15606285","568","1534.31159643","0.370198596765"
"SL2.50ch01:15796659-15797469","6","15796659","15797469","810","1534.31159643","0.527924055246"
"SL2.50ch01:1839676-1903415","102116","1839676","1903415","63739","1534.31159643","41.5424090832"
"SL2.50ch01:1839708-1903437","102116","1839708","1903437","63729","1534.31159643","41.5358915022"
"SL2.50ch01:18586438-18586913","1","18586438","18586913","475","1534.31159643","0.309585094126"
"SL2.50ch01:18783900-18784595","2","18783900","18784595","695","1534.31159643","0.452971874563"
"SL2.50ch01:19716069-19718334","15","19716069","19718334","2265","1534.31159643","1.47623208041"
"SL2.50ch01:20285362-20286126","8","20285362","20286126","764","1534.31159643","0.497943182973"
"SL2.50ch01:20757843-20758451","4","20757843","20758451","608","1534.31159643","0.396268920481"
"SL2.50ch01:21238823-21239198","1","21238823","21239198","375","1534.31159643","0.244409284836"
"SL2.50ch01:21401232-21401847","1","21401232","21401847","615","1534.31159643","0.400831227132"
"SL2.50ch01:21722889-21724486","12","21722889","21724486","1597","1534.31159643","1.04085767436"
"SL2.50ch01:21754167-21754542","2","21754167","21754542","375","1534.31159643","0.244409284836"
"SL2.50ch01:22438896-22440095","9","22438896","22440095","1199","1534.31159643","0.781457953383"
"SL2.50ch01:22596222-22597075","14","22596222","22597075","853","1534.31159643","0.555949653241"
"SL2.50ch01:22848489-22848989","1","22848489","22848989","500","1534.31159643","0.325879046448"
"SL2.50ch01:23606727-23608043","12","23606727","23608043","1316","1534.31159643","0.857713650252"
"SL2.50ch01:23877807-23878380","7","23877807","23878380","573","1534.31159643","0.37345738723"
"SL2.50ch01:23892015-23893041","13","23892015","23893041","1026","1534.31159643","0.668703803312"
"SL2.50ch01:23894853-23895255","33","23894853","23895255","402","1534.31159643","0.262006753345"
"SL2.50ch01:23933813-23939761","174","23933813","23939761","5948","1534.31159643","3.87665713655"
"SL2.50ch01:23940972-23943685","314","23940972","23943685","2713","1534.31159643","1.76821970603"
"SL2.50ch01:23941259-23943022","307","23941259","23943022","1763","1534.31159643","1.14904951778"
"SL2.50ch01:23946758-23950271","15","23946758","23950271","3513","1534.31159643","2.28962618035"
"SL2.50ch01:23951916-23953495","16","23951916","23953495","1579","1534.31159643","1.02912602868"
"SL2.50ch01:23965380-23966367","80","23965380","23966367","987","1534.31159643","0.643285237689"
"SL2.50ch01:23965510-23966276","78","23965510","23966276","766","1534.31159643","0.499246699159"
"SL2.50ch01:24228570-24229146","6","24228570","24229146","576","1534.31159643","0.375412661509"
"SL2.50ch01:24233826-24236083","37","24233826","24236083","2257","1534.31159643","1.47101801567"
"SL2.50ch01:24272581-24273438","3","24272581","24273438","857","1534.31159643","0.558556685613"
"SL2.50ch01:24513175-24513796","2","24513175","24513796","621","1534.31159643","0.404741775689"
"SL2.50ch01:25132342-25132816","5","25132342","25132816","474","1534.31159643","0.308933336033"
"SL2.50ch01:25672237-25672612","7","25672237","25672612","375","1534.31159643","0.244409284836"
"SL2.50ch01:26210581-26211494","6","26210581","26211494","913","1534.31159643","0.595055138815"
"SL2.50ch01:26525089-26525905","1","26525089","26525905","816","1534.31159643","0.531834603804"
"SL2.50ch01:27417575-27417977","18","27417575","27417977","402","1534.31159643","0.262006753345"
"SL2.50ch01:27884750-27885367","27","27884750","27885367","617","1534.31159643","0.402134743317"
"SL2.50ch01:27918114-27918598","1","27918114","27918598","484","1534.31159643","0.315450916962"
"SL2.50ch01:28028813-28030120","13","28028813","28030120","1307","1534.31159643","0.851847827416"
"SL2.50ch01:28492826-28493201","1","28492826","28493201","375","1534.31159643","0.244409284836"
"SL2.50ch01:28711042-28711946","5","28711042","28711946","904","1534.31159643","0.589189315979"
"SL2.50ch01:30279147-30279522","2","30279147","30279522","375","1534.31159643","0.244409284836"
"SL2.50ch01:30784789-30785164","1","30784789","30785164","375","1534.31159643","0.244409284836"
"SL2.50ch01:30948965-30949340","4","30948965","30949340","375","1534.31159643","0.244409284836"
"SL2.50ch01:31146127-31146596","1","31146127","31146596","469","1534.31159643","0.305674545569"
"SL2.50ch01:31224586-31224961","7","31224586","31224961","375","1534.31159643","0.244409284836"
"SL2.50ch01:32339044-32339563","5","32339044","32339563","519","1534.31159643","0.338262450213"
"SL2.50ch01:36643814-36645093","9","36643814","36645093","1279","1534.31159643","0.833598600815"
"SL2.50ch01:36888348-36897964","244","36888348","36897964","9616","1534.31159643","6.2673058213"
"SL2.50ch01:36888550-36896089","234","36888550","36896089","7539","1534.31159643","4.91360426235"
"SL2.50ch01:36942610-36944092","19","36942610","36944092","1482","1534.31159643","0.965905493673"
"SL2.50ch01:36950295-36952356","30","36950295","36952356","2061","1534.31159643","1.34327342946"
"SL2.50ch01:36984575-36988502","87","36984575","36988502","3927","1534.31159643","2.55945403081"
"SL2.50ch01:36985927-36986829","56","36985927","36986829","902","1534.31159643","0.587885799793"
"SL2.50ch01:39121062-39124230","63","39121062","39124230","3168","1534.31159643","2.0647696383"
"SL2.50ch01:39121411-39123115","51","39121411","39123115","1704","1534.31159643","1.1105957903"
"SL2.50ch01:39132048-39134342","71","39132048","39134342","2294","1534.31159643","1.49513306511"
"SL2.50ch01:39132427-39133966","70","39132427","39133966","1539","1534.31159643","1.00305570497"
"SL2.50ch01:39135164-39136515","34","39135164","39136515","1351","1534.31159643","0.880525183504"
"SL2.50ch01:39135319-39138487","70","39135319","39138487","3168","1534.31159643","2.0647696383"
"SL2.50ch01:39137229-39137719","11","39137229","39137719","490","1534.31159643","0.319361465519"
"SL2.50ch01:39475355-39475730","2","39475355","39475730","375","1534.31159643","0.244409284836"
"SL2.50ch01:39769273-39770042","14","39769273","39770042","769","1534.31159643","0.501201973438"
"SL2.50ch01:39769424-39770132","15","39769424","39770132","708","1534.31159643","0.461444729771"
"SL2.50ch01:40219084-40219617","1","40219084","40219617","533","1534.31159643","0.347387063514"
"SL2.50ch01:40523400-40524312","16","40523400","40524312","912","1534.31159643","0.594403380722"
"SL2.50ch01:40714692-40715168","4","40714692","40715168","476","1534.31159643","0.310236852219"
"SL2.50ch01:41711237-41712006","11","41711237","41712006","769","1534.31159643","0.501201973438"
"SL2.50ch01:41729414-41731149","24","41729414","41731149","1735","1534.31159643","1.13080029118"
"SL2.50ch01:41729550-41731227","24","41729550","41731227","1677","1534.31159643","1.09299832179"
"SL2.50ch01:41733216-41734775","22","41733216","41734775","1559","1534.31159643","1.01609086683"
"SL2.50ch01:41752923-41754182","8","41752923","41754182","1259","1534.31159643","0.820563438957"
"SL2.50ch01:42324376-42325644","11","42324376","42325644","1268","1534.31159643","0.826429261793"
"SL2.50ch01:42379624-42380407","8","42379624","42380407","783","1534.31159643","0.510326586738"
"SL2.50ch01:43039383-43039917","23","43039383","43039917","534","1534.31159643","0.348038821607"
"SL2.50ch01:43482173-43482803","10","43482173","43482803","630","1534.31159643","0.410607598525"
"SL2.50ch01:43544852-43546071","1","43544852","43546071","1219","1534.31159643","0.794493115241"
"SL2.50ch01:43647943-43648446","16","43647943","43648446","503","1534.31159643","0.327834320727"
"SL2.50ch01:44093707-44094177","11","44093707","44094177","470","1534.31159643","0.306326303662"
"SL2.50ch01:44352450-44352945","4","44352450","44352945","495","1534.31159643","0.322620255984"
"SL2.50ch01:44466800-44467490","11","44466800","44467490","690","1534.31159643","0.449713084099"
"SL2.50ch01:44528814-44530884","25","44528814","44530884","2070","1534.31159643","1.3491392523"
"SL2.50ch01:44562367-44563066","5","44562367","44563066","699","1534.31159643","0.455578906935"
"SL2.50ch01:44575856-44577434","11","44575856","44577434","1578","1534.31159643","1.02847427059"
"SL2.50ch01:44607595-44608224","6","44607595","44608224","629","1534.31159643","0.409955840432"
"SL2.50ch01:44630655-44631224","15","44630655","44631224","569","1534.31159643","0.370850354858"
"SL2.50ch01:44768402-44769003","5","44768402","44769003","601","1534.31159643","0.391706613831"
"SL2.50ch01:44787657-44789122","13","44787657","44789122","1465","1534.31159643","0.954825606094"
"SL2.50ch01:44799513-44802631","39","44799513","44802631","3118","1534.31159643","2.03218173365"
"SL2.50ch01:44830568-44831831","22","44830568","44831831","1263","1534.31159643","0.823170471329"
"SL2.50ch01:44835507-44836244","5","44835507","44836244","737","1534.31159643","0.480345714465"
"SL2.50ch01:44860994-44861698","13","44860994","44861698","704","1534.31159643","0.458837697399"
"SL2.50ch01:44881547-44882473","3","44881547","44882473","926","1534.31159643","0.603527994023"
"SL2.50ch01:44921478-44922958","17","44921478","44922958","1480","1534.31159643","0.964601977487"
"SL2.50ch01:45009193-45009837","103","45009193","45009837","644","1534.31159643","0.419732211826"
"SL2.50ch01:45009318-45009860","102","45009318","45009860","542","1534.31159643","0.35325288635"
"SL2.50ch01:45271114-45271901","5","45271114","45271901","787","1534.31159643","0.51293361911"
"SL2.50ch01:45275571-45277585","22","45275571","45277585","2014","1534.31159643","1.31264079909"
"SL2.50ch01:45421617-45422175","6","45421617","45422175","558","1534.31159643","0.363681015836"
"SL2.50ch01:45785334-45785953","4","45785334","45785953","619","1534.31159643","0.403438259503"
"SL2.50ch01:46733816-46734218","24","46733816","46734218","402","1534.31159643","0.262006753345"
"SL2.50ch01:47302941-47303609","7","47302941","47303609","668","1534.31159643","0.435374406055"
"SL2.50ch01:47843874-47844682","1","47843874","47844682","808","1534.31159643","0.526620539061"
"SL2.50ch01:51312742-51313340","0","51312742","51313340","598","1534.31159643","0.389751339552"
"SL2.50ch01:51977574-51978650","15","51977574","51978650","1076","1534.31159643","0.701291707957"
"SL2.50ch01:52231429-52231804","3","52231429","52231804","375","1534.31159643","0.244409284836"
"SL2.50ch01:5240388-5241007","2","5240388","5241007","619","1534.31159643","0.403438259503"
"SL2.50ch01:52675696-52676071","4","52675696","52676071","375","1534.31159643","0.244409284836"
"SL2.50ch01:53022792-53023167","6","53022792","53023167","375","1534.31159643","0.244409284836"
"SL2.50ch01:5319741-5323511","38","5319741","5323511","3770","1534.31159643","2.45712801022"
"SL2.50ch01:53392224-53392843","94","53392224","53392843","619","1534.31159643","0.403438259503"
"SL2.50ch01:53935855-53936602","2","53935855","53936602","747","1534.31159643","0.486863295394"
"SL2.50ch01:54049261-54049783","17","54049261","54049783","522","1534.31159643","0.340217724492"
"SL2.50ch01:54133256-54134212","3","54133256","54134212","956","1534.31159643","0.623080736809"
"SL2.50ch01:54528867-54529492","7","54528867","54529492","625","1534.31159643","0.407348808061"
"SL2.50ch01:55579446-55580280","38","55579446","55580280","834","1534.31159643","0.543566249476"
"SL2.50ch01:55579536-55580384","39","55579536","55580384","848","1534.31159643","0.552690862777"
"SL2.50ch01:56248997-56249783","33","56248997","56249783","786","1534.31159643","0.512281861017"
"SL2.50ch01:56249071-56249793","33","56249071","56249793","722","1534.31159643","0.470569343072"
"SL2.50ch01:56405661-56406036","2","56405661","56406036","375","1534.31159643","0.244409284836"
"SL2.50ch01:56566648-56567141","1","56566648","56567141","493","1534.31159643","0.321316739798"
"SL2.50ch01:57183204-57183715","12","57183204","57183715","511","1534.31159643","0.33304838547"
"SL2.50ch01:57530071-57530641","8","57530071","57530641","570","1534.31159643","0.371502112951"
"SL2.50ch01:57613255-57613833","7","57613255","57613833","578","1534.31159643","0.376716177694"
"SL2.50ch01:57705080-57705611","5","57705080","57705611","531","1534.31159643","0.346083547328"
"SL2.50ch01:59085623-59086899","4","59085623","59086899","1276","1534.31159643","0.831643326536"
"SL2.50ch01:59207040-59207799","8","59207040","59207799","759","1534.31159643","0.494684392509"
"SL2.50ch01:59207200-59207602","7","59207200","59207602","402","1534.31159643","0.262006753345"
"SL2.50ch01:59546577-59547710","7","59546577","59547710","1133","1534.31159643","0.738441919252"
"SL2.50ch01:59582778-59583153","0","59582778","59583153","375","1534.31159643","0.244409284836"
"SL2.50ch01:60202970-60203452","3","60202970","60203452","482","1534.31159643","0.314147400776"
"SL2.50ch01:60368274-60368881","18","60368274","60368881","607","1534.31159643","0.395617162388"
"SL2.50ch01:60369345-60370336","17","60369345","60370336","991","1534.31159643","0.645892270061"
"SL2.50ch01:60876675-60878871","40","60876675","60878871","2196","1534.31159643","1.431260772"
"SL2.50ch01:61418471-61419574","9","61418471","61419574","1103","1534.31159643","0.718889176465"
"SL2.50ch01:61861994-61862396","13","61861994","61862396","402","1534.31159643","0.262006753345"
"SL2.50ch01:63257005-63257380","2","63257005","63257380","375","1534.31159643","0.244409284836"
"SL2.50ch01:63798114-63798876","13","63798114","63798876","762","1534.31159643","0.496639666787"
"SL2.50ch01:63798218-63798943","13","63798218","63798943","725","1534.31159643","0.47252461735"
"SL2.50ch01:63800315-63800787","8","63800315","63800787","472","1534.31159643","0.307629819847"
"SL2.50ch01:63802289-63803112","10","63802289","63803112","823","1534.31159643","0.536396910454"
"SL2.50ch01:63802614-63803443","15","63802614","63803443","829","1534.31159643","0.540307459012"
"SL2.50ch01:64254168-64255162","2","64254168","64255162","994","1534.31159643","0.647847544339"
"SL2.50ch01:64585552-64585927","1","64585552","64585927","375","1534.31159643","0.244409284836"
"SL2.50ch01:64640118-64640608","37","64640118","64640608","490","1534.31159643","0.319361465519"
"SL2.50ch01:65152545-65152920","3","65152545","65152920","375","1534.31159643","0.244409284836"
"SL2.50ch01:65651673-65652479","112","65651673","65652479","806","1534.31159643","0.525317022875"
"SL2.50ch01:65651778-65652467","112","65651778","65652467","689","1534.31159643","0.449061326006"
"SL2.50ch01:65923481-65923856","2","65923481","65923856","375","1534.31159643","0.244409284836"
"SL2.50ch01:66009140-66010629","23","66009140","66010629","1489","1534.31159643","0.970467800323"
"SL2.50ch01:66013118-66014447","12","66013118","66014447","1329","1534.31159643","0.86618650546"
"SL2.50ch01:66014831-66016152","14","66014831","66016152","1321","1534.31159643","0.860972440717"
"SL2.50ch01:66329272-66329889","26","66329272","66329889","617","1534.31159643","0.402134743317"
"SL2.50ch01:66433437-66434185","5","66433437","66434185","748","1534.31159643","0.487515053487"
"SL2.50ch01:66433540-66434069","5","66433540","66434069","529","1534.31159643","0.344780031142"
"SL2.50ch01:66435134-66435509","3","66435134","66435509","375","1534.31159643","0.244409284836"
"SL2.50ch01:66780954-66782239","101","66780954","66782239","1285","1534.31159643","0.837509149372"
"SL2.50ch01:68660527-68661179","6","68660527","68661179","652","1534.31159643","0.424946276569"
"SL2.50ch01:69305195-69305570","2","69305195","69305570","375","1534.31159643","0.244409284836"
"SL2.50ch01:7029801-7030523","17","7029801","7030523","722","1534.31159643","0.470569343072"
"SL2.50ch01:7029828-7030891","17","7029828","7030891","1063","1534.31159643","0.692818852749"
"SL2.50ch01:7080086-7082148","12","7080086","7082148","2062","1534.31159643","1.34392518755"
"SL2.50ch01:71108669-71109044","4","71108669","71109044","375","1534.31159643","0.244409284836"
"SL2.50ch01:72633593-72634365","18","72633593","72634365","772","1534.31159643","0.503157247716"
"SL2.50ch01:72633669-72634317","17","72633669","72634317","648","1534.31159643","0.422339244197"
"SL2.50ch01:75968814-75971781","28","75968814","75971781","2967","1534.31159643","1.93376626163"
"SL2.50ch01:75984810-75985326","3","75984810","75985326","516","1534.31159643","0.336307175935"
"SL2.50ch01:76143294-76143669","14","76143294","76143669","375","1534.31159643","0.244409284836"
"SL2.50ch01:76143304-76143706","14","76143304","76143706","402","1534.31159643","0.262006753345"
"SL2.50ch01:76425822-76427320","12","76425822","76427320","1498","1534.31159643","0.97633362316"
"SL2.50ch01:76744000-76744402","5","76744000","76744402","402","1534.31159643","0.262006753345"
"SL2.50ch01:77468331-77468816","1","77468331","77468816","485","1534.31159643","0.316102675055"
"SL2.50ch01:77501311-77502448","14","77501311","77502448","1137","1534.31159643","0.741048951624"
"SL2.50ch01:77505244-77506629","12","77505244","77506629","1385","1534.31159643","0.902684958662"
"SL2.50ch01:77505657-77506721","10","77505657","77506721","1064","1534.31159643","0.693470610842"
"SL2.50ch01:77533649-77534576","7","77533649","77534576","927","1534.31159643","0.604179752115"
"SL2.50ch01:7787425-7787910","3","7787425","7787910","485","1534.31159643","0.316102675055"
"SL2.50ch01:78119873-78120346","9","78119873","78120346","473","1534.31159643","0.30828157794"
"SL2.50ch01:81032985-81033935","17","81032985","81033935","950","1534.31159643","0.619170188252"
"SL2.50ch01:82436085-82436621","13","82436085","82436621","536","1534.31159643","0.349342337793"
"SL2.50ch01:82806754-82807425","9","82806754","82807425","671","1534.31159643","0.437329680334"
"SL2.50ch01:82806872-82807274","9","82806872","82807274","402","1534.31159643","0.262006753345"
"SL2.50ch01:84251027-84251694","14","84251027","84251694","667","1534.31159643","0.434722647962"
"SL2.50ch01:84251071-84251473","9","84251071","84251473","402","1534.31159643","0.262006753345"
"SL2.50ch01:84341173-84342133","0","84341173","84342133","960","1534.31159643","0.625687769181"
"SL2.50ch01:84679640-84680042","18","84679640","84680042","402","1534.31159643","0.262006753345"
"SL2.50ch01:84936667-84937457","13","84936667","84937457","790","1534.31159643","0.514888893389"
"SL2.50ch01:8530445-8530913","12","8530445","8530913","468","1534.31159643","0.305022787476"
"SL2.50ch01:86035393-86035891","20","86035393","86035891","498","1534.31159643","0.324575530263"
"SL2.50ch01:86035464-86035866","20","86035464","86035866","402","1534.31159643","0.262006753345"
"SL2.50ch01:86711724-86712214","50","86711724","86712214","490","1534.31159643","0.319361465519"
"SL2.50ch01:87072349-87072839","27","87072349","87072839","490","1534.31159643","0.319361465519"
"SL2.50ch01:88104703-88105201","23","88104703","88105201","498","1534.31159643","0.324575530263"
"SL2.50ch01:88104741-88105143","23","88104741","88105143","402","1534.31159643","0.262006753345"
"SL2.50ch01:9006356-9006889","85","9006356","9006889","533","1534.31159643","0.347387063514"
"SL2.50ch01:9006400-9006869","85","9006400","9006869","469","1534.31159643","0.305674545569"
"SL2.50ch01:90133335-90133970","26","90133335","90133970","635","1534.31159643","0.41386638899"
"SL2.50ch01:90133432-90133987","26","90133432","90133987","555","1534.31159643","0.361725741558"
"SL2.50ch01:90236888-90237263","4","90236888","90237263","375","1534.31159643","0.244409284836"
"SL2.50ch01:91495592-91496198","74","91495592","91496198","606","1534.31159643","0.394965404296"
"SL2.50ch01:91495694-91496165","74","91495694","91496165","471","1534.31159643","0.306978061754"
"SL2.50ch01:92021047-92021422","17","92021047","92021422","375","1534.31159643","0.244409284836"
"SL2.50ch01:92021082-92021484","17","92021082","92021484","402","1534.31159643","0.262006753345"
"SL2.50ch01:93670523-93671719","40","93670523","93671719","1196","1534.31159643","0.779502679105"
"SL2.50ch01:95967350-95968207","3","95967350","95968207","857","1534.31159643","0.558556685613"
"SL2.50ch01:96015003-96015710","3","96015003","96015710","707","1534.31159643","0.460792971678"
"SL2.50ch01:96868547-96870464","74","96868547","96870464","1917","1534.31159643","1.24942026408"
"SL2.50ch01:96868557-96870445","74","96868557","96870445","1888","1534.31159643","1.23051927939"
"SL2.50ch01:96871095-96871701","19","96871095","96871701","606","1534.31159643","0.394965404296"
"SL2.50ch01:96871136-96871759","18","96871136","96871759","623","1534.31159643","0.406045291875"
"SL2.50ch01:97436361-97437546","10","97436361","97437546","1185","1534.31159643","0.772333340083"
"SL2.50ch01:98472738-98473567","13","98472738","98473567","829","1534.31159643","0.540307459012"
"SL2.50ch01:98476541-98477971","8","98476541","98477971","1430","1534.31159643","0.932014072843"
"SL2.50ch01:98479579-98481098","4","98479579","98481098","1519","1534.31159643","0.99002054311"
"SL2.50ch01:98480121-98480973","2","98480121","98480973","852","1534.31159643","0.555297895148"
"SL2.50ch01:98481486-98482344","12","98481486","98482344","858","1534.31159643","0.559208443706"
"SL2.50ch01:98483991-98484676","10","98483991","98484676","685","1534.31159643","0.446454293634"
"SL2.50ch01:98485526-98487170","19","98485526","98487170","1644","1534.31159643","1.07149030472"
"SL2.50ch01:98486269-98487226","11","98486269","98487226","957","1534.31159643","0.623732494902"
"SL2.50ch01:98492162-98492745","9","98492162","98492745","583","1534.31159643","0.379974968159"
"SL2.50ch01:98497795-98499816","14","98497795","98499816","2021","1534.31159643","1.31720310574"
"SL2.50ch01:98502870-98505066","26","98502870","98505066","2196","1534.31159643","1.431260772"
"SL2.50ch01:98506241-98507449","12","98506241","98507449","1208","1534.31159643","0.787323776219"
"SL2.50ch01:98530529-98530904","1","98530529","98530904","375","1534.31159643","0.244409284836"
"SL2.50ch01:98534714-98535186","8","98534714","98535186","472","1534.31159643","0.307629819847"
"SL2.50ch02:12835422-12844334","102","12835422","12844334","8912","1534.31159643","5.8084681239"
"SL2.50ch02:12837047-12837537","10","12837047","12837537","490","1534.31159643","0.319361465519"
"SL2.50ch02:12839395-12841119","35","12839395","12841119","1724","1534.31159643","1.12363095215"
"SL2.50ch02:12845732-12848615","26","12845732","12848615","2883","1534.31159643","1.87901858182"
"SL2.50ch02:12849964-12857765","119","12849964","12857765","7801","1534.31159643","5.08436488269"
"SL2.50ch02:12857016-12857524","4","12857016","12857524","508","1534.31159643","0.331093111192"
"SL2.50ch02:12859088-12865286","96","12859088","12865286","6198","1534.31159643","4.03959665977"
"SL2.50ch02:12859505-12861268","30","12859505","12861268","1763","1534.31159643","1.14904951778"
"SL2.50ch02:12867166-12867870","19","12867166","12867870","704","1534.31159643","0.458837697399"
"SL2.50ch02:12887587-12888561","27","12887587","12888561","974","1534.31159643","0.634812382482"
"SL2.50ch02:12893940-12895344","14","12893940","12895344","1404","1534.31159643","0.915068362427"
"SL2.50ch02:12916048-12916423","5","12916048","12916423","375","1534.31159643","0.244409284836"
"SL2.50ch02:12918386-12918857","9","12918386","12918857","471","1534.31159643","0.306978061754"
"SL2.50ch02:12971206-12972987","29","12971206","12972987","1781","1534.31159643","1.16078116345"
"SL2.50ch02:12984908-12985517","6","12984908","12985517","609","1534.31159643","0.396920678574"
"SL2.50ch02:12992985-12996740","38","12992985","12996740","3755","1534.31159643","2.44735163883"
"SL2.50ch02:13002876-13017983","168","13002876","13017983","15107","1534.31159643","9.84610950939"
"SL2.50ch02:13011188-13011678","5","13011188","13011678","490","1534.31159643","0.319361465519"
"SL2.50ch02:13018370-13020320","10","13018370","13020320","1950","1534.31159643","1.27092828115"
"SL2.50ch02:13022290-13022759","5","13022290","13022759","469","1534.31159643","0.305674545569"
"SL2.50ch02:13324451-13325032","16","13324451","13325032","581","1534.31159643","0.378671451973"
"SL2.50ch02:13773308-13773989","0","13773308","13773989","681","1534.31159643","0.443847261263"
"SL2.50ch02:13775643-13776112","2","13775643","13776112","469","1534.31159643","0.305674545569"
"SL2.50ch02:13778190-13780818","102","13778190","13780818","2628","1534.31159643","1.71282026813"
"SL2.50ch02:13779945-13780790","75","13779945","13780790","845","1534.31159643","0.550735588498"
"SL2.50ch02:13782935-13786345","180","13782935","13786345","3410","1534.31159643","2.22249509678"
"SL2.50ch02:13783300-13784253","106","13783300","13784253","953","1534.31159643","0.621125462531"
"SL2.50ch02:13784750-13786256","67","13784750","13786256","1506","1534.31159643","0.981547687903"
"SL2.50ch02:13787281-13788760","37","13787281","13788760","1479","1534.31159643","0.963950219394"
"SL2.50ch02:13787342-13787846","33","13787342","13787846","504","1534.31159643","0.32848607882"
"SL2.50ch02:13815682-13816263","6","13815682","13816263","581","1534.31159643","0.378671451973"
"SL2.50ch02:13823738-13824140","24","13823738","13824140","402","1534.31159643","0.262006753345"
"SL2.50ch02:13827392-13830284","112","13827392","13830284","2892","1534.31159643","1.88488440466"
"SL2.50ch02:13830876-13833335","158","13830876","13833335","2459","1534.31159643","1.60267315043"
"SL2.50ch02:13831055-13833195","156","13831055","13833195","2140","1534.31159643","1.3947623188"
"SL2.50ch02:13845192-13845567","5","13845192","13845567","375","1534.31159643","0.244409284836"
"SL2.50ch02:13856709-13857306","8","13856709","13857306","597","1534.31159643","0.389099581459"
"SL2.50ch02:13874382-13884371","113","13874382","13884371","9989","1534.31159643","6.51041158995"
"SL2.50ch02:15331834-15332350","11","15331834","15332350","516","1534.31159643","0.336307175935"
"SL2.50ch02:15517466-15518274","2","15517466","15518274","808","1534.31159643","0.526620539061"
"SL2.50ch02:16006591-16007127","0","16006591","16007127","536","1534.31159643","0.349342337793"
"SL2.50ch02:16075026-16075401","0","16075026","16075401","375","1534.31159643","0.244409284836"
"SL2.50ch02:16311701-16312340","1","16311701","16312340","639","1534.31159643","0.416473421361"
"SL2.50ch02:16345463-16346083","11","16345463","16346083","620","1534.31159643","0.404090017596"
"SL2.50ch02:17880673-17881075","7","17880673","17881075","402","1534.31159643","0.262006753345"
"SL2.50ch02:17882122-17882944","26","17882122","17882944","822","1534.31159643","0.535745152361"
"SL2.50ch02:17882135-17883066","26","17882135","17883066","931","1534.31159643","0.606786784487"
"SL2.50ch02:18090629-18091004","0","18090629","18091004","375","1534.31159643","0.244409284836"
"SL2.50ch02:18224749-18225264","1","18224749","18225264","515","1534.31159643","0.335655417842"
"SL2.50ch02:18810320-18811397","4","18810320","18811397","1077","1534.31159643","0.70194346605"
"SL2.50ch02:19051008-19051611","13","19051008","19051611","603","1534.31159643","0.393010130017"
"SL2.50ch02:19051111-19052172","13","19051111","19052172","1061","1534.31159643","0.691515336564"
"SL2.50ch02:19905226-19906826","19","19905226","19906826","1600","1534.31159643","1.04281294864"
"SL2.50ch02:19905311-19906897","17","19905311","19906897","1586","1534.31159643","1.03368833533"
"SL2.50ch02:19910002-19910488","2","19910002","19910488","486","1534.31159643","0.316754433148"
"SL2.50ch02:204024-204568","5","204024","204568","544","1534.31159643","0.354556402536"
"SL2.50ch02:20737516-20737918","6","20737516","20737918","402","1534.31159643","0.262006753345"
"SL2.50ch02:21344067-21345092","13","21344067","21345092","1025","1534.31159643","0.668052045219"
"SL2.50ch02:21625130-21625719","8","21625130","21625719","589","1534.31159643","0.383885516716"
"SL2.50ch02:22404775-22405265","47","22404775","22405265","490","1534.31159643","0.319361465519"
"SL2.50ch02:22601520-22602086","14","22601520","22602086","566","1534.31159643","0.36889508058"
"SL2.50ch02:22880692-22881067","11","22880692","22881067","375","1534.31159643","0.244409284836"
"SL2.50ch02:22974418-22975445","8","22974418","22975445","1027","1534.31159643","0.669355561405"
"SL2.50ch02:23767749-23768837","15","23767749","23768837","1088","1534.31159643","0.709112805072"
"SL2.50ch02:23767937-23768454","14","23767937","23768454","517","1534.31159643","0.336958934028"
"SL2.50ch02:24225306-24226515","7","24225306","24226515","1209","1534.31159643","0.787975534312"
"SL2.50ch02:24431561-24431936","2","24431561","24431936","375","1534.31159643","0.244409284836"
"SL2.50ch02:24490615-24495350","702","24490615","24495350","4735","1534.31159643","3.08607456987"
"SL2.50ch02:24490717-24495399","701","24490717","24495399","4682","1534.31159643","3.05153139094"
"SL2.50ch02:24495838-24496615","86","24495838","24496615","777","1534.31159643","0.506416038181"
"SL2.50ch02:24495847-24496680","86","24495847","24496680","833","1534.31159643","0.542914491383"
"SL2.50ch02:24497794-24498386","39","24497794","24498386","592","1534.31159643","0.385840790995"
"SL2.50ch02:24497811-24498433","39","24497811","24498433","622","1534.31159643","0.405393533782"
"SL2.50ch02:24507107-24507677","34","24507107","24507677","570","1534.31159643","0.371502112951"
"SL2.50ch02:24507171-24507681","34","24507171","24507681","510","1534.31159643","0.332396627377"
"SL2.50ch02:24512833-24514517","300","24512833","24514517","1684","1534.31159643","1.09756062844"
"SL2.50ch02:24512869-24514609","300","24512869","24514609","1740","1534.31159643","1.13405908164"
"SL2.50ch02:24527438-24528628","513","24527438","24528628","1190","1534.31159643","0.775592130547"
"SL2.50ch02:24531697-24533162","161","24531697","24533162","1465","1534.31159643","0.954825606094"
"SL2.50ch02:24531846-24533095","159","24531846","24533095","1249","1534.31159643","0.814045858028"
"SL2.50ch02:2472631-2473594","11","2472631","2473594","963","1534.31159643","0.62764304346"
"SL2.50ch02:24948187-24952494","30","24948187","24952494","4307","1534.31159643","2.80712210611"
"SL2.50ch02:24968218-24970878","38","24968218","24970878","2660","1534.31159643","1.73367652711"
"SL2.50ch02:24972522-24980040","66","24972522","24980040","7518","1534.31159643","4.8999173424"
"SL2.50ch02:25007683-25009561","14","25007683","25009561","1878","1534.31159643","1.22400169846"
"SL2.50ch02:25019877-25021322","9","25019877","25021322","1445","1534.31159643","0.941790444236"
"SL2.50ch02:2908971-2909728","30","2908971","2909728","757","1534.31159643","0.493380876323"
"SL2.50ch02:2909039-2909571","27","2909039","2909571","532","1534.31159643","0.346735305421"
"SL2.50ch02:30278301-30278676","11","30278301","30278676","375","1534.31159643","0.244409284836"
"SL2.50ch02:30497755-30498245","48","30497755","30498245","490","1534.31159643","0.319361465519"
"SL2.50ch02:3104901-3105509","9","3104901","3105509","608","1534.31159643","0.396268920481"
"SL2.50ch02:31141327-31141892","4","31141327","31141892","565","1534.31159643","0.368243322487"
"SL2.50ch02:32963098-32963473","9","32963098","32963473","375","1534.31159643","0.244409284836"
"SL2.50ch02:36474207-36479398","73","36474207","36479398","5191","1534.31159643","3.38327626023"
"SL2.50ch02:36475738-36476228","13","36475738","36476228","490","1534.31159643","0.319361465519"
"SL2.50ch02:3680327-3680702","0","3680327","3680702","375","1534.31159643","0.244409284836"
"SL2.50ch02:37743070-37743472","23","37743070","37743472","402","1534.31159643","0.262006753345"
"SL2.50ch02:3888235-3889008","4","3888235","3889008","773","1534.31159643","0.503809005809"
"SL2.50ch02:41500716-41501118","18","41500716","41501118","402","1534.31159643","0.262006753345"
"SL2.50ch02:41500716-41501214","18","41500716","41501214","498","1534.31159643","0.324575530263"
"SL2.50ch02:41778656-41779031","6","41778656","41779031","375","1534.31159643","0.244409284836"
"SL2.50ch02:42082520-42083785","8","42082520","42083785","1265","1534.31159643","0.824473987515"
"SL2.50ch02:4424955-4425541","3","4424955","4425541","586","1534.31159643","0.381930242438"
"SL2.50ch02:44549031-44549818","246","44549031","44549818","787","1534.31159643","0.51293361911"
"SL2.50ch02:44549066-44549818","246","44549066","44549818","752","1534.31159643","0.490122085858"
"SL2.50ch02:44818411-44819137","427","44818411","44819137","726","1534.31159643","0.473176375443"
"SL2.50ch02:44818489-44819236","430","44818489","44819236","747","1534.31159643","0.486863295394"
"SL2.50ch02:45767419-45767794","2","45767419","45767794","375","1534.31159643","0.244409284836"
"SL2.50ch02:47579957-47580442","8","47579957","47580442","485","1534.31159643","0.316102675055"
"SL2.50ch02:48371617-48372130","14","48371617","48372130","513","1534.31159643","0.334351901656"
"SL2.50ch02:48371737-48372139","14","48371737","48372139","402","1534.31159643","0.262006753345"
"SL2.50ch02:48732880-48734093","15","48732880","48734093","1213","1534.31159643","0.790582566684"
"SL2.50ch02:49308269-49308885","98","49308269","49308885","616","1534.31159643","0.401482985224"
"SL2.50ch02:49904144-49904854","9","49904144","49904854","710","1534.31159643","0.462748245957"
"SL2.50ch02:49904256-49904658","9","49904256","49904658","402","1534.31159643","0.262006753345"
"SL2.50ch02:52487679-52488250","19","52487679","52488250","571","1534.31159643","0.372153871044"
"SL2.50ch02:5257369-5258616","5","5257369","5258616","1247","1534.31159643","0.812742341842"
"SL2.50ch02:5752523-5752994","2","5752523","5752994","471","1534.31159643","0.306978061754"
"SL2.50ch02:6346335-6346803","4","6346335","6346803","468","1534.31159643","0.305022787476"
"SL2.50ch02:6347821-6348597","10","6347821","6348597","776","1534.31159643","0.505764280088"
"SL2.50ch02:7361323-7361843","1","7361323","7361843","520","1534.31159643","0.338914208306"
"SL2.50ch02:741592-742197","1","741592","742197","605","1534.31159643","0.394313646203"
"SL2.50ch02:7704925-7705300","1","7704925","7705300","375","1534.31159643","0.244409284836"
"SL2.50ch02:7741868-7742243","0","7741868","7742243","375","1534.31159643","0.244409284836"
"SL2.50ch02:7752404-7752779","0","7752404","7752779","375","1534.31159643","0.244409284836"
"SL2.50ch02:7957709-7958084","1","7957709","7958084","375","1534.31159643","0.244409284836"
"SL2.50ch02:9251221-9251828","28","9251221","9251828","607","1534.31159643","0.395617162388"
"SL2.50ch02:9406540-9419289","277","9406540","9419289","12749","1534.31159643","8.30926392634"
"SL2.50ch02:9407426-9419237","268","9407426","9419237","11811","1534.31159643","7.69791483521"
"SL2.50ch02:9423911-9427218","69","9423911","9427218","3307","1534.31159643","2.15536401321"
"SL2.50ch02:9423918-9427366","70","9423918","9427366","3448","1534.31159643","2.24726190431"
"SL2.50ch02:9446878-9450512","29","9446878","9450512","3634","1534.31159643","2.36848890959"
"SL2.50ch02:9459090-9460766","11","9459090","9460766","1676","1534.31159643","1.0923465637"
"SL2.50ch02:9470431-9471176","9","9470431","9471176","745","1534.31159643","0.485559779208"
"SL2.50ch02:9477116-9477890","2","9477116","9477890","774","1534.31159643","0.504460763902"
"SL2.50ch02:9503321-9504323","4","9503321","9504323","1002","1534.31159643","0.653061609083"
"SL2.50ch02:9534345-9535131","7","9534345","9535131","786","1534.31159643","0.512281861017"
"SL2.50ch02:9536410-9537326","10","9536410","9537326","916","1534.31159643","0.597010413094"
"SL2.50ch02:9548043-9549156","9","9548043","9549156","1113","1534.31159643","0.725406757394"
"SL2.50ch02:9565411-9566675","13","9565411","9566675","1264","1534.31159643","0.823822229422"
"SL2.50ch02:9639480-9639855","7","9639480","9639855","375","1534.31159643","0.244409284836"
"SL2.50ch02:9655132-9656369","12","9655132","9656369","1237","1534.31159643","0.806224760913"
"SL2.50ch02:9671401-9671960","2","9671401","9671960","559","1534.31159643","0.364332773929"
"SL2.50ch02:9676056-9676756","3","9676056","9676756","700","1534.31159643","0.456230665028"
"SL2.50ch02:9683072-9683701","0","9683072","9683701","629","1534.31159643","0.409955840432"
"SL2.50ch02:9689807-9690988","6","9689807","9690988","1181","1534.31159643","0.769726307711"
"SL2.50ch02:9717024-9717746","4","9717024","9717746","722","1534.31159643","0.470569343072"
"SL2.50ch03:11058702-11059077","1","11058702","11059077","375","1534.31159643","0.244409284836"
"SL2.50ch03:11213472-11214074","3","11213472","11214074","602","1534.31159643","0.392358371924"
"SL2.50ch03:11743641-11748395","63","11743641","11748395","4754","1534.31159643","3.09845797363"
"SL2.50ch03:11747775-11748446","17","11747775","11748446","671","1534.31159643","0.437329680334"
"SL2.50ch03:12265197-12265680","3","12265197","12265680","483","1534.31159643","0.314799158869"
"SL2.50ch03:12965029-12965619","1","12965029","12965619","590","1534.31159643","0.384537274809"
"SL2.50ch03:13255889-13257488","12","13255889","13257488","1599","1534.31159643","1.04216119054"
"SL2.50ch03:13269637-13270807","3","13269637","13270807","1170","1534.31159643","0.762556968689"
"SL2.50ch03:13285827-13286202","1","13285827","13286202","375","1534.31159643","0.244409284836"
"SL2.50ch03:13310956-13311988","22","13310956","13311988","1032","1534.31159643","0.67261435187"
"SL2.50ch03:13318237-13320243","59","13318237","13320243","2006","1534.31159643","1.30742673435"
"SL2.50ch03:13321597-13325545","38","13321597","13325545","3948","1534.31159643","2.57314095076"
"SL2.50ch03:13328728-13330066","8","13328728","13330066","1338","1534.31159643","0.872052328296"
"SL2.50ch03:13343373-13345685","19","13343373","13345685","2312","1534.31159643","1.50686471078"
"SL2.50ch03:13345017-13345645","12","13345017","13345645","628","1534.31159643","0.409304082339"
"SL2.50ch03:13361926-13363313","25","13361926","13363313","1387","1534.31159643","0.903988474848"
"SL2.50ch03:13361959-13363237","25","13361959","13363237","1278","1534.31159643","0.832946842722"
"SL2.50ch03:13366705-13367423","6","13366705","13367423","718","1534.31159643","0.4679623107"
"SL2.50ch03:13368070-13372262","88","13368070","13372262","4192","1534.31159643","2.73216992542"
"SL2.50ch03:13369009-13372265","80","13369009","13372265","3256","1534.31159643","2.12212435047"
"SL2.50ch03:15952990-15954350","36","15952990","15954350","1360","1534.31159643","0.88639100634"
"SL2.50ch03:15953216-15954272","33","15953216","15954272","1056","1534.31159643","0.688256546099"
"SL2.50ch03:15955742-15957552","64","15955742","15957552","1810","1534.31159643","1.17968214814"
"SL2.50ch03:15955776-15957621","64","15955776","15957621","1845","1534.31159643","1.20249368139"
"SL2.50ch03:15958733-15960416","48","15958733","15960416","1683","1534.31159643","1.09690887035"
"SL2.50ch03:15958738-15960952","51","15958738","15960952","2214","1534.31159643","1.44299241767"
"SL2.50ch03:15969076-15970080","83","15969076","15970080","1004","1534.31159643","0.654365125268"
"SL2.50ch03:15969145-15973104","152","15969145","15973104","3959","1534.31159643","2.58031028978"
"SL2.50ch03:15971377-15973118","66","15971377","15973118","1741","1534.31159643","1.13471083973"
"SL2.50ch03:15974157-15977428","174","15974157","15977428","3271","1534.31159643","2.13190072187"
"SL2.50ch03:15974161-15974663","5","15974161","15974663","502","1534.31159643","0.327182562634"
"SL2.50ch03:15975168-15977466","165","15975168","15977466","2298","1534.31159643","1.49774009748"
"SL2.50ch03:16287134-16287937","6","16287134","16287937","803","1534.31159643","0.523361748596"
"SL2.50ch03:16289540-16291454","19","16289540","16291454","1914","1534.31159643","1.2474649898"
"SL2.50ch03:16290921-16291424","11","16290921","16291424","503","1534.31159643","0.327834320727"
"SL2.50ch03:16295263-16296034","0","16295263","16296034","771","1534.31159643","0.502505489623"
"SL2.50ch03:16306709-16308124","17","16306709","16308124","1415","1534.31159643","0.922237701449"
"SL2.50ch03:16483504-16484101","12","16483504","16484101","597","1534.31159643","0.389099581459"
"SL2.50ch03:16813607-16814233","15","16813607","16814233","626","1534.31159643","0.408000566153"
"SL2.50ch03:17787362-17788004","11","17787362","17788004","642","1534.31159643","0.41842869564"
"SL2.50ch03:1788130-1789325","11","1788130","1789325","1195","1534.31159643","0.778850921012"
"SL2.50ch03:19394122-19395508","11","19394122","19395508","1386","1534.31159643","0.903336716755"
"SL2.50ch03:20102977-20103352","3","20102977","20103352","375","1534.31159643","0.244409284836"
"SL2.50ch03:20151953-20152438","5","20151953","20152438","485","1534.31159643","0.316102675055"
"SL2.50ch03:20391278-20392186","3","20391278","20392186","908","1534.31159643","0.59179634835"
"SL2.50ch03:20430092-20431061","11","20430092","20431061","969","1534.31159643","0.631553592017"
"SL2.50ch03:20510377-20510956","10","20510377","20510956","579","1534.31159643","0.377367935787"
"SL2.50ch03:22923191-22923755","4","22923191","22923755","564","1534.31159643","0.367591564394"
"SL2.50ch03:23544067-23545151","20","23544067","23545151","1084","1534.31159643","0.7065057727"
"SL2.50ch03:23694522-23695413","52","23694522","23695413","891","1534.31159643","0.580716460771"
"SL2.50ch03:23694553-23695405","52","23694553","23695405","852","1534.31159643","0.555297895148"
"SL2.50ch03:23696909-23697471","14","23696909","23697471","562","1534.31159643","0.366288048208"
"SL2.50ch03:23696923-23697463","14","23696923","23697463","540","1534.31159643","0.351949370164"
"SL2.50ch03:24895811-24896734","5","24895811","24896734","923","1534.31159643","0.601572719744"
"SL2.50ch03:25794916-25795551","112","25794916","25795551","635","1534.31159643","0.41386638899"
"SL2.50ch03:25795072-25795633","112","25795072","25795633","561","1534.31159643","0.365636290115"
"SL2.50ch03:27306822-27307351","6","27306822","27307351","529","1534.31159643","0.344780031142"
"SL2.50ch03:28416380-28416853","2","28416380","28416853","473","1534.31159643","0.30828157794"
"SL2.50ch03:29465861-29466440","3","29465861","29466440","579","1534.31159643","0.377367935787"
"SL2.50ch03:29582486-29582986","0","29582486","29582986","500","1534.31159643","0.325879046448"
"SL2.50ch03:29750176-29750777","5","29750176","29750777","601","1534.31159643","0.391706613831"
"SL2.50ch03:30364137-30369932","261","30364137","30369932","5795","1534.31159643","3.77693814834"
"SL2.50ch03:30365354-30369827","248","30365354","30369827","4473","1534.31159643","2.91531394953"
"SL2.50ch03:30568857-30569547","1","30568857","30569547","690","1534.31159643","0.449713084099"
"SL2.50ch03:30712542-30712917","3","30712542","30712917","375","1534.31159643","0.244409284836"
"SL2.50ch03:30751607-30751982","3","30751607","30751982","375","1534.31159643","0.244409284836"
"SL2.50ch03:31454419-31455482","7","31454419","31455482","1063","1534.31159643","0.692818852749"
"SL2.50ch03:31622098-31623811","41","31622098","31623811","1713","1534.31159643","1.11646161313"
"SL2.50ch03:31622181-31623823","41","31622181","31623823","1642","1534.31159643","1.07018678854"
"SL2.50ch03:3174757-3175259","11","3174757","3175259","502","1534.31159643","0.327182562634"
"SL2.50ch03:32171095-32172287","201","32171095","32172287","1192","1534.31159643","0.776895646733"
"SL2.50ch03:32171131-32172275","201","32171131","32172275","1144","1534.31159643","0.745611258274"
"SL2.50ch03:32831365-32831740","1","32831365","32831740","375","1534.31159643","0.244409284836"
"SL2.50ch03:33136306-33137004","833","33136306","33137004","698","1534.31159643","0.454927148842"
"SL2.50ch03:33136487-33137099","833","33136487","33137099","612","1534.31159643","0.398875952853"
"SL2.50ch03:33137645-33140600","5520","33137645","33140600","2955","1534.31159643","1.92594516451"
"SL2.50ch03:33277703-33278173","1","33277703","33278173","470","1534.31159643","0.306326303662"
"SL2.50ch03:33529669-33530151","6","33529669","33530151","482","1534.31159643","0.314147400776"
"SL2.50ch03:34590893-34593313","59","34590893","34593313","2420","1534.31159643","1.57725458481"
"SL2.50ch03:34591050-34593046","59","34591050","34593046","1996","1534.31159643","1.30090915342"
"SL2.50ch03:34595117-34595977","24","34595117","34595977","860","1534.31159643","0.560511959891"
"SL2.50ch03:34595186-34597006","30","34595186","34597006","1820","1534.31159643","1.18619972907"
"SL2.50ch03:34597521-34598361","49","34597521","34598361","840","1534.31159643","0.547476798033"
"SL2.50ch03:34597534-34598433","48","34597534","34598433","899","1534.31159643","0.585930525514"
"SL2.50ch03:34599973-34601583","118","34599973","34601583","1610","1534.31159643","1.04933052956"
"SL2.50ch03:34600055-34601530","117","34600055","34601530","1475","1534.31159643","0.961343187023"
"SL2.50ch03:34606036-34609039","208","34606036","34609039","3003","1534.31159643","1.95722955297"
"SL2.50ch03:34606216-34608819","204","34606216","34608819","2603","1534.31159643","1.69652631581"
"SL2.50ch03:36149961-36150437","3","36149961","36150437","476","1534.31159643","0.310236852219"
"SL2.50ch03:36366203-36366578","1","36366203","36366578","375","1534.31159643","0.244409284836"
"SL2.50ch03:36590703-36591078","5","36590703","36591078","375","1534.31159643","0.244409284836"
"SL2.50ch03:37388243-37388966","36","37388243","37388966","723","1534.31159643","0.471221101164"
"SL2.50ch03:37388255-37389163","38","37388255","37389163","908","1534.31159643","0.59179634835"
"SL2.50ch03:37574696-37575071","1","37574696","37575071","375","1534.31159643","0.244409284836"
"SL2.50ch03:37822705-37823364","2","37822705","37823364","659","1534.31159643","0.429508583219"
"SL2.50ch03:38127483-38128156","2","38127483","38128156","673","1534.31159643","0.43863319652"
"SL2.50ch03:38361197-38362150","1","38361197","38362150","953","1534.31159643","0.621125462531"
"SL2.50ch03:38719280-38719655","4","38719280","38719655","375","1534.31159643","0.244409284836"
"SL2.50ch03:39625938-39626421","0","39625938","39626421","483","1534.31159643","0.314799158869"
"SL2.50ch03:39746103-39747589","24","39746103","39747589","1486","1534.31159643","0.968512526045"
"SL2.50ch03:40280870-40281693","1","40280870","40281693","823","1534.31159643","0.536396910454"
"SL2.50ch03:40663941-40664707","9","40663941","40664707","766","1534.31159643","0.499246699159"
"SL2.50ch03:407239-407963","26","407239","407963","724","1534.31159643","0.471872859257"
"SL2.50ch03:41347339-41347855","21","41347339","41347855","516","1534.31159643","0.336307175935"
"SL2.50ch03:41525316-41529259","41","41525316","41529259","3943","1534.31159643","2.56988216029"
"SL2.50ch03:42823297-42823934","54","42823297","42823934","637","1534.31159643","0.415169905175"
"SL2.50ch03:43238956-43239331","4","43238956","43239331","375","1534.31159643","0.244409284836"
"SL2.50ch03:43439997-43440467","8","43439997","43440467","470","1534.31159643","0.306326303662"
"SL2.50ch03:44111907-44114461","622","44111907","44114461","2554","1534.31159643","1.66459016926"
"SL2.50ch03:44111993-44114489","622","44111993","44114489","2496","1534.31159643","1.62678819987"
"SL2.50ch03:44115827-44117012","684","44115827","44117012","1185","1534.31159643","0.772333340083"
"SL2.50ch03:44115862-44117038","679","44115862","44117038","1176","1534.31159643","0.766467517247"
"SL2.50ch03:44452735-44453445","3","44452735","44453445","710","1534.31159643","0.462748245957"
"SL2.50ch03:44456798-44458035","8","44456798","44458035","1237","1534.31159643","0.806224760913"
"SL2.50ch03:44459174-44460260","14","44459174","44460260","1086","1534.31159643","0.707809288886"
"SL2.50ch03:44888615-44888990","5","44888615","44888990","375","1534.31159643","0.244409284836"
"SL2.50ch03:45065945-45066556","5","45065945","45066556","611","1534.31159643","0.39822419476"
"SL2.50ch03:45136597-45137264","1","45136597","45137264","667","1534.31159643","0.434722647962"
"SL2.50ch03:45289744-45290119","4","45289744","45290119","375","1534.31159643","0.244409284836"
"SL2.50ch03:45379356-45381522","31","45379356","45381522","2166","1534.31159643","1.41170802921"
"SL2.50ch03:46522492-46523088","11","46522492","46523088","596","1534.31159643","0.388447823367"
"SL2.50ch03:47014584-47015543","0","47014584","47015543","959","1534.31159643","0.625036011088"
"SL2.50ch03:48906516-48909745","31","48906516","48909745","3229","1534.31159643","2.10452688196"
"SL2.50ch03:48907463-48908286","20","48907463","48908286","823","1534.31159643","0.536396910454"
"SL2.50ch03:49590590-49590965","0","49590590","49590965","375","1534.31159643","0.244409284836"
"SL2.50ch03:49931866-49932241","4","49931866","49932241","375","1534.31159643","0.244409284836"
"SL2.50ch03:50412262-50412732","4","50412262","50412732","470","1534.31159643","0.306326303662"
"SL2.50ch03:50954079-50954793","1","50954079","50954793","714","1534.31159643","0.465355278328"
"SL2.50ch03:51201915-51202653","3","51201915","51202653","738","1534.31159643","0.480997472558"
"SL2.50ch03:51702327-51702992","44","51702327","51702992","665","1534.31159643","0.433419131776"
"SL2.50ch03:51702481-51703095","44","51702481","51703095","614","1534.31159643","0.400179469039"
"SL2.50ch03:52270878-52272691","21","52270878","52272691","1813","1534.31159643","1.18163742242"
"SL2.50ch03:52274986-52275969","18","52274986","52275969","983","1534.31159643","0.640678205318"
"SL2.50ch03:52597401-52597803","10","52597401","52597803","402","1534.31159643","0.262006753345"
"SL2.50ch03:53569746-53570307","9","53569746","53570307","561","1534.31159643","0.365636290115"
"SL2.50ch03:53623667-53624356","14","53623667","53624356","689","1534.31159643","0.449061326006"
"SL2.50ch03:53627832-53628544","82","53627832","53628544","712","1534.31159643","0.464051762143"
"SL2.50ch03:53627858-53628621","82","53627858","53628621","763","1534.31159643","0.49729142488"
"SL2.50ch03:53931373-53932658","36","53931373","53932658","1285","1534.31159643","0.837509149372"
"SL2.50ch03:54169559-54172842","51","54169559","54172842","3283","1534.31159643","2.13972181898"
"SL2.50ch03:54169580-54172792","50","54169580","54172792","3212","1534.31159643","2.09344699438"
"SL2.50ch03:54176340-54177266","26","54176340","54177266","926","1534.31159643","0.603527994023"
"SL2.50ch03:54176397-54177355","27","54176397","54177355","958","1534.31159643","0.624384252995"
"SL2.50ch03:54180801-54182640","28","54180801","54182640","1839","1534.31159643","1.19858313284"
"SL2.50ch03:56488540-56490509","267","56488540","56490509","1969","1534.31159643","1.28331168491"
"SL2.50ch03:56488743-56490395","267","56488743","56490395","1652","1534.31159643","1.07670436947"
"SL2.50ch03:57120790-57121298","4","57120790","57121298","508","1534.31159643","0.331093111192"
"SL2.50ch03:60836717-60839032","22","60836717","60839032","2315","1534.31159643","1.50881998506"
"SL2.50ch03:60887178-60887935","11","60887178","60887935","757","1534.31159643","0.493380876323"
"SL2.50ch03:62569594-62569996","9","62569594","62569996","402","1534.31159643","0.262006753345"
"SL2.50ch03:6454447-6455012","9","6454447","6455012","565","1534.31159643","0.368243322487"
"SL2.50ch03:64832472-64835555","25","64832472","64835555","3083","1534.31159643","2.0093702004"
"SL2.50ch03:64925071-64929301","39","64925071","64929301","4230","1534.31159643","2.75693673295"
"SL2.50ch03:65838849-65839411","11","65838849","65839411","562","1534.31159643","0.366288048208"
"SL2.50ch03:67851346-67851836","120","67851346","67851836","490","1534.31159643","0.319361465519"
"SL2.50ch03:67851421-67851889","120","67851421","67851889","468","1534.31159643","0.305022787476"
"SL2.50ch03:6883156-6883946","9","6883156","6883946","790","1534.31159643","0.514888893389"
"SL2.50ch03:6919095-6919569","14","6919095","6919569","474","1534.31159643","0.308933336033"
"SL2.50ch03:6921518-6922643","12","6921518","6922643","1125","1534.31159643","0.733227854509"
"SL2.50ch03:6947130-6948891","24","6947130","6948891","1761","1534.31159643","1.14774600159"
"SL2.50ch03:6950630-6953393","18","6950630","6953393","2763","1534.31159643","1.80080761067"
"SL2.50ch03:6965441-6966808","25","6965441","6966808","1367","1534.31159643","0.89095331299"
"SL2.50ch03:70528807-70529413","14","70528807","70529413","606","1534.31159643","0.394965404296"
"SL2.50ch03:7105723-7106192","11","7105723","7106192","469","1534.31159643","0.305674545569"
"SL2.50ch03:7108873-7110202","13","7108873","7110202","1329","1534.31159643","0.86618650546"
"SL2.50ch04:11167865-11168494","28","11167865","11168494","629","1534.31159643","0.409955840432"
"SL2.50ch04:11568536-11569010","10","11568536","11569010","474","1534.31159643","0.308933336033"
"SL2.50ch04:12134891-12135381","2","12134891","12135381","490","1534.31159643","0.319361465519"
"SL2.50ch04:12536113-12537064","14","12536113","12537064","951","1534.31159643","0.619821946345"
"SL2.50ch04:12545616-12546288","12","12545616","12546288","672","1534.31159643","0.437981438427"
"SL2.50ch04:12547228-12547707","8","12547228","12547707","479","1534.31159643","0.312192126498"
"SL2.50ch04:13811031-13811873","9","13811031","13811873","842","1534.31159643","0.548780314219"
"SL2.50ch04:14454669-14455748","10","14454669","14455748","1079","1534.31159643","0.703246982236"
"SL2.50ch04:14534431-14535267","8","14534431","14535267","836","1534.31159643","0.544869765662"
"SL2.50ch04:14616344-14616913","10","14616344","14616913","569","1534.31159643","0.370850354858"
"SL2.50ch04:14677241-14677991","9","14677241","14677991","750","1534.31159643","0.488818569673"
"SL2.50ch04:14685626-14686434","8","14685626","14686434","808","1534.31159643","0.526620539061"
"SL2.50ch04:14715454-14716627","9","14715454","14716627","1173","1534.31159643","0.764512242968"
"SL2.50ch04:14729594-14730907","16","14729594","14730907","1313","1534.31159643","0.855758375974"
"SL2.50ch04:14738542-14739013","4","14738542","14739013","471","1534.31159643","0.306978061754"
"SL2.50ch04:14742352-14743858","22","14742352","14743858","1506","1534.31159643","0.981547687903"
"SL2.50ch04:14755876-14756951","6","14755876","14756951","1075","1534.31159643","0.700639949864"
"SL2.50ch04:14768565-14769960","20","14768565","14769960","1395","1534.31159643","0.909202539591"
"SL2.50ch04:14807941-14809954","21","14807941","14809954","2013","1534.31159643","1.311989041"
"SL2.50ch04:14813993-14814806","19","14813993","14814806","813","1534.31159643","0.529879329525"
"SL2.50ch04:14834142-14836881","28","14834142","14836881","2739","1534.31159643","1.78516541644"
"SL2.50ch04:14841334-14841876","7","14841334","14841876","542","1534.31159643","0.35325288635"
"SL2.50ch04:14842574-14844001","7","14842574","14844001","1427","1534.31159643","0.930058798564"
"SL2.50ch04:14985947-14986465","2","14985947","14986465","518","1534.31159643","0.337610692121"
"SL2.50ch04:15038494-15039297","7","15038494","15039297","803","1534.31159643","0.523361748596"
"SL2.50ch04:15038500-15041316","25","15038500","15041316","2816","1534.31159643","1.8353507896"
"SL2.50ch04:15417417-15418005","10","15417417","15418005","588","1534.31159643","0.383233758623"
"SL2.50ch04:15958079-15958454","0","15958079","15958454","375","1534.31159643","0.244409284836"
"SL2.50ch04:17160851-17161555","8","17160851","17161555","704","1534.31159643","0.458837697399"
"SL2.50ch04:17249218-17250111","8","17249218","17250111","893","1534.31159643","0.582019976957"
"SL2.50ch04:17251619-17251994","1","17251619","17251994","375","1534.31159643","0.244409284836"
"SL2.50ch04:18560488-18561075","49","18560488","18561075","587","1534.31159643","0.38258200053"
"SL2.50ch04:18560554-18561096","49","18560554","18561096","542","1534.31159643","0.35325288635"
"SL2.50ch04:19878321-19878696","4","19878321","19878696","375","1534.31159643","0.244409284836"
"SL2.50ch04:20399812-20400187","4","20399812","20400187","375","1534.31159643","0.244409284836"
"SL2.50ch04:20722013-20722494","6","20722013","20722494","481","1534.31159643","0.313495642683"
"SL2.50ch04:20773780-20774549","5","20773780","20774549","769","1534.31159643","0.501201973438"
"SL2.50ch04:21059530-21059905","4","21059530","21059905","375","1534.31159643","0.244409284836"
"SL2.50ch04:21369111-21369486","1","21369111","21369486","375","1534.31159643","0.244409284836"
"SL2.50ch04:21474510-21475246","3","21474510","21475246","736","1534.31159643","0.479693956372"
"SL2.50ch04:21979423-21979950","6","21979423","21979950","527","1534.31159643","0.343476514957"
"SL2.50ch04:24046018-24046963","10","24046018","24046963","945","1534.31159643","0.615911397788"
"SL2.50ch04:248030-248432","6","248030","248432","402","1534.31159643","0.262006753345"
"SL2.50ch04:25230288-25230780","4","25230288","25230780","492","1534.31159643","0.320664981705"
"SL2.50ch04:26075214-26075689","0","26075214","26075689","475","1534.31159643","0.309585094126"
"SL2.50ch04:26395424-26397215","5","26395424","26397215","1791","1534.31159643","1.16729874438"
"SL2.50ch04:26620940-26622083","21","26620940","26622083","1143","1534.31159643","0.744959500181"
"SL2.50ch04:26655663-26657240","18","26655663","26657240","1577","1534.31159643","1.0278225125"
"SL2.50ch04:26669361-26671911","27","26669361","26671911","2550","1534.31159643","1.66198313689"
"SL2.50ch04:26674539-26675115","1","26674539","26675115","576","1534.31159643","0.375412661509"
"SL2.50ch04:26705733-26708543","24","26705733","26708543","2810","1534.31159643","1.83144024104"
"SL2.50ch04:26707198-26708153","13","26707198","26708153","955","1534.31159643","0.622428978717"
"SL2.50ch04:26712301-26716719","28","26712301","26716719","4418","1534.31159643","2.87946725442"
"SL2.50ch04:26717448-26722901","42","26717448","26722901","5453","1534.31159643","3.55403688057"
"SL2.50ch04:26721964-26722601","9","26721964","26722601","637","1534.31159643","0.415169905175"
"SL2.50ch04:26757403-26764442","49","26757403","26764442","7039","1534.31159643","4.5877252159"
"SL2.50ch04:26778881-26785520","67","26778881","26785520","6639","1534.31159643","4.32702197874"
"SL2.50ch04:26795859-26796448","6","26795859","26796448","589","1534.31159643","0.383885516716"
"SL2.50ch04:26825939-26827886","10","26825939","26827886","1947","1534.31159643","1.26897300687"
"SL2.50ch04:26834101-26837317","21","26834101","26837317","3216","1534.31159643","2.09605402676"
"SL2.50ch04:26837800-26842030","40","26837800","26842030","4230","1534.31159643","2.75693673295"
"SL2.50ch04:26842476-26843087","5","26842476","26843087","611","1534.31159643","0.39822419476"
"SL2.50ch04:27596327-27597043","1","27596327","27597043","716","1534.31159643","0.466658794514"
"SL2.50ch04:28236598-28236973","3","28236598","28236973","375","1534.31159643","0.244409284836"
"SL2.50ch04:28522434-28523268","3","28522434","28523268","834","1534.31159643","0.543566249476"
"SL2.50ch04:28683585-28684526","2","28683585","28684526","941","1534.31159643","0.613304365416"
"SL2.50ch04:28706517-28706892","4","28706517","28706892","375","1534.31159643","0.244409284836"
"SL2.50ch04:28822623-28823312","5","28822623","28823312","689","1534.31159643","0.449061326006"
"SL2.50ch04:29184607-29186133","11","29184607","29186133","1526","1534.31159643","0.994582849761"
"SL2.50ch04:30142865-30143540","10","30142865","30143540","675","1534.31159643","0.439936712705"
"SL2.50ch04:31278302-31278785","1","31278302","31278785","483","1534.31159643","0.314799158869"
"SL2.50ch04:31286822-31287586","71","31286822","31287586","764","1534.31159643","0.497943182973"
"SL2.50ch04:31286912-31287515","71","31286912","31287515","603","1534.31159643","0.393010130017"
"SL2.50ch04:31883443-31883818","6","31883443","31883818","375","1534.31159643","0.244409284836"
"SL2.50ch04:32073532-32073907","3","32073532","32073907","375","1534.31159643","0.244409284836"
"SL2.50ch04:32664006-32664594","1","32664006","32664594","588","1534.31159643","0.383233758623"
"SL2.50ch04:33195737-33196632","1","33195737","33196632","895","1534.31159643","0.583323493143"
"SL2.50ch04:33411788-33412553","28","33411788","33412553","765","1534.31159643","0.498594941066"
"SL2.50ch04:33411857-33412482","28","33411857","33412482","625","1534.31159643","0.407348808061"
"SL2.50ch04:33600068-33600848","20","33600068","33600848","780","1534.31159643","0.50837131246"
"SL2.50ch04:33600221-33600711","19","33600221","33600711","490","1534.31159643","0.319361465519"
"SL2.50ch04:33964712-33965872","58","33964712","33965872","1160","1534.31159643","0.75603938776"
"SL2.50ch04:33966316-33967439","43","33966316","33967439","1123","1534.31159643","0.731924338323"
"SL2.50ch04:35556262-35557403","3","35556262","35557403","1141","1534.31159643","0.743655983995"
"SL2.50ch04:35724231-35724606","2","35724231","35724606","375","1534.31159643","0.244409284836"
"SL2.50ch04:36421237-36421612","0","36421237","36421612","375","1534.31159643","0.244409284836"
"SL2.50ch04:37931966-37932599","2","37931966","37932599","633","1534.31159643","0.412562872804"
"SL2.50ch04:4062224-4062839","15","4062224","4062839","615","1534.31159643","0.400831227132"
"SL2.50ch04:4062368-4062840","15","4062368","4062840","472","1534.31159643","0.307629819847"
"SL2.50ch04:40873440-40873972","2","40873440","40873972","532","1534.31159643","0.346735305421"
"SL2.50ch04:41198237-41199273","20","41198237","41199273","1036","1534.31159643","0.675221384241"
"SL2.50ch04:41198767-41199169","12","41198767","41199169","402","1534.31159643","0.262006753345"
"SL2.50ch04:41209844-41211136","12","41209844","41211136","1292","1534.31159643","0.842071456023"
"SL2.50ch04:41210288-41210690","4","41210288","41210690","402","1534.31159643","0.262006753345"
"SL2.50ch04:41212108-41212910","35","41212108","41212910","802","1534.31159643","0.522709990503"
"SL2.50ch04:41212181-41214051","49","41212181","41214051","1870","1534.31159643","1.21878763372"
"SL2.50ch04:42479013-42479482","3","42479013","42479482","469","1534.31159643","0.305674545569"
"SL2.50ch04:42564984-42565487","13","42564984","42565487","503","1534.31159643","0.327834320727"
"SL2.50ch04:42863763-42864367","7","42863763","42864367","604","1534.31159643","0.39366188811"
"SL2.50ch04:42863868-42864270","6","42863868","42864270","402","1534.31159643","0.262006753345"
"SL2.50ch04:43245790-43246413","30","43245790","43246413","623","1534.31159643","0.406045291875"
"SL2.50ch04:4481891-4482361","19","4481891","4482361","470","1534.31159643","0.306326303662"
"SL2.50ch04:4481981-4482383","18","4481981","4482383","402","1534.31159643","0.262006753345"
"SL2.50ch04:45285911-45287297","14","45285911","45287297","1386","1534.31159643","0.903336716755"
"SL2.50ch04:48279789-48280361","6","48279789","48280361","572","1534.31159643","0.372805629137"
"SL2.50ch04:49036971-49038698","31","49036971","49038698","1727","1534.31159643","1.12558622643"
"SL2.50ch04:49143558-49143933","6","49143558","49143933","375","1534.31159643","0.244409284836"
"SL2.50ch04:49645104-49645946","6","49645104","49645946","842","1534.31159643","0.548780314219"
"SL2.50ch04:50234340-50234809","6","50234340","50234809","469","1534.31159643","0.305674545569"
"SL2.50ch04:50472460-50472835","10","50472460","50472835","375","1534.31159643","0.244409284836"
"SL2.50ch04:51278355-51279207","17","51278355","51279207","852","1534.31159643","0.555297895148"
"SL2.50ch04:51485000-51485853","12","51485000","51485853","853","1534.31159643","0.555949653241"
"SL2.50ch04:51635479-51636070","3","51635479","51636070","591","1534.31159643","0.385189032902"
"SL2.50ch04:53908837-53910787","16","53908837","53910787","1950","1534.31159643","1.27092828115"
"SL2.50ch04:54906279-54907178","10","54906279","54907178","899","1534.31159643","0.585930525514"
"SL2.50ch04:55562801-55563366","5","55562801","55563366","565","1534.31159643","0.368243322487"
"SL2.50ch04:55565029-55568902","35","55565029","55568902","3873","1534.31159643","2.52425909379"
"SL2.50ch04:56149404-56149902","27","56149404","56149902","498","1534.31159643","0.324575530263"
"SL2.50ch04:56149433-56149923","24","56149433","56149923","490","1534.31159643","0.319361465519"
"SL2.50ch04:58235758-58236265","23","58235758","58236265","507","1534.31159643","0.330441353099"
"SL2.50ch04:64832233-64832635","24","64832233","64832635","402","1534.31159643","0.262006753345"
"SL2.50ch04:65387298-65387815","22","65387298","65387815","517","1534.31159643","0.336958934028"
"SL2.50ch04:6910496-6910986","30","6910496","6910986","490","1534.31159643","0.319361465519"
"SL2.50ch04:7364261-7369138","44","7364261","7369138","4877","1534.31159643","3.17862421906"
"SL2.50ch04:7371892-7377121","64","7371892","7377121","5229","1534.31159643","3.40804306776"
"SL2.50ch04:7380735-7382481","15","7380735","7382481","1746","1534.31159643","1.1379696302"
"SL2.50ch04:7382991-7384030","20","7382991","7384030","1039","1534.31159643","0.67717665852"
"SL2.50ch04:7386752-7387485","7","7386752","7387485","733","1534.31159643","0.477738682093"
"SL2.50ch04:7459635-7460520","4","7459635","7460520","885","1534.31159643","0.576805912214"
"SL2.50ch05:10221775-10222463","6","10221775","10222463","688","1534.31159643","0.448409567913"
"SL2.50ch05:11785098-11785615","18","11785098","11785615","517","1534.31159643","0.336958934028"
"SL2.50ch05:12450271-12450772","6","12450271","12450772","501","1534.31159643","0.326530804541"
"SL2.50ch05:124759-125269","16","124759","125269","510","1534.31159643","0.332396627377"
"SL2.50ch05:124783-125158","16","124783","125158","375","1534.31159643","0.244409284836"
"SL2.50ch05:14605812-14607111","314","14605812","14607111","1299","1534.31159643","0.846633762673"
"SL2.50ch05:14606104-14607177","314","14606104","14607177","1073","1534.31159643","0.699336433678"
"SL2.50ch05:14690339-14690813","0","14690339","14690813","474","1534.31159643","0.308933336033"
"SL2.50ch05:16694334-16695352","6","16694334","16695352","1018","1534.31159643","0.663489738569"
"SL2.50ch05:16723083-16723458","2","16723083","16723458","375","1534.31159643","0.244409284836"
"SL2.50ch05:16979697-16980582","7","16979697","16980582","885","1534.31159643","0.576805912214"
"SL2.50ch05:17037597-17038067","2","17037597","17038067","470","1534.31159643","0.306326303662"
"SL2.50ch05:17039214-17042071","30","17039214","17042071","2857","1534.31159643","1.86207287141"
"SL2.50ch05:17047401-17049149","12","17047401","17049149","1748","1534.31159643","1.13927314638"
"SL2.50ch05:17049999-17051202","13","17049999","17051202","1203","1534.31159643","0.784064985755"
"SL2.50ch05:17051674-17053585","15","17051674","17053585","1911","1534.31159643","1.24550971553"
"SL2.50ch05:17159967-17160908","3","17159967","17160908","941","1534.31159643","0.613304365416"
"SL2.50ch05:17351314-17351783","3","17351314","17351783","469","1534.31159643","0.305674545569"
"SL2.50ch05:17385040-17386799","12","17385040","17386799","1759","1534.31159643","1.14644248541"
"SL2.50ch05:17470266-17470748","3","17470266","17470748","482","1534.31159643","0.314147400776"
"SL2.50ch05:18101997-18104616","22","18101997","18104616","2619","1534.31159643","1.7069544453"
"SL2.50ch05:18552024-18552965","11","18552024","18552965","941","1534.31159643","0.613304365416"
"SL2.50ch05:19596372-19596747","2","19596372","19596747","375","1534.31159643","0.244409284836"
"SL2.50ch05:1959664-1960304","0","1959664","1960304","640","1534.31159643","0.417125179454"
"SL2.50ch05:19600676-19604409","57","19600676","19604409","3733","1534.31159643","2.43301296078"
"SL2.50ch05:19605239-19606212","12","19605239","19606212","973","1534.31159643","0.634160624389"
"SL2.50ch05:19607655-19608710","3","19607655","19608710","1055","1534.31159643","0.687604788006"
"SL2.50ch05:19639952-19645121","57","19639952","19645121","5169","1534.31159643","3.36893758218"
"SL2.50ch05:19649748-19655004","53","19649748","19655004","5256","1534.31159643","3.42564053627"
"SL2.50ch05:19672296-19678999","53","19672296","19678999","6703","1534.31159643","4.36873449669"
"SL2.50ch05:19691784-19692791","5","19691784","19692791","1007","1534.31159643","0.656320399547"
"SL2.50ch05:19710141-19716979","48","19710141","19716979","6838","1534.31159643","4.45672183923"
"SL2.50ch05:19834195-19835596","15","19834195","19835596","1401","1534.31159643","0.913113088149"
"SL2.50ch05:19838872-19840504","14","19838872","19840504","1632","1534.31159643","1.06366920761"
"SL2.50ch05:19852665-19856166","28","19852665","19856166","3501","1534.31159643","2.28180508323"
"SL2.50ch05:19856497-19856899","3","19856497","19856899","402","1534.31159643","0.262006753345"
"SL2.50ch05:20464725-20465198","1","20464725","20465198","473","1534.31159643","0.30828157794"
"SL2.50ch05:20931305-20931870","4","20931305","20931870","565","1534.31159643","0.368243322487"
"SL2.50ch05:2203006-2203774","45","2203006","2203774","768","1534.31159643","0.500550215345"
"SL2.50ch05:2203064-2203696","45","2203064","2203696","632","1534.31159643","0.411911114711"
"SL2.50ch05:23493368-23493743","1","23493368","23493743","375","1534.31159643","0.244409284836"
"SL2.50ch05:24103540-24104273","14","24103540","24104273","733","1534.31159643","0.477738682093"
"SL2.50ch05:24361724-24362496","44","24361724","24362496","772","1534.31159643","0.503157247716"
"SL2.50ch05:24361765-24362394","44","24361765","24362394","629","1534.31159643","0.409955840432"
"SL2.50ch05:25812465-25813284","141","25812465","25813284","819","1534.31159643","0.533789878083"
"SL2.50ch05:25812610-25813324","139","25812610","25813324","714","1534.31159643","0.465355278328"
"SL2.50ch05:26626503-26626905","30","26626503","26626905","402","1534.31159643","0.262006753345"
"SL2.50ch05:26632661-26633731","8","26632661","26633731","1070","1534.31159643","0.6973811594"
"SL2.50ch05:27250714-27251089","3","27250714","27251089","375","1534.31159643","0.244409284836"
"SL2.50ch05:27332290-27332780","15","27332290","27332780","490","1534.31159643","0.319361465519"
"SL2.50ch05:27332339-27332714","15","27332339","27332714","375","1534.31159643","0.244409284836"
"SL2.50ch05:28102352-28102954","5","28102352","28102954","602","1534.31159643","0.392358371924"
"SL2.50ch05:28301241-28302022","143","28301241","28302022","781","1534.31159643","0.509023070552"
"SL2.50ch05:28301334-28301960","143","28301334","28301960","626","1534.31159643","0.408000566153"
"SL2.50ch05:29407450-29407825","1","29407450","29407825","375","1534.31159643","0.244409284836"
"SL2.50ch05:29577080-29577455","3","29577080","29577455","375","1534.31159643","0.244409284836"
"SL2.50ch05:30101233-30101608","5","30101233","30101608","375","1534.31159643","0.244409284836"
"SL2.50ch05:30135085-30135988","5","30135085","30135988","903","1534.31159643","0.588537557886"
"SL2.50ch05:30137680-30138917","13","30137680","30138917","1237","1534.31159643","0.806224760913"
"SL2.50ch05:30137755-30138678","11","30137755","30138678","923","1534.31159643","0.601572719744"
"SL2.50ch05:30147666-30148456","3","30147666","30148456","790","1534.31159643","0.514888893389"
"SL2.50ch05:30149749-30150226","4","30149749","30150226","477","1534.31159643","0.310888610312"
"SL2.50ch05:30155193-30155675","9","30155193","30155675","482","1534.31159643","0.314147400776"
"SL2.50ch05:30156832-30157338","9","30156832","30157338","506","1534.31159643","0.329789595006"
"SL2.50ch05:30156848-30157316","9","30156848","30157316","468","1534.31159643","0.305022787476"
"SL2.50ch05:31170466-31171574","12","31170466","31171574","1108","1534.31159643","0.72214796693"
"SL2.50ch05:31776383-31776892","24","31776383","31776892","509","1534.31159643","0.331744869285"
"SL2.50ch05:32634842-32635820","13","32634842","32635820","978","1534.31159643","0.637419414853"
"SL2.50ch05:33142930-33143667","6","33142930","33143667","737","1534.31159643","0.480345714465"
"SL2.50ch05:34059111-34059601","53","34059111","34059601","490","1534.31159643","0.319361465519"
"SL2.50ch05:34096133-34097461","882","34096133","34097461","1328","1534.31159643","0.865534747367"
"SL2.50ch05:34096262-34097363","882","34096262","34097363","1101","1534.31159643","0.717585660279"
"SL2.50ch05:34099408-34100973","5278","34099408","34100973","1565","1534.31159643","1.02000141538"
"SL2.50ch05:34099468-34100859","5278","34099468","34100859","1391","1534.31159643","0.90659550722"
"SL2.50ch05:35698420-35699648","52","35698420","35699648","1228","1534.31159643","0.800358938077"
"SL2.50ch05:35698569-35699548","52","35698569","35699548","979","1534.31159643","0.638071172946"
"SL2.50ch05:36600134-36600509","9","36600134","36600509","375","1534.31159643","0.244409284836"
"SL2.50ch05:36816130-36816505","0","36816130","36816505","375","1534.31159643","0.244409284836"
"SL2.50ch05:36962613-36963103","29","36962613","36963103","490","1534.31159643","0.319361465519"
"SL2.50ch05:36962627-36963125","29","36962627","36963125","498","1534.31159643","0.324575530263"
"SL2.50ch05:37476736-37477111","4","37476736","37477111","375","1534.31159643","0.244409284836"
"SL2.50ch05:40067674-40069045","29","40067674","40069045","1371","1534.31159643","0.893560345362"
"SL2.50ch05:40068113-40069049","28","40068113","40069049","936","1534.31159643","0.610045574951"
"SL2.50ch05:41165357-41165846","5","41165357","41165846","489","1534.31159643","0.318709707427"
"SL2.50ch05:41940526-41940901","6","41940526","41940901","375","1534.31159643","0.244409284836"
"SL2.50ch05:41976040-41976415","4","41976040","41976415","375","1534.31159643","0.244409284836"
"SL2.50ch05:42985477-42985949","16","42985477","42985949","472","1534.31159643","0.307629819847"
"SL2.50ch05:42985495-42985999","17","42985495","42985999","504","1534.31159643","0.32848607882"
"SL2.50ch05:45135206-45136043","105","45135206","45136043","837","1534.31159643","0.545521523755"
"SL2.50ch05:45135258-45135873","105","45135258","45135873","615","1534.31159643","0.400831227132"
"SL2.50ch05:47140025-47140809","0","47140025","47140809","784","1534.31159643","0.510978344831"
"SL2.50ch05:47294704-47295828","9","47294704","47295828","1124","1534.31159643","0.732576096416"
"SL2.50ch05:47551289-47551880","3","47551289","47551880","591","1534.31159643","0.385189032902"
"SL2.50ch05:47671730-47672105","2","47671730","47672105","375","1534.31159643","0.244409284836"
"SL2.50ch05:48166716-48167327","4","48166716","48167327","611","1534.31159643","0.39822419476"
"SL2.50ch05:48423913-48424315","16","48423913","48424315","402","1534.31159643","0.262006753345"
"SL2.50ch05:49228459-49228834","1","49228459","49228834","375","1534.31159643","0.244409284836"
"SL2.50ch05:49830583-49830958","3","49830583","49830958","375","1534.31159643","0.244409284836"
"SL2.50ch05:49929704-49930705","20","49929704","49930705","1001","1534.31159643","0.65240985099"
"SL2.50ch05:49929897-49930538","20","49929897","49930538","641","1534.31159643","0.417776937547"
"SL2.50ch05:51313961-51315479","441","51313961","51315479","1518","1534.31159643","0.989368785017"
"SL2.50ch05:51314130-51315314","438","51314130","51315314","1184","1534.31159643","0.77168158199"
"SL2.50ch05:51316938-51317633","3","51316938","51317633","695","1534.31159643","0.452971874563"
"SL2.50ch05:51317025-51317543","3","51317025","51317543","518","1534.31159643","0.337610692121"
"SL2.50ch05:51467477-51468328","15","51467477","51468328","851","1534.31159643","0.554646137055"
"SL2.50ch05:5398937-5399493","0","5398937","5399493","556","1534.31159643","0.362377499651"
"SL2.50ch05:56673377-56673752","1","56673377","56673752","375","1534.31159643","0.244409284836"
"SL2.50ch05:56705687-56706449","11","56705687","56706449","762","1534.31159643","0.496639666787"
"SL2.50ch05:56705909-56706311","9","56705909","56706311","402","1534.31159643","0.262006753345"
"SL2.50ch05:57568564-57573125","123","57568564","57573125","4561","1534.31159643","2.9726686617"
"SL2.50ch05:57569065-57571282","20","57569065","57571282","2217","1534.31159643","1.44494769195"
"SL2.50ch05:57571670-57573071","94","57571670","57573071","1401","1534.31159643","0.913113088149"
"SL2.50ch05:57574567-57576582","44","57574567","57576582","2015","1534.31159643","1.31329255719"
"SL2.50ch05:57574895-57576031","40","57574895","57576031","1136","1534.31159643","0.740397193531"
"SL2.50ch05:57583723-57584484","7","57583723","57584484","761","1534.31159643","0.495987908695"
"SL2.50ch05:57583750-57584573","8","57583750","57584573","823","1534.31159643","0.536396910454"
"SL2.50ch05:57990456-57991043","2","57990456","57991043","587","1534.31159643","0.38258200053"
"SL2.50ch05:58886943-58888070","17","58886943","58888070","1127","1534.31159643","0.734531370695"
"SL2.50ch05:58887104-58887646","6","58887104","58887646","542","1534.31159643","0.35325288635"
"SL2.50ch05:58892060-58892860","252","58892060","58892860","800","1534.31159643","0.521406474318"
"SL2.50ch05:58892105-58892790","252","58892105","58892790","685","1534.31159643","0.446454293634"
"SL2.50ch05:60997404-60998305","21","60997404","60998305","901","1534.31159643","0.5872340417"
"SL2.50ch05:60997419-60998286","21","60997419","60998286","867","1534.31159643","0.565074266542"
"SL2.50ch05:62772343-62773063","69","62772343","62773063","720","1534.31159643","0.469265826886"
"SL2.50ch05:62772472-62772980","67","62772472","62772980","508","1534.31159643","0.331093111192"
"SL2.50ch05:62857695-62858167","2","62857695","62858167","472","1534.31159643","0.307629819847"
"SL2.50ch05:62857730-62858132","2","62857730","62858132","402","1534.31159643","0.262006753345"
"SL2.50ch05:64808123-64809136","16","64808123","64809136","1013","1534.31159643","0.660230948105"
"SL2.50ch05:6498327-6499129","240","6498327","6499129","802","1534.31159643","0.522709990503"
"SL2.50ch05:6498340-6499318","240","6498340","6499318","978","1534.31159643","0.637419414853"
"SL2.50ch05:6728431-6728921","10","6728431","6728921","490","1534.31159643","0.319361465519"
"SL2.50ch05:6773480-6774045","39","6773480","6774045","565","1534.31159643","0.368243322487"
"SL2.50ch05:6773513-6774003","39","6773513","6774003","490","1534.31159643","0.319361465519"
"SL2.50ch05:8435969-8436440","3","8435969","8436440","471","1534.31159643","0.306978061754"
"SL2.50ch05:8891224-8892218","6","8891224","8892218","994","1534.31159643","0.647847544339"
"SL2.50ch05:9087602-9088399","7","9087602","9088399","797","1534.31159643","0.519451200039"
"SL2.50ch05:932544-933080","1","932544","933080","536","1534.31159643","0.349342337793"
"SL2.50ch05:9672010-9673035","2","9672010","9673035","1025","1534.31159643","0.668052045219"
"SL2.50ch06:10946406-10946781","1","10946406","10946781","375","1534.31159643","0.244409284836"
"SL2.50ch06:10947690-10948333","2","10947690","10948333","643","1534.31159643","0.419080453733"
"SL2.50ch06:10947723-10948504","2","10947723","10948504","781","1534.31159643","0.509023070552"
"SL2.50ch06:10950419-10951848","27","10950419","10951848","1429","1534.31159643","0.93136231475"
"SL2.50ch06:10951139-10951768","15","10951139","10951768","629","1534.31159643","0.409955840432"
"SL2.50ch06:10957290-10958336","26","10957290","10958336","1046","1534.31159643","0.68173896517"
"SL2.50ch06:10957404-10958264","25","10957404","10958264","860","1534.31159643","0.560511959891"
"SL2.50ch06:10960949-10962258","20","10960949","10962258","1309","1534.31159643","0.853151343602"
"SL2.50ch06:10961192-10962318","19","10961192","10962318","1126","1534.31159643","0.733879612602"
"SL2.50ch06:10963237-10964462","17","10963237","10964462","1225","1534.31159643","0.798403663799"
"SL2.50ch06:10963704-10964378","12","10963704","10964378","674","1534.31159643","0.439284954612"
"SL2.50ch06:10965818-10966637","18","10965818","10966637","819","1534.31159643","0.533789878083"
"SL2.50ch06:10965974-10966580","16","10965974","10966580","606","1534.31159643","0.394965404296"
"SL2.50ch06:10968849-10970164","22","10968849","10970164","1315","1534.31159643","0.857061892159"
"SL2.50ch06:10968874-10970273","22","10968874","10970273","1399","1534.31159643","0.911809571963"
"SL2.50ch06:10971739-10972830","38","10971739","10972830","1091","1534.31159643","0.71106807935"
"SL2.50ch06:10971756-10972893","38","10971756","10972893","1137","1534.31159643","0.741048951624"
"SL2.50ch06:10979435-10980097","17","10979435","10980097","662","1534.31159643","0.431463857498"
"SL2.50ch06:10979499-10980082","17","10979499","10980082","583","1534.31159643","0.379974968159"
"SL2.50ch06:10982149-10982966","21","10982149","10982966","817","1534.31159643","0.532486361897"
"SL2.50ch06:10982192-10983000","21","10982192","10983000","808","1534.31159643","0.526620539061"
"SL2.50ch06:10986800-10990160","82","10986800","10990160","3360","1534.31159643","2.18990719213"
"SL2.50ch06:10986803-10990089","82","10986803","10990089","3286","1534.31159643","2.14167709326"
"SL2.50ch06:10996599-10999028","39","10996599","10999028","2429","1534.31159643","1.58312040765"
"SL2.50ch06:10996667-10998928","39","10996667","10998928","2261","1534.31159643","1.47362504804"
"SL2.50ch06:11000039-11000967","35","11000039","11000967","928","1534.31159643","0.604831510208"
"SL2.50ch06:11000042-11000979","35","11000042","11000979","937","1534.31159643","0.610697333044"
"SL2.50ch06:11008968-11009484","9","11008968","11009484","516","1534.31159643","0.336307175935"
"SL2.50ch06:11008998-11014464","82","11008998","11014464","5466","1534.31159643","3.56250973577"
"SL2.50ch06:11009993-11014385","70","11009993","11014385","4392","1534.31159643","2.862521544"
"SL2.50ch06:11019623-11027377","246","11019623","11027377","7754","1534.31159643","5.05373225232"
"SL2.50ch06:11019663-11027361","246","11019663","11027361","7698","1534.31159643","5.01723379912"
"SL2.50ch06:11032885-11037142","148","11032885","11037142","4257","1534.31159643","2.77453420146"
"SL2.50ch06:11032913-11036993","147","11032913","11036993","4080","1534.31159643","2.65917301902"
"SL2.50ch06:11037846-11040202","54","11037846","11040202","2356","1534.31159643","1.53554206687"
"SL2.50ch06:11037848-11040368","58","11037848","11040368","2520","1534.31159643","1.6424303941"
"SL2.50ch06:11040975-11044012","72","11040975","11044012","3037","1534.31159643","1.97938932813"
"SL2.50ch06:11040994-11044052","72","11040994","11044052","3058","1534.31159643","1.99307624808"
"SL2.50ch06:11050075-11054389","143","11050075","11054389","4314","1534.31159643","2.81168441276"
"SL2.50ch06:11050100-11054316","143","11050100","11054316","4216","1534.31159643","2.74781211965"
"SL2.50ch06:11063385-11064584","12","11063385","11064584","1199","1534.31159643","0.781457953383"
"SL2.50ch06:11088653-11090639","37","11088653","11090639","1986","1534.31159643","1.29439157249"
"SL2.50ch06:11092108-11092483","5","11092108","11092483","375","1534.31159643","0.244409284836"
"SL2.50ch06:11101527-11102398","11","11101527","11102398","871","1534.31159643","0.567681298913"
"SL2.50ch06:11121982-11124438","56","11121982","11124438","2456","1534.31159643","1.60071787615"
"SL2.50ch06:11122106-11124460","55","11122106","11124460","2354","1534.31159643","1.53423855068"
"SL2.50ch06:11125035-11127101","49","11125035","11127101","2066","1534.31159643","1.34653221992"
"SL2.50ch06:11125555-11127032","29","11125555","11127032","1477","1534.31159643","0.962646703209"
"SL2.50ch06:11127599-11128855","20","11127599","11128855","1256","1534.31159643","0.818608164678"
"SL2.50ch06:11137678-11138080","4","11137678","11138080","402","1534.31159643","0.262006753345"
"SL2.50ch06:11142260-11147791","84","11142260","11147791","5531","1534.31159643","3.60487401181"
"SL2.50ch06:11142264-11149330","94","11142264","11149330","7066","1534.31159643","4.60532268441"
"SL2.50ch06:11150074-11152488","78","11150074","11152488","2414","1534.31159643","1.57334403625"
"SL2.50ch06:11186558-11187865","16","11186558","11187865","1307","1534.31159643","0.851847827416"
"SL2.50ch06:11194871-11195361","55","11194871","11195361","490","1534.31159643","0.319361465519"
"SL2.50ch06:11232084-11232643","6","11232084","11232643","559","1534.31159643","0.364332773929"
"SL2.50ch06:11242479-11243580","10","11242479","11243580","1101","1534.31159643","0.717585660279"
"SL2.50ch06:11249527-11251064","12","11249527","11251064","1537","1534.31159643","1.00175218878"
"SL2.50ch06:11251623-11252887","10","11251623","11252887","1264","1534.31159643","0.823822229422"
"SL2.50ch06:11281571-11283224","3","11281571","11283224","1653","1534.31159643","1.07735612756"
"SL2.50ch06:11284966-11285462","2","11284966","11285462","496","1534.31159643","0.323272014077"
"SL2.50ch06:11403082-11403457","1","11403082","11403457","375","1534.31159643","0.244409284836"
"SL2.50ch06:11534187-11534803","52","11534187","11534803","616","1534.31159643","0.401482985224"
"SL2.50ch06:11537547-11538159","15","11537547","11538159","612","1534.31159643","0.398875952853"
"SL2.50ch06:11555872-11556484","92","11555872","11556484","612","1534.31159643","0.398875952853"
"SL2.50ch06:11558107-11558719","45","11558107","11558719","612","1534.31159643","0.398875952853"
"SL2.50ch06:11564966-11565573","22","11564966","11565573","607","1534.31159643","0.395617162388"
"SL2.50ch06:11564973-11565846","25","11564973","11565846","873","1534.31159643","0.568984815099"
"SL2.50ch06:11566596-11567349","49","11566596","11567349","753","1534.31159643","0.490773843951"
"SL2.50ch06:11567625-11569107","19","11567625","11569107","1482","1534.31159643","0.965905493673"
"SL2.50ch06:11578294-11578894","15","11578294","11578894","600","1534.31159643","0.391054855738"
"SL2.50ch06:11578367-11578928","14","11578367","11578928","561","1534.31159643","0.365636290115"
"SL2.50ch06:11581359-11581971","17","11581359","11581971","612","1534.31159643","0.398875952853"
"SL2.50ch06:11586601-11587003","11","11586601","11587003","402","1534.31159643","0.262006753345"
"SL2.50ch06:11590094-11593520","55","11590094","11593520","3426","1534.31159643","2.23292322626"
"SL2.50ch06:11599666-11601367","33","11599666","11601367","1701","1534.31159643","1.10864051602"
"SL2.50ch06:11604823-11606584","29","11604823","11606584","1761","1534.31159643","1.14774600159"
"SL2.50ch06:11605426-11606268","17","11605426","11606268","842","1534.31159643","0.548780314219"
"SL2.50ch06:11607704-11609191","48","11607704","11609191","1487","1534.31159643","0.969164284138"
"SL2.50ch06:11607763-11609274","48","11607763","11609274","1511","1534.31159643","0.984806478367"
"SL2.50ch06:11610985-11612389","30","11610985","11612389","1404","1534.31159643","0.915068362427"
"SL2.50ch06:11611117-11612311","30","11611117","11612311","1194","1534.31159643","0.778199162919"
"SL2.50ch06:11615330-11616382","16","11615330","11616382","1052","1534.31159643","0.685649513728"
"SL2.50ch06:11620070-11620580","1","11620070","11620580","510","1534.31159643","0.332396627377"
"SL2.50ch06:11622767-11624432","56","11622767","11624432","1665","1534.31159643","1.08517722467"
"SL2.50ch06:11622839-11624605","56","11622839","11624605","1766","1534.31159643","1.15100479206"
"SL2.50ch06:11632062-11632714","36","11632062","11632714","652","1534.31159643","0.424946276569"
"SL2.50ch06:11632067-11632732","36","11632067","11632732","665","1534.31159643","0.433419131776"
"SL2.50ch06:11634541-11636861","99","11634541","11636861","2320","1534.31159643","1.51207877552"
"SL2.50ch06:11634582-11636856","99","11634582","11636856","2274","1534.31159643","1.48209790325"
"SL2.50ch06:12253792-12255393","47","12253792","12255393","1601","1534.31159643","1.04346470673"
"SL2.50ch06:12253946-12255434","46","12253946","12255434","1488","1534.31159643","0.969816042231"
"SL2.50ch06:12260836-12261238","10","12260836","12261238","402","1534.31159643","0.262006753345"
"SL2.50ch06:12260932-12261847","25","12260932","12261847","915","1534.31159643","0.596358655001"
"SL2.50ch06:12263990-12268177","181","12263990","12268177","4187","1534.31159643","2.72891113496"
"SL2.50ch06:12263995-12269859","195","12263995","12269859","5864","1534.31159643","3.82190945675"
"SL2.50ch06:12268952-12269454","6","12268952","12269454","502","1534.31159643","0.327182562634"
"SL2.50ch06:12271732-12272338","13","12271732","12272338","606","1534.31159643","0.394965404296"
"SL2.50ch06:12276344-12278623","22","12276344","12278623","2279","1534.31159643","1.48535669371"
"SL2.50ch06:12276374-12276776","10","12276374","12276776","402","1534.31159643","0.262006753345"
"SL2.50ch06:12283739-12284815","8","12283739","12284815","1076","1534.31159643","0.701291707957"
"SL2.50ch06:12296111-12296601","51","12296111","12296601","490","1534.31159643","0.319361465519"
"SL2.50ch06:12375345-12376977","22","12375345","12376977","1632","1534.31159643","1.06366920761"
"SL2.50ch06:12380252-12382058","14","12380252","12382058","1806","1534.31159643","1.17707511577"
"SL2.50ch06:12387063-12389014","19","12387063","12389014","1951","1534.31159643","1.27158003924"
"SL2.50ch06:12392143-12392763","21","12392143","12392763","620","1534.31159643","0.404090017596"
"SL2.50ch06:12402165-12402540","2","12402165","12402540","375","1534.31159643","0.244409284836"
"SL2.50ch06:12431451-12433857","21","12431451","12433857","2406","1534.31159643","1.56812997151"
"SL2.50ch06:12447289-12448805","18","12447289","12448805","1516","1534.31159643","0.988065268832"
"SL2.50ch06:12449493-12450841","6","12449493","12450841","1348","1534.31159643","0.878569909225"
"SL2.50ch06:12457559-12459263","23","12457559","12459263","1704","1534.31159643","1.1105957903"
"SL2.50ch06:12465109-12465990","4","12465109","12465990","881","1534.31159643","0.574198879842"
"SL2.50ch06:12477838-12478858","13","12477838","12478858","1020","1534.31159643","0.664793254755"
"SL2.50ch06:12482968-12484779","21","12482968","12484779","1811","1534.31159643","1.18033390624"
"SL2.50ch06:12488303-12489856","12","12488303","12489856","1553","1534.31159643","1.01218031827"
"SL2.50ch06:12492685-12493828","2","12492685","12493828","1143","1534.31159643","0.744959500181"
"SL2.50ch06:12504601-12506605","23","12504601","12506605","2004","1534.31159643","1.30612321817"
"SL2.50ch06:12507326-12508268","8","12507326","12508268","942","1534.31159643","0.613956123509"
"SL2.50ch06:12533674-12534900","14","12533674","12534900","1226","1534.31159643","0.799055421892"
"SL2.50ch06:12562663-12564129","10","12562663","12564129","1466","1534.31159643","0.955477364187"
"SL2.50ch06:12579820-12580762","6","12579820","12580762","942","1534.31159643","0.613956123509"
"SL2.50ch06:12602997-12604244","7","12602997","12604244","1247","1534.31159643","0.812742341842"
"SL2.50ch06:12606000-12607139","14","12606000","12607139","1139","1534.31159643","0.74235246781"
"SL2.50ch06:12618856-12619563","3","12618856","12619563","707","1534.31159643","0.460792971678"
"SL2.50ch06:12621804-12623260","5","12621804","12623260","1456","1534.31159643","0.948959783258"
"SL2.50ch06:12642682-12643616","5","12642682","12643616","934","1534.31159643","0.608742058766"
"SL2.50ch06:12655595-12656931","15","12655595","12656931","1336","1534.31159643","0.87074881211"
"SL2.50ch06:12659346-12659814","7","12659346","12659814","468","1534.31159643","0.305022787476"
"SL2.50ch06:12667513-12670001","12","12667513","12670001","2488","1534.31159643","1.62157413513"
"SL2.50ch06:12673868-12675784","16","12673868","12675784","1916","1534.31159643","1.24876850599"
"SL2.50ch06:12691023-12692471","14","12691023","12692471","1448","1534.31159643","0.943745718515"
"SL2.50ch06:12715474-12716891","6","12715474","12716891","1417","1534.31159643","0.923541217635"
"SL2.50ch06:12741197-12743812","18","12741197","12743812","2615","1534.31159643","1.70434741293"
"SL2.50ch06:12754105-12754923","11","12754105","12754923","818","1534.31159643","0.53313811999"
"SL2.50ch06:12772546-12774247","17","12772546","12774247","1701","1534.31159643","1.10864051602"
"SL2.50ch06:12779180-12780745","37","12779180","12780745","1565","1534.31159643","1.02000141538"
"SL2.50ch06:12849408-12850272","31","12849408","12850272","864","1534.31159643","0.563118992263"
"SL2.50ch06:12849430-12850318","31","12849430","12850318","888","1534.31159643","0.578761186492"
"SL2.50ch06:12853054-12853456","2","12853054","12853456","402","1534.31159643","0.262006753345"
"SL2.50ch06:12880369-12882549","17","12880369","12882549","2180","1534.31159643","1.42083264252"
"SL2.50ch06:12904330-12905284","5","12904330","12905284","954","1534.31159643","0.621777220624"
"SL2.50ch06:12911795-12912848","7","12911795","12912848","1053","1534.31159643","0.68630127182"
"SL2.50ch06:12927539-12930895","26","12927539","12930895","3356","1534.31159643","2.18730015976"
"SL2.50ch06:12935094-12935563","4","12935094","12935563","469","1534.31159643","0.305674545569"
"SL2.50ch06:12944847-12945380","2","12944847","12945380","533","1534.31159643","0.347387063514"
"SL2.50ch06:12978564-12978939","3","12978564","12978939","375","1534.31159643","0.244409284836"
"SL2.50ch06:12987225-12987600","1","12987225","12987600","375","1534.31159643","0.244409284836"
"SL2.50ch06:12993501-12994303","3","12993501","12994303","802","1534.31159643","0.522709990503"
"SL2.50ch06:13025796-13026986","7","13025796","13026986","1190","1534.31159643","0.775592130547"
"SL2.50ch06:13027702-13029858","22","13027702","13029858","2156","1534.31159643","1.40519044829"
"SL2.50ch06:13035131-13036192","13","13035131","13036192","1061","1534.31159643","0.691515336564"
"SL2.50ch06:13037463-13040146","17","13037463","13040146","2683","1534.31159643","1.74866696324"
"SL2.50ch06:13042253-13043575","13","13042253","13043575","1322","1534.31159643","0.86162419881"
"SL2.50ch06:13045620-13046727","5","13045620","13046727","1107","1534.31159643","0.721496208837"
"SL2.50ch06:13422386-13423254","224","13422386","13423254","868","1534.31159643","0.565726024634"
"SL2.50ch06:13424246-13425133","45","13424246","13425133","887","1534.31159643","0.5781094284"
"SL2.50ch06:13424254-13425155","45","13424254","13425155","901","1534.31159643","0.5872340417"
"SL2.50ch06:15863785-15864253","8","15863785","15864253","468","1534.31159643","0.305022787476"
"SL2.50ch06:16299554-16300320","8","16299554","16300320","766","1534.31159643","0.499246699159"
"SL2.50ch06:19442474-19442849","6","19442474","19442849","375","1534.31159643","0.244409284836"
"SL2.50ch06:19446373-19446886","5","19446373","19446886","513","1534.31159643","0.334351901656"
"SL2.50ch06:19472302-19473254","2","19472302","19473254","952","1534.31159643","0.620473704438"
"SL2.50ch06:19676262-19680566","21","19676262","19680566","4304","1534.31159643","2.80516683183"
"SL2.50ch06:19877103-19877664","2","19877103","19877664","561","1534.31159643","0.365636290115"
"SL2.50ch06:19933156-19934187","6","19933156","19934187","1031","1534.31159643","0.671962593777"
"SL2.50ch06:20126876-20127614","296","20126876","20127614","738","1534.31159643","0.480997472558"
"SL2.50ch06:20128274-20129320","411","20128274","20129320","1046","1534.31159643","0.68173896517"
"SL2.50ch06:20128282-20130263","1093","20128282","20130263","1981","1534.31159643","1.29113278203"
"SL2.50ch06:20129779-20130247","680","20129779","20130247","468","1534.31159643","0.305022787476"
"SL2.50ch06:20515044-20515446","13","20515044","20515446","402","1534.31159643","0.262006753345"
"SL2.50ch06:20964815-20965283","1","20964815","20965283","468","1534.31159643","0.305022787476"
"SL2.50ch06:21340983-21341385","59","21340983","21341385","402","1534.31159643","0.262006753345"
"SL2.50ch06:21340983-21341547","59","21340983","21341547","564","1534.31159643","0.367591564394"
"SL2.50ch06:21522154-21523200","14","21522154","21523200","1046","1534.31159643","0.68173896517"
"SL2.50ch06:21771348-21772213","22","21771348","21772213","865","1534.31159643","0.563770750356"
"SL2.50ch06:21771458-21772091","21","21771458","21772091","633","1534.31159643","0.412562872804"
"SL2.50ch06:21888593-21889067","4","21888593","21889067","474","1534.31159643","0.308933336033"
"SL2.50ch06:22013353-22014090","9","22013353","22014090","737","1534.31159643","0.480345714465"
"SL2.50ch06:22674068-22674566","19","22674068","22674566","498","1534.31159643","0.324575530263"
"SL2.50ch06:24168328-24168968","38","24168328","24168968","640","1534.31159643","0.417125179454"
"SL2.50ch06:24292005-24292708","6","24292005","24292708","703","1534.31159643","0.458185939307"
"SL2.50ch06:24536090-24536684","34","24536090","24536684","594","1534.31159643","0.387144307181"
"SL2.50ch06:2523184-2523674","37","2523184","2523674","490","1534.31159643","0.319361465519"
"SL2.50ch06:26056380-26056852","0","26056380","26056852","472","1534.31159643","0.307629819847"
"SL2.50ch06:26505820-26506408","0","26505820","26506408","588","1534.31159643","0.383233758623"
"SL2.50ch06:27182233-27182750","32","27182233","27182750","517","1534.31159643","0.336958934028"
"SL2.50ch06:27219236-27219611","4","27219236","27219611","375","1534.31159643","0.244409284836"
"SL2.50ch06:27246387-27246762","4","27246387","27246762","375","1534.31159643","0.244409284836"
"SL2.50ch06:27367795-27368170","2","27367795","27368170","375","1534.31159643","0.244409284836"
"SL2.50ch06:27436796-27437198","4","27436796","27437198","402","1534.31159643","0.262006753345"
"SL2.50ch06:27475556-27478013","25","27475556","27478013","2457","1534.31159643","1.60136963425"
"SL2.50ch06:29196945-29199345","15","29196945","29199345","2400","1534.31159643","1.56421942295"
"SL2.50ch06:29609666-29610630","11","29609666","29610630","964","1534.31159643","0.628294801553"
"SL2.50ch06:30951127-30951502","2","30951127","30951502","375","1534.31159643","0.244409284836"
"SL2.50ch06:31135950-31136539","4","31135950","31136539","589","1534.31159643","0.383885516716"
"SL2.50ch06:31136046-31136550","4","31136046","31136550","504","1534.31159643","0.32848607882"
"SL2.50ch06:32398471-32399126","4","32398471","32399126","655","1534.31159643","0.426901550847"
"SL2.50ch06:32472746-32473580","4","32472746","32473580","834","1534.31159643","0.543566249476"
"SL2.50ch06:3332759-3333441","1","3332759","3333441","682","1534.31159643","0.444499019356"
"SL2.50ch06:33858415-33859055","20","33858415","33859055","640","1534.31159643","0.417125179454"
"SL2.50ch06:33858481-33858856","16","33858481","33858856","375","1534.31159643","0.244409284836"
"SL2.50ch06:3414131-3415346","17","3414131","3415346","1215","1534.31159643","0.79188608287"
"SL2.50ch06:3416275-3416978","10","3416275","3416978","703","1534.31159643","0.458185939307"
"SL2.50ch06:34189577-34189952","3","34189577","34189952","375","1534.31159643","0.244409284836"
"SL2.50ch06:3440582-3441174","4","3440582","3441174","592","1534.31159643","0.385840790995"
"SL2.50ch06:3447211-3449683","23","3447211","3449683","2472","1534.31159643","1.61114600564"
"SL2.50ch06:35232373-35232979","5","35232373","35232979","606","1534.31159643","0.394965404296"
"SL2.50ch06:35232454-35233130","6","35232454","35233130","676","1534.31159643","0.440588470798"
"SL2.50ch06:35841331-35842181","7","35841331","35842181","850","1534.31159643","0.553994378962"
"SL2.50ch06:35848126-35848934","3","35848126","35848934","808","1534.31159643","0.526620539061"
"SL2.50ch06:36593466-36594178","113","36593466","36594178","712","1534.31159643","0.464051762143"
"SL2.50ch06:36593593-36594154","113","36593593","36594154","561","1534.31159643","0.365636290115"
"SL2.50ch06:38692646-38693048","7","38692646","38693048","402","1534.31159643","0.262006753345"
"SL2.50ch06:3923921-3924746","2","3923921","3924746","825","1534.31159643","0.53770042664"
"SL2.50ch06:39340459-39340949","20","39340459","39340949","490","1534.31159643","0.319361465519"
"SL2.50ch06:39340474-39340972","20","39340474","39340972","498","1534.31159643","0.324575530263"
"SL2.50ch06:40138792-40139290","33","40138792","40139290","498","1534.31159643","0.324575530263"
"SL2.50ch06:40138835-40139354","33","40138835","40139354","519","1534.31159643","0.338262450213"
"SL2.50ch06:40454177-40455330","9","40454177","40455330","1153","1534.31159643","0.75147708111"
"SL2.50ch06:4241505-4241907","6","4241505","4241907","402","1534.31159643","0.262006753345"
"SL2.50ch06:42662776-42663530","152","42662776","42663530","754","1534.31159643","0.491425602044"
"SL2.50ch06:42662920-42663448","152","42662920","42663448","528","1534.31159643","0.34412827305"
"SL2.50ch06:4357240-4357783","63","4357240","4357783","543","1534.31159643","0.353904644443"
"SL2.50ch06:44550669-44551657","4","44550669","44551657","988","1534.31159643","0.643936995782"
"SL2.50ch06:44655007-44655497","11","44655007","44655497","490","1534.31159643","0.319361465519"
"SL2.50ch06:44744098-44744642","171","44744098","44744642","544","1534.31159643","0.354556402536"
"SL2.50ch06:44744152-44744620","171","44744152","44744620","468","1534.31159643","0.305022787476"
"SL2.50ch06:46138783-46140500","55","46138783","46140500","1717","1534.31159643","1.1190686455"
"SL2.50ch06:46139900-46140419","41","46139900","46140419","519","1534.31159643","0.338262450213"
"SL2.50ch06:46145260-46148713","537","46145260","46148713","3453","1534.31159643","2.25052069477"
"SL2.50ch06:46145263-46148659","537","46145263","46148659","3396","1534.31159643","2.21337048348"
"SL2.50ch06:47239582-47239984","10","47239582","47239984","402","1534.31159643","0.262006753345"
"SL2.50ch06:47293410-47294104","43","47293410","47294104","694","1534.31159643","0.45232011647"
"SL2.50ch06:47293568-47294058","43","47293568","47294058","490","1534.31159643","0.319361465519"
"SL2.50ch06:49737655-49738607","8","49737655","49738607","952","1534.31159643","0.620473704438"
"SL2.50ch06:5020160-5021283","6","5020160","5021283","1123","1534.31159643","0.731924338323"
"SL2.50ch06:5039987-5040769","2","5039987","5040769","782","1534.31159643","0.509674828645"
"SL2.50ch06:5041583-5042558","12","5041583","5042558","975","1534.31159643","0.635464140574"
"SL2.50ch06:5043143-5045374","22","5043143","5045374","2231","1534.31159643","1.45407230525"
"SL2.50ch06:5047687-5048863","9","5047687","5048863","1176","1534.31159643","0.766467517247"
"SL2.50ch06:5059484-5060242","13","5059484","5060242","758","1534.31159643","0.494032634416"
"SL2.50ch06:5075343-5076357","7","5075343","5076357","1014","1534.31159643","0.660882706197"
"SL2.50ch06:5118428-5118960","5","5118428","5118960","532","1534.31159643","0.346735305421"
"SL2.50ch06:5261752-5262254","7","5261752","5262254","502","1534.31159643","0.327182562634"
"SL2.50ch06:5300730-5301297","9","5300730","5301297","567","1534.31159643","0.369546838673"
"SL2.50ch06:5300818-5301220","9","5300818","5301220","402","1534.31159643","0.262006753345"
"SL2.50ch06:5452603-5453175","0","5452603","5453175","572","1534.31159643","0.372805629137"
"SL2.50ch06:5534297-5535698","7","5534297","5535698","1401","1534.31159643","0.913113088149"
"SL2.50ch06:5535212-5535614","6","5535212","5535614","402","1534.31159643","0.262006753345"
"SL2.50ch06:5745929-5747291","9","5745929","5747291","1362","1534.31159643","0.887694522526"
"SL2.50ch06:5771150-5772119","7","5771150","5772119","969","1534.31159643","0.631553592017"
"SL2.50ch06:5772988-5773457","2","5772988","5773457","469","1534.31159643","0.305674545569"
"SL2.50ch06:6317096-6317682","2","6317096","6317682","586","1534.31159643","0.381930242438"
"SL2.50ch06:6377893-6378409","1","6377893","6378409","516","1534.31159643","0.336307175935"
"SL2.50ch06:6389691-6390201","27","6389691","6390201","510","1534.31159643","0.332396627377"
"SL2.50ch06:7153407-7154126","0","7153407","7154126","719","1534.31159643","0.468614068793"
"SL2.50ch06:7235782-7236157","9","7235782","7236157","375","1534.31159643","0.244409284836"
"SL2.50ch06:7609794-7610284","11","7609794","7610284","490","1534.31159643","0.319361465519"
"SL2.50ch06:7753223-7754056","2","7753223","7754056","833","1534.31159643","0.542914491383"
"SL2.50ch06:8413666-8414041","0","8413666","8414041","375","1534.31159643","0.244409284836"
"SL2.50ch06:8559912-8561917","18","8559912","8561917","2005","1534.31159643","1.30677497626"
"SL2.50ch06:8595972-8597144","9","8595972","8597144","1172","1534.31159643","0.763860484875"
"SL2.50ch07:10330984-10331487","4","10330984","10331487","503","1534.31159643","0.327834320727"
"SL2.50ch07:10484574-10485384","35","10484574","10485384","810","1534.31159643","0.527924055246"
"SL2.50ch07:10484695-10485407","33","10484695","10485407","712","1534.31159643","0.464051762143"
"SL2.50ch07:10490115-10490850","81","10490115","10490850","735","1534.31159643","0.479042198279"
"SL2.50ch07:10490242-10490872","81","10490242","10490872","630","1534.31159643","0.410607598525"
"SL2.50ch07:11359676-11360051","3","11359676","11360051","375","1534.31159643","0.244409284836"
"SL2.50ch07:11631133-11631734","2","11631133","11631734","601","1534.31159643","0.391706613831"
"SL2.50ch07:11633188-11633660","5","11633188","11633660","472","1534.31159643","0.307629819847"
"SL2.50ch07:11852425-11856905","119","11852425","11856905","4480","1534.31159643","2.91987625618"
"SL2.50ch07:11854649-11856819","88","11854649","11856819","2170","1534.31159643","1.41431506159"
"SL2.50ch07:12791877-12792490","5","12791877","12792490","613","1534.31159643","0.399527710946"
"SL2.50ch07:12855807-12856325","10","12855807","12856325","518","1534.31159643","0.337610692121"
"SL2.50ch07:13215968-13216343","0","13215968","13216343","375","1534.31159643","0.244409284836"
"SL2.50ch07:13510775-13511856","3","13510775","13511856","1081","1534.31159643","0.704550498422"
"SL2.50ch07:13703611-13704084","3","13703611","13704084","473","1534.31159643","0.30828157794"
"SL2.50ch07:14478817-14479429","8","14478817","14479429","612","1534.31159643","0.398875952853"
"SL2.50ch07:14670431-14670952","1","14670431","14670952","521","1534.31159643","0.339565966399"
"SL2.50ch07:14879251-14880856","4","14879251","14880856","1605","1534.31159643","1.0460717391"
"SL2.50ch07:15207359-15207939","2","15207359","15207939","580","1534.31159643","0.37801969388"
"SL2.50ch07:15364684-15365534","0","15364684","15365534","850","1534.31159643","0.553994378962"
"SL2.50ch07:15509086-15509461","3","15509086","15509461","375","1534.31159643","0.244409284836"
"SL2.50ch07:16223192-16226558","20","16223192","16226558","3366","1534.31159643","2.19381774069"
"SL2.50ch07:16793730-16795427","9","16793730","16795427","1697","1534.31159643","1.10603348365"
"SL2.50ch07:17357581-17358076","2","17357581","17358076","495","1534.31159643","0.322620255984"
"SL2.50ch07:18155913-18156854","14","18155913","18156854","941","1534.31159643","0.613304365416"
"SL2.50ch07:18155996-18156486","10","18155996","18156486","490","1534.31159643","0.319361465519"
"SL2.50ch07:18257099-18259691","15","18257099","18259691","2592","1534.31159643","1.68935697679"
"SL2.50ch07:18723447-18723990","3","18723447","18723990","543","1534.31159643","0.353904644443"
"SL2.50ch07:19363002-19363653","5","19363002","19363653","651","1534.31159643","0.424294518476"
"SL2.50ch07:19794728-19795857","15","19794728","19795857","1129","1534.31159643","0.735834886881"
"SL2.50ch07:19803738-19805595","27","19803738","19805595","1857","1534.31159643","1.21031477851"
"SL2.50ch07:19807330-19812504","39","19807330","19812504","5174","1534.31159643","3.37219637265"
"SL2.50ch07:19831167-19835424","40","19831167","19835424","4257","1534.31159643","2.77453420146"
"SL2.50ch07:19838534-19839278","0","19838534","19839278","744","1534.31159643","0.484908021115"
"SL2.50ch07:19842461-19843414","13","19842461","19843414","953","1534.31159643","0.621125462531"
"SL2.50ch07:19847505-19849329","15","19847505","19849329","1824","1534.31159643","1.18880676144"
"SL2.50ch07:19862863-19866371","36","19862863","19866371","3508","1534.31159643","2.28636738988"
"SL2.50ch07:19871390-19873872","24","19871390","19873872","2482","1534.31159643","1.61766358657"
"SL2.50ch07:19880668-19881287","23","19880668","19881287","619","1534.31159643","0.403438259503"
"SL2.50ch07:19882133-19882812","19","19882133","19882812","679","1534.31159643","0.442543745077"
"SL2.50ch07:19882213-19882882","19","19882213","19882882","669","1534.31159643","0.436026164148"
"SL2.50ch07:19886196-19887691","14","19886196","19887691","1495","1534.31159643","0.974378348881"
"SL2.50ch07:19950395-19950978","7","19950395","19950978","583","1534.31159643","0.379974968159"
"SL2.50ch07:19983938-19984833","3","19983938","19984833","895","1534.31159643","0.583323493143"
"SL2.50ch07:20362429-20362966","5","20362429","20362966","537","1534.31159643","0.349994095886"
"SL2.50ch07:20482154-20482529","4","20482154","20482529","375","1534.31159643","0.244409284836"
"SL2.50ch07:20862124-20862962","14","20862124","20862962","838","1534.31159643","0.546173281848"
"SL2.50ch07:21109522-21110259","3","21109522","21110259","737","1534.31159643","0.480345714465"
"SL2.50ch07:21158805-21159733","14","21158805","21159733","928","1534.31159643","0.604831510208"
"SL2.50ch07:22267574-22267949","3","22267574","22267949","375","1534.31159643","0.244409284836"
"SL2.50ch07:23178828-23179371","5","23178828","23179371","543","1534.31159643","0.353904644443"
"SL2.50ch07:23705203-23705721","6","23705203","23705721","518","1534.31159643","0.337610692121"
"SL2.50ch07:23731754-23732129","2","23731754","23732129","375","1534.31159643","0.244409284836"
"SL2.50ch07:24165265-24165640","1","24165265","24165640","375","1534.31159643","0.244409284836"
"SL2.50ch07:24197521-24197896","3","24197521","24197896","375","1534.31159643","0.244409284836"
"SL2.50ch07:24678668-24679043","6","24678668","24679043","375","1534.31159643","0.244409284836"
"SL2.50ch07:24747101-24747570","1","24747101","24747570","469","1534.31159643","0.305674545569"
"SL2.50ch07:25085594-25085969","1","25085594","25085969","375","1534.31159643","0.244409284836"
"SL2.50ch07:25270007-25270603","4","25270007","25270603","596","1534.31159643","0.388447823367"
"SL2.50ch07:25828749-25829260","3","25828749","25829260","511","1534.31159643","0.33304838547"
"SL2.50ch07:26467698-26468166","12","26467698","26468166","468","1534.31159643","0.305022787476"
"SL2.50ch07:27088118-27088667","2","27088118","27088667","549","1534.31159643","0.357815193"
"SL2.50ch07:27171286-27171661","3","27171286","27171661","375","1534.31159643","0.244409284836"
"SL2.50ch07:27291139-27291786","10","27291139","27291786","647","1534.31159643","0.421687486104"
"SL2.50ch07:27291165-27291868","10","27291165","27291868","703","1534.31159643","0.458185939307"
"SL2.50ch07:28302934-28303544","134","28302934","28303544","610","1534.31159643","0.397572436667"
"SL2.50ch07:28303049-28303517","133","28303049","28303517","468","1534.31159643","0.305022787476"
"SL2.50ch07:29209638-29210040","16","29209638","29210040","402","1534.31159643","0.262006753345"
"SL2.50ch07:29426734-29427203","8","29426734","29427203","469","1534.31159643","0.305674545569"
"SL2.50ch07:29887449-29887958","1","29887449","29887958","509","1534.31159643","0.331744869285"
"SL2.50ch07:29919954-29920437","1","29919954","29920437","483","1534.31159643","0.314799158869"
"SL2.50ch07:2999403-3000995","17","2999403","3000995","1592","1534.31159643","1.03759888389"
"SL2.50ch07:2999672-3000302","10","2999672","3000302","630","1534.31159643","0.410607598525"
"SL2.50ch07:30150602-30151092","49","30150602","30151092","490","1534.31159643","0.319361465519"
"SL2.50ch07:30175177-30175660","7","30175177","30175660","483","1534.31159643","0.314799158869"
"SL2.50ch07:30902000-30903467","30","30902000","30903467","1467","1534.31159643","0.95612912228"
"SL2.50ch07:30902001-30903455","30","30902001","30903455","1454","1534.31159643","0.947656267072"
"SL2.50ch07:30904019-30904523","1","30904019","30904523","504","1534.31159643","0.32848607882"
"SL2.50ch07:30904026-30904590","2","30904026","30904590","564","1534.31159643","0.367591564394"
"SL2.50ch07:30906020-30906631","20","30906020","30906631","611","1534.31159643","0.39822419476"
"SL2.50ch07:3184708-3185110","47","3184708","3185110","402","1534.31159643","0.262006753345"
"SL2.50ch07:32432796-32433583","84","32432796","32433583","787","1534.31159643","0.51293361911"
"SL2.50ch07:32432891-32433453","83","32432891","32433453","562","1534.31159643","0.366288048208"
"SL2.50ch07:3372-4110","125","3372","4110","738","1534.31159643","0.480997472558"
"SL2.50ch07:34209928-34210528","3","34209928","34210528","600","1534.31159643","0.391054855738"
"SL2.50ch07:34439127-34439673","4","34439127","34439673","546","1534.31159643","0.355859918722"
"SL2.50ch07:34595240-34595615","4","34595240","34595615","375","1534.31159643","0.244409284836"
"SL2.50ch07:34915326-34915920","7","34915326","34915920","594","1534.31159643","0.387144307181"
"SL2.50ch07:35058834-35059437","7","35058834","35059437","603","1534.31159643","0.393010130017"
"SL2.50ch07:36068592-36069317","7","36068592","36069317","725","1534.31159643","0.47252461735"
"SL2.50ch07:37273451-37273949","1","37273451","37273949","498","1534.31159643","0.324575530263"
"SL2.50ch07:3774743-3776382","21","3774743","3776382","1639","1534.31159643","1.06823151426"
"SL2.50ch07:38058364-38058833","1","38058364","38058833","469","1534.31159643","0.305674545569"
"SL2.50ch07:38160847-38161662","1","38160847","38161662","815","1534.31159643","0.531182845711"
"SL2.50ch07:38212908-38213396","8","38212908","38213396","488","1534.31159643","0.318057949334"
"SL2.50ch07:4007281-4008058","12","4007281","4008058","777","1534.31159643","0.506416038181"
"SL2.50ch07:4007379-4008043","12","4007379","4008043","664","1534.31159643","0.432767373684"
"SL2.50ch07:40130551-40130926","7","40130551","40130926","375","1534.31159643","0.244409284836"
"SL2.50ch07:40168529-40169090","3","40168529","40169090","561","1534.31159643","0.365636290115"
"SL2.50ch07:40295479-40296056","3","40295479","40296056","577","1534.31159643","0.376064419601"
"SL2.50ch07:41249675-41250932","6","41249675","41250932","1257","1534.31159643","0.819259922771"
"SL2.50ch07:41360345-41360720","1","41360345","41360720","375","1534.31159643","0.244409284836"
"SL2.50ch07:44009853-44010353","3","44009853","44010353","500","1534.31159643","0.325879046448"
"SL2.50ch07:44373038-44373861","2","44373038","44373861","823","1534.31159643","0.536396910454"
"SL2.50ch07:44663230-44663705","1","44663230","44663705","475","1534.31159643","0.309585094126"
"SL2.50ch07:45274098-45275110","8","45274098","45275110","1012","1534.31159643","0.659579190012"
"SL2.50ch07:45482513-45482888","1","45482513","45482888","375","1534.31159643","0.244409284836"
"SL2.50ch07:46279404-46280757","9","46279404","46280757","1353","1534.31159643","0.881828699689"
"SL2.50ch07:4794178-4794650","2","4794178","4794650","472","1534.31159643","0.307629819847"
"SL2.50ch07:48383329-48383933","4","48383329","48383933","604","1534.31159643","0.39366188811"
"SL2.50ch07:48899122-48899639","2","48899122","48899639","517","1534.31159643","0.336958934028"
"SL2.50ch07:49605353-49605728","1","49605353","49605728","375","1534.31159643","0.244409284836"
"SL2.50ch07:50218720-50219647","16","50218720","50219647","927","1534.31159643","0.604179752115"
"SL2.50ch07:50218764-50219166","14","50218764","50219166","402","1534.31159643","0.262006753345"
"SL2.50ch07:50387754-50388861","12","50387754","50388861","1107","1534.31159643","0.721496208837"
"SL2.50ch07:50623523-50623994","12","50623523","50623994","471","1534.31159643","0.306978061754"
"SL2.50ch07:51235860-51236437","37","51235860","51236437","577","1534.31159643","0.376064419601"
"SL2.50ch07:52229731-52230258","4","52229731","52230258","527","1534.31159643","0.343476514957"
"SL2.50ch07:52294483-52295151","2","52294483","52295151","668","1534.31159643","0.435374406055"
"SL2.50ch07:52522616-52524449","7","52522616","52524449","1833","1534.31159643","1.19467258428"
"SL2.50ch07:53599442-53600287","10","53599442","53600287","845","1534.31159643","0.550735588498"
"SL2.50ch07:53965457-53966247","3","53965457","53966247","790","1534.31159643","0.514888893389"
"SL2.50ch07:53975469-53975871","17","53975469","53975871","402","1534.31159643","0.262006753345"
"SL2.50ch07:5413089-5413754","2","5413089","5413754","665","1534.31159643","0.433419131776"
"SL2.50ch07:5413298-5414032","2","5413298","5414032","734","1534.31159643","0.478390440186"
"SL2.50ch07:5449682-5452325","26","5449682","5452325","2643","1534.31159643","1.72259663953"
"SL2.50ch07:54736705-54737343","26","54736705","54737343","638","1534.31159643","0.415821663268"
"SL2.50ch07:54736841-54737354","26","54736841","54737354","513","1534.31159643","0.334351901656"
"SL2.50ch07:55282802-55283204","17","55282802","55283204","402","1534.31159643","0.262006753345"
"SL2.50ch07:55623508-55624399","10","55623508","55624399","891","1534.31159643","0.580716460771"
"SL2.50ch07:55632576-55633447","10","55632576","55633447","871","1534.31159643","0.567681298913"
"SL2.50ch07:55632801-55633422","10","55632801","55633422","621","1534.31159643","0.404741775689"
"SL2.50ch07:5584399-5585220","8","5584399","5585220","821","1534.31159643","0.535093394268"
"SL2.50ch07:5586890-5587265","2","5586890","5587265","375","1534.31159643","0.244409284836"
"SL2.50ch07:56754891-56755463","7","56754891","56755463","572","1534.31159643","0.372805629137"
"SL2.50ch07:56757127-56757897","10","56757127","56757897","770","1534.31159643","0.501853731531"
"SL2.50ch07:57398872-57400681","15","57398872","57400681","1809","1534.31159643","1.17903039005"
"SL2.50ch07:57403887-57404531","3","57403887","57404531","644","1534.31159643","0.419732211826"
"SL2.50ch07:57406693-57407290","0","57406693","57407290","597","1534.31159643","0.389099581459"
"SL2.50ch07:57409285-57410276","3","57409285","57410276","991","1534.31159643","0.645892270061"
"SL2.50ch07:58301086-58301688","12","58301086","58301688","602","1534.31159643","0.392358371924"
"SL2.50ch07:58802352-58805143","37","58802352","58805143","2791","1534.31159643","1.81905683728"
"SL2.50ch07:59388843-59389425","19","59388843","59389425","582","1534.31159643","0.379323210066"
"SL2.50ch07:59388935-59389477","19","59388935","59389477","542","1534.31159643","0.35325288635"
"SL2.50ch07:59506934-59507820","197","59506934","59507820","886","1534.31159643","0.577457670307"
"SL2.50ch07:59506991-59507646","196","59506991","59507646","655","1534.31159643","0.426901550847"
"SL2.50ch07:61301593-61302247","13","61301593","61302247","654","1534.31159643","0.426249792755"
"SL2.50ch07:61301649-61302327","13","61301649","61302327","678","1534.31159643","0.441891986984"
"SL2.50ch07:61414731-61415106","6","61414731","61415106","375","1534.31159643","0.244409284836"
"SL2.50ch07:63553939-63554314","8","63553939","63554314","375","1534.31159643","0.244409284836"
"SL2.50ch07:63554982-63555460","1","63554982","63555460","478","1534.31159643","0.311540368405"
"SL2.50ch07:64790120-64790495","3","64790120","64790495","375","1534.31159643","0.244409284836"
"SL2.50ch07:65397005-65397380","2","65397005","65397380","375","1534.31159643","0.244409284836"
"SL2.50ch07:65784663-65785153","9","65784663","65785153","490","1534.31159643","0.319361465519"
"SL2.50ch07:7832025-7832533","15","7832025","7832533","508","1534.31159643","0.331093111192"
"SL2.50ch07:8195959-8196334","4","8195959","8196334","375","1534.31159643","0.244409284836"
"SL2.50ch07:8824605-8825074","17","8824605","8825074","469","1534.31159643","0.305674545569"
"SL2.50ch07:90612-91248","2","90612","91248","636","1534.31159643","0.414518147082"
"SL2.50ch07:9403987-9405063","7","9403987","9405063","1076","1534.31159643","0.701291707957"
"SL2.50ch08:10002631-10004774","49","10002631","10004774","2143","1534.31159643","1.39671759308"
"SL2.50ch08:10002767-10004772","49","10002767","10004772","2005","1534.31159643","1.30677497626"
"SL2.50ch08:10005552-10006837","32","10005552","10006837","1285","1534.31159643","0.837509149372"
"SL2.50ch08:10005569-10006879","32","10005569","10006879","1310","1534.31159643","0.853803101695"
"SL2.50ch08:10011819-10013442","44","10011819","10013442","1623","1534.31159643","1.05780338477"
"SL2.50ch08:10011842-10013449","44","10011842","10013449","1607","1534.31159643","1.04737525529"
"SL2.50ch08:10015683-10017918","67","10015683","10017918","2235","1534.31159643","1.45667933762"
"SL2.50ch08:10015792-10017881","66","10015792","10017881","2089","1534.31159643","1.36152265606"
"SL2.50ch08:10024206-10028238","166","10024206","10028238","4032","1534.31159643","2.62788863056"
"SL2.50ch08:10024259-10028312","165","10024259","10028312","4053","1534.31159643","2.64157555051"
"SL2.50ch08:10030614-10031938","30","10030614","10031938","1324","1534.31159643","0.862927714995"
"SL2.50ch08:10030648-10031833","30","10030648","10031833","1185","1534.31159643","0.772333340083"
"SL2.50ch08:10032530-10036482","102","10032530","10036482","3952","1534.31159643","2.57574798313"
"SL2.50ch08:10032595-10036544","102","10032595","10036544","3949","1534.31159643","2.57379270885"
"SL2.50ch08:10429512-10430017","13","10429512","10430017","505","1534.31159643","0.329137836913"
"SL2.50ch08:10434313-10437377","52","10434313","10437377","3064","1534.31159643","1.99698679664"
"SL2.50ch08:10445852-10446438","4","10445852","10446438","586","1534.31159643","0.381930242438"
"SL2.50ch08:10563767-10564351","7","10563767","10564351","584","1534.31159643","0.380626726252"
"SL2.50ch08:10821212-10821897","12","10821212","10821897","685","1534.31159643","0.446454293634"
"SL2.50ch08:10888393-10890109","20","10888393","10890109","1716","1534.31159643","1.11841688741"
"SL2.50ch08:11082829-11083405","15","11082829","11083405","576","1534.31159643","0.375412661509"
"SL2.50ch08:11082930-11083400","15","11082930","11083400","470","1534.31159643","0.306326303662"
"SL2.50ch08:11130632-11131379","38","11130632","11131379","747","1534.31159643","0.486863295394"
"SL2.50ch08:11137848-11141424","522","11137848","11141424","3576","1534.31159643","2.3306869402"
"SL2.50ch08:11138082-11141260","521","11138082","11141260","3178","1534.31159643","2.07128721923"
"SL2.50ch08:11147837-11149023","68","11147837","11149023","1186","1534.31159643","0.772985098176"
"SL2.50ch08:11147964-11148936","66","11147964","11148936","972","1534.31159643","0.633508866296"
"SL2.50ch08:11732669-11733512","21","11732669","11733512","843","1534.31159643","0.549432072312"
"SL2.50ch08:11732728-11733548","21","11732728","11733548","820","1534.31159643","0.534441636175"
"SL2.50ch08:11880892-11881676","12","11880892","11881676","784","1534.31159643","0.510978344831"
"SL2.50ch08:12271948-12272456","1","12271948","12272456","508","1534.31159643","0.331093111192"
"SL2.50ch08:13446739-13447472","0","13446739","13447472","733","1534.31159643","0.477738682093"
"SL2.50ch08:14138174-14139779","8","14138174","14139779","1605","1534.31159643","1.0460717391"
"SL2.50ch08:14423080-14423455","0","14423080","14423455","375","1534.31159643","0.244409284836"
"SL2.50ch08:14782409-14783639","8","14782409","14783639","1230","1534.31159643","0.801662454263"
"SL2.50ch08:14849153-14849922","14","14849153","14849922","769","1534.31159643","0.501201973438"
"SL2.50ch08:14906344-14906719","2","14906344","14906719","375","1534.31159643","0.244409284836"
"SL2.50ch08:14929397-14930627","11","14929397","14930627","1230","1534.31159643","0.801662454263"
"SL2.50ch08:14939719-14940094","2","14939719","14940094","375","1534.31159643","0.244409284836"
"SL2.50ch08:14999361-15000850","39","14999361","15000850","1489","1534.31159643","0.970467800323"
"SL2.50ch08:14999814-15000611","39","14999814","15000611","797","1534.31159643","0.519451200039"
"SL2.50ch08:15012585-15015861","19","15012585","15015861","3276","1534.31159643","2.13515951233"
"SL2.50ch08:15167719-15168629","27","15167719","15168629","910","1534.31159643","0.593099864536"
"SL2.50ch08:15167816-15168423","26","15167816","15168423","607","1534.31159643","0.395617162388"
"SL2.50ch08:15513770-15514768","16","15513770","15514768","998","1534.31159643","0.650454576711"
"SL2.50ch08:15513785-15514624","15","15513785","15514624","839","1534.31159643","0.54682503994"
"SL2.50ch08:15515434-15516356","9","15515434","15516356","922","1534.31159643","0.600920961651"
"SL2.50ch08:15515493-15516330","9","15515493","15516330","837","1534.31159643","0.545521523755"
"SL2.50ch08:15517553-15518021","6","15517553","15518021","468","1534.31159643","0.305022787476"
"SL2.50ch08:15547353-15547924","20","15547353","15547924","571","1534.31159643","0.372153871044"
"SL2.50ch08:15555027-15555495","8","15555027","15555495","468","1534.31159643","0.305022787476"
"SL2.50ch08:15556231-15557378","18","15556231","15557378","1147","1534.31159643","0.747566532553"
"SL2.50ch08:15556257-15557433","18","15556257","15557433","1176","1534.31159643","0.766467517247"
"SL2.50ch08:15570741-15571524","14","15570741","15571524","783","1534.31159643","0.510326586738"
"SL2.50ch08:15612648-15613407","8","15612648","15613407","759","1534.31159643","0.494684392509"
"SL2.50ch08:15838909-15839311","9","15838909","15839311","402","1534.31159643","0.262006753345"
"SL2.50ch08:15840182-15840584","17","15840182","15840584","402","1534.31159643","0.262006753345"
"SL2.50ch08:15840200-15840698","17","15840200","15840698","498","1534.31159643","0.324575530263"
"SL2.50ch08:15842238-15842811","10","15842238","15842811","573","1534.31159643","0.37345738723"
"SL2.50ch08:15842263-15842784","10","15842263","15842784","521","1534.31159643","0.339565966399"
"SL2.50ch08:15843673-15844141","7","15843673","15844141","468","1534.31159643","0.305022787476"
"SL2.50ch08:15843676-15844078","6","15843676","15844078","402","1534.31159643","0.262006753345"
"SL2.50ch08:15847478-15847880","10","15847478","15847880","402","1534.31159643","0.262006753345"
"SL2.50ch08:16026314-16027981","22","16026314","16027981","1667","1534.31159643","1.08648074086"
"SL2.50ch08:16027161-16027932","18","16027161","16027932","771","1534.31159643","0.502505489623"
"SL2.50ch08:16031684-16032194","20","16031684","16032194","510","1534.31159643","0.332396627377"
"SL2.50ch08:16184608-16185513","1","16184608","16185513","905","1534.31159643","0.589841074072"
"SL2.50ch08:16330791-16331166","1","16330791","16331166","375","1534.31159643","0.244409284836"
"SL2.50ch08:18438018-18438486","6","18438018","18438486","468","1534.31159643","0.305022787476"
"SL2.50ch08:18882883-18883258","3","18882883","18883258","375","1534.31159643","0.244409284836"
"SL2.50ch08:20831258-20831944","4","20831258","20831944","686","1534.31159643","0.447106051727"
"SL2.50ch08:21993489-21994553","16","21993489","21994553","1064","1534.31159643","0.693470610842"
"SL2.50ch08:22048713-22049654","2","22048713","22049654","941","1534.31159643","0.613304365416"
"SL2.50ch08:22057628-22059113","10","22057628","22059113","1485","1534.31159643","0.967860767952"
"SL2.50ch08:22106435-22107140","1","22106435","22107140","705","1534.31159643","0.459489455492"
"SL2.50ch08:22110937-22112032","4","22110937","22112032","1095","1534.31159643","0.713675111722"
"SL2.50ch08:22754166-22754762","2","22754166","22754762","596","1534.31159643","0.388447823367"
"SL2.50ch08:23194922-23195394","0","23194922","23195394","472","1534.31159643","0.307629819847"
"SL2.50ch08:24008165-24008906","2","24008165","24008906","741","1534.31159643","0.482952746837"
"SL2.50ch08:25319895-25320574","17","25319895","25320574","679","1534.31159643","0.442543745077"
"SL2.50ch08:25335907-25336309","9","25335907","25336309","402","1534.31159643","0.262006753345"
"SL2.50ch08:25881646-25882394","5","25881646","25882394","748","1534.31159643","0.487515053487"
"SL2.50ch08:26152852-26153326","5","26152852","26153326","474","1534.31159643","0.308933336033"
"SL2.50ch08:2620366-2620768","14","2620366","2620768","402","1534.31159643","0.262006753345"
"SL2.50ch08:2620392-2620767","14","2620392","2620767","375","1534.31159643","0.244409284836"
"SL2.50ch08:26693003-26693746","13","26693003","26693746","743","1534.31159643","0.484256263022"
"SL2.50ch08:26922990-26923365","0","26922990","26923365","375","1534.31159643","0.244409284836"
"SL2.50ch08:27633040-27633813","241","27633040","27633813","773","1534.31159643","0.503809005809"
"SL2.50ch08:27633124-27633828","241","27633124","27633828","704","1534.31159643","0.458837697399"
"SL2.50ch08:28973967-28974989","5","28973967","28974989","1022","1534.31159643","0.666096770941"
"SL2.50ch08:29032708-29033083","3","29032708","29033083","375","1534.31159643","0.244409284836"
"SL2.50ch08:29725656-29726031","3","29725656","29726031","375","1534.31159643","0.244409284836"
"SL2.50ch08:29731350-29731725","0","29731350","29731725","375","1534.31159643","0.244409284836"
"SL2.50ch08:29735774-29736548","6","29735774","29736548","774","1534.31159643","0.504460763902"
"SL2.50ch08:29769736-29770224","2","29769736","29770224","488","1534.31159643","0.318057949334"
"SL2.50ch08:30721854-30722229","5","30721854","30722229","375","1534.31159643","0.244409284836"
"SL2.50ch08:31765783-31766601","161","31765783","31766601","818","1534.31159643","0.53313811999"
"SL2.50ch08:32308823-32309711","5","32308823","32309711","888","1534.31159643","0.578761186492"
"SL2.50ch08:32821717-32822280","17","32821717","32822280","563","1534.31159643","0.366939806301"
"SL2.50ch08:32821729-32822351","17","32821729","32822351","622","1534.31159643","0.405393533782"
"SL2.50ch08:33532582-33533633","2","33532582","33533633","1051","1534.31159643","0.684997755635"
"SL2.50ch08:33539540-33540141","5","33539540","33540141","601","1534.31159643","0.391706613831"
"SL2.50ch08:33559933-33561952","13","33559933","33561952","2019","1534.31159643","1.31589958956"
"SL2.50ch08:33791999-33792945","5","33791999","33792945","946","1534.31159643","0.61656315588"
"SL2.50ch08:33847277-33847952","10","33847277","33847952","675","1534.31159643","0.439936712705"
"SL2.50ch08:33973640-33974015","2","33973640","33974015","375","1534.31159643","0.244409284836"
"SL2.50ch08:34038094-34038610","6","34038094","34038610","516","1534.31159643","0.336307175935"
"SL2.50ch08:34452829-34453204","0","34452829","34453204","375","1534.31159643","0.244409284836"
"SL2.50ch08:36254055-36254523","2","36254055","36254523","468","1534.31159643","0.305022787476"
"SL2.50ch08:36327095-36327819","11","36327095","36327819","724","1534.31159643","0.471872859257"
"SL2.50ch08:37202792-37203633","15","37202792","37203633","841","1534.31159643","0.548128556126"
"SL2.50ch08:37202826-37204271","16","37202826","37204271","1445","1534.31159643","0.941790444236"
"SL2.50ch08:37207199-37208138","4","37207199","37208138","939","1534.31159643","0.61200084923"
"SL2.50ch08:37401945-37402449","51","37401945","37402449","504","1534.31159643","0.32848607882"
"SL2.50ch08:38677612-38678102","64","38677612","38678102","490","1534.31159643","0.319361465519"
"SL2.50ch08:39144765-39154049","1117","39144765","39154049","9284","1534.31159643","6.05092213445"
"SL2.50ch08:39144970-39146391","103","39144970","39146391","1421","1534.31159643","0.926148250006"
"SL2.50ch08:39146800-39147758","136","39146800","39147758","958","1534.31159643","0.624384252995"
"SL2.50ch08:39148615-39150867","612","39148615","39150867","2252","1534.31159643","1.4677592252"
"SL2.50ch08:39151290-39153967","244","39151290","39153967","2677","1534.31159643","1.74475641468"
"SL2.50ch08:39461737-39462112","3","39461737","39462112","375","1534.31159643","0.244409284836"
"SL2.50ch08:40119573-40120194","4","40119573","40120194","621","1534.31159643","0.404741775689"
"SL2.50ch08:40507516-40507891","1","40507516","40507891","375","1534.31159643","0.244409284836"
"SL2.50ch08:40624439-40624918","4","40624439","40624918","479","1534.31159643","0.312192126498"
"SL2.50ch08:40631090-40631465","0","40631090","40631465","375","1534.31159643","0.244409284836"
"SL2.50ch08:40632968-40633569","5","40632968","40633569","601","1534.31159643","0.391706613831"
"SL2.50ch08:41075319-41076236","5","41075319","41076236","917","1534.31159643","0.597662171186"
"SL2.50ch08:41315057-41315579","0","41315057","41315579","522","1534.31159643","0.340217724492"
"SL2.50ch08:41619053-41619543","8","41619053","41619543","490","1534.31159643","0.319361465519"
"SL2.50ch08:42177146-42177627","3","42177146","42177627","481","1534.31159643","0.313495642683"
"SL2.50ch08:4256808-4257458","9","4256808","4257458","650","1534.31159643","0.423642760383"
"SL2.50ch08:4393981-4394383","16","4393981","4394383","402","1534.31159643","0.262006753345"
"SL2.50ch08:44328114-44328997","7","44328114","44328997","883","1534.31159643","0.575502396028"
"SL2.50ch08:44809859-44810351","1","44809859","44810351","492","1534.31159643","0.320664981705"
"SL2.50ch08:46708959-46710564","42","46708959","46710564","1605","1534.31159643","1.0460717391"
"SL2.50ch08:46709679-46710490","41","46709679","46710490","811","1534.31159643","0.528575813339"
"SL2.50ch08:46782997-46783372","2","46782997","46783372","375","1534.31159643","0.244409284836"
"SL2.50ch08:46873921-46876100","23","46873921","46876100","2179","1534.31159643","1.42018088442"
"SL2.50ch08:46950792-46951507","1","46950792","46951507","715","1534.31159643","0.466007036421"
"SL2.50ch08:46953229-46956365","1093","46953229","46956365","3136","1534.31159643","2.04391337932"
"SL2.50ch08:46953330-46956047","1086","46953330","46956047","2717","1534.31159643","1.7708267384"
"SL2.50ch08:48239737-48240989","35","48239737","48240989","1252","1534.31159643","0.816001132307"
"SL2.50ch08:48239856-48240807","35","48239856","48240807","951","1534.31159643","0.619821946345"
"SL2.50ch08:48578587-48579189","1","48578587","48579189","602","1534.31159643","0.392358371924"
"SL2.50ch08:50477166-50478169","12","50477166","50478169","1003","1534.31159643","0.653713367176"
"SL2.50ch08:51015740-51016115","6","51015740","51016115","375","1534.31159643","0.244409284836"
"SL2.50ch08:51242868-51243343","4","51242868","51243343","475","1534.31159643","0.309585094126"
"SL2.50ch08:51743956-51744483","52","51743956","51744483","527","1534.31159643","0.343476514957"
"SL2.50ch08:54478594-54479084","56","54478594","54479084","490","1534.31159643","0.319361465519"
"SL2.50ch08:54824004-54824605","9","54824004","54824605","601","1534.31159643","0.391706613831"
"SL2.50ch08:54992791-54994630","33","54992791","54994630","1839","1534.31159643","1.19858313284"
"SL2.50ch08:57456485-57456887","15","57456485","57456887","402","1534.31159643","0.262006753345"
"SL2.50ch08:5746546-5747235","5","5746546","5747235","689","1534.31159643","0.449061326006"
"SL2.50ch08:57484981-57486206","111","57484981","57486206","1225","1534.31159643","0.798403663799"
"SL2.50ch08:57485394-57486098","109","57485394","57486098","704","1534.31159643","0.458837697399"
"SL2.50ch08:57859884-57863473","41","57859884","57863473","3589","1534.31159643","2.33915979541"
"SL2.50ch08:60629009-60629993","13","60629009","60629993","984","1534.31159643","0.641329963411"
"SL2.50ch08:6345911-6346468","0","6345911","6346468","557","1534.31159643","0.363029257744"
"SL2.50ch08:63628760-63629740","12","63628760","63629740","980","1534.31159643","0.638722931039"
"SL2.50ch08:6502019-6502394","6","6502019","6502394","375","1534.31159643","0.244409284836"
"SL2.50ch08:65066031-65066691","14","65066031","65066691","660","1534.31159643","0.430160341312"
"SL2.50ch08:65133266-65133734","6","65133266","65133734","468","1534.31159643","0.305022787476"
"SL2.50ch08:65160430-65161335","10","65160430","65161335","905","1534.31159643","0.589841074072"
"SL2.50ch08:6548271-6548931","62","6548271","6548931","660","1534.31159643","0.430160341312"
"SL2.50ch08:6548308-6548870","62","6548308","6548870","562","1534.31159643","0.366288048208"
"SL2.50ch08:65731792-65734597","14","65731792","65734597","2805","1534.31159643","1.82818145058"
"SL2.50ch08:7035438-7036053","7","7035438","7036053","615","1534.31159643","0.400831227132"
"SL2.50ch08:7130693-7131166","1","7130693","7131166","473","1534.31159643","0.30828157794"
"SL2.50ch08:8130598-8131124","0","8130598","8131124","526","1534.31159643","0.342824756864"
"SL2.50ch08:8702609-8703998","13","8702609","8703998","1389","1534.31159643","0.905291991034"
"SL2.50ch08:9019480-9019855","4","9019480","9019855","375","1534.31159643","0.244409284836"
"SL2.50ch08:9361556-9364116","27","9361556","9364116","2560","1534.31159643","1.66850071782"
"SL2.50ch08:9427529-9431458","32","9427529","9431458","3929","1534.31159643","2.56075754699"
"SL2.50ch08:9428601-9429104","10","9428601","9429104","503","1534.31159643","0.327834320727"
"SL2.50ch08:9436310-9437747","15","9436310","9437747","1437","1534.31159643","0.936576379493"
"SL2.50ch08:9455858-9456233","5","9455858","9456233","375","1534.31159643","0.244409284836"
"SL2.50ch08:9460721-9462248","13","9460721","9462248","1527","1534.31159643","0.995234607854"
"SL2.50ch08:9465618-9467091","17","9465618","9467091","1473","1534.31159643","0.960039670837"
"SL2.50ch08:9985729-9986390","28","9985729","9986390","661","1534.31159643","0.430812099405"
"SL2.50ch08:9985756-9986388","28","9985756","9986388","632","1534.31159643","0.411911114711"
"SL2.50ch08:9987933-9990384","126","9987933","9990384","2451","1534.31159643","1.59745908569"
"SL2.50ch08:9987993-9990336","126","9987993","9990336","2343","1534.31159643","1.52706921166"
"SL2.50ch08:9993033-9995895","136","9993033","9995895","2862","1534.31159643","1.86533166187"
"SL2.50ch08:9993036-9995912","136","9993036","9995912","2876","1534.31159643","1.87445627517"
"SL2.50ch09:10913610-10913985","3","10913610","10913985","375","1534.31159643","0.244409284836"
"SL2.50ch09:11297433-11301505","314","11297433","11301505","4072","1534.31159643","2.65395895428"
"SL2.50ch09:11297633-11301471","313","11297633","11301471","3838","1534.31159643","2.50144756054"
"SL2.50ch09:11302230-11304243","241","11302230","11304243","2013","1534.31159643","1.311989041"
"SL2.50ch09:11302374-11304283","238","11302374","11304283","1909","1534.31159643","1.24420619934"
"SL2.50ch09:11306570-11308211","147","11306570","11308211","1641","1534.31159643","1.06953503044"
"SL2.50ch09:11306583-11308316","147","11306583","11308316","1733","1534.31159643","1.12949677499"
"SL2.50ch09:11310073-11314098","168","11310073","11314098","4025","1534.31159643","2.62332632391"
"SL2.50ch09:11310180-11312338","152","11310180","11312338","2158","1534.31159643","1.40649396447"
"SL2.50ch09:11312889-11313291","7","11312889","11313291","402","1534.31159643","0.262006753345"
"SL2.50ch09:11575480-11576351","5","11575480","11576351","871","1534.31159643","0.567681298913"
"SL2.50ch09:12099517-12100172","10","12099517","12100172","655","1534.31159643","0.426901550847"
"SL2.50ch09:12786329-12786968","11","12786329","12786968","639","1534.31159643","0.416473421361"
"SL2.50ch09:12883847-12884332","5","12883847","12884332","485","1534.31159643","0.316102675055"
"SL2.50ch09:13688021-13688423","19","13688021","13688423","402","1534.31159643","0.262006753345"
"SL2.50ch09:13697321-13697723","9","13697321","13697723","402","1534.31159643","0.262006753345"
"SL2.50ch09:14455145-14456119","6","14455145","14456119","974","1534.31159643","0.634812382482"
"SL2.50ch09:15203638-15204013","5","15203638","15204013","375","1534.31159643","0.244409284836"
"SL2.50ch09:1555849-1556419","38","1555849","1556419","570","1534.31159643","0.371502112951"
"SL2.50ch09:1555899-1556389","38","1555899","1556389","490","1534.31159643","0.319361465519"
"SL2.50ch09:16779793-16780722","15","16779793","16780722","929","1534.31159643","0.605483268301"
"SL2.50ch09:16784081-16785298","2","16784081","16785298","1217","1534.31159643","0.793189599056"
"SL2.50ch09:17834934-17835451","4","17834934","17835451","517","1534.31159643","0.336958934028"
"SL2.50ch09:18467595-18469417","15","18467595","18469417","1822","1534.31159643","1.18750324526"
"SL2.50ch09:18938919-18939551","43","18938919","18939551","632","1534.31159643","0.411911114711"
"SL2.50ch09:19183208-19183583","7","19183208","19183583","375","1534.31159643","0.244409284836"
"SL2.50ch09:20902832-20903304","1","20902832","20903304","472","1534.31159643","0.307629819847"
"SL2.50ch09:21073066-21073441","5","21073066","21073441","375","1534.31159643","0.244409284836"
"SL2.50ch09:21620518-21621122","9","21620518","21621122","604","1534.31159643","0.39366188811"
"SL2.50ch09:22012360-22012948","0","22012360","22012948","588","1534.31159643","0.383233758623"
"SL2.50ch09:22135710-22136380","1","22135710","22136380","670","1534.31159643","0.436677922241"
"SL2.50ch09:22141916-22142778","14","22141916","22142778","862","1534.31159643","0.561815476077"
"SL2.50ch09:23494719-23495226","5","23494719","23495226","507","1534.31159643","0.330441353099"
"SL2.50ch09:2437059-2437726","44","2437059","2437726","667","1534.31159643","0.434722647962"
"SL2.50ch09:2437079-2437650","44","2437079","2437650","571","1534.31159643","0.372153871044"
"SL2.50ch09:24474541-24475334","53","24474541","24475334","793","1534.31159643","0.516844167667"
"SL2.50ch09:24474549-24475257","53","24474549","24475257","708","1534.31159643","0.461444729771"
"SL2.50ch09:25552558-25553171","7","25552558","25553171","613","1534.31159643","0.399527710946"
"SL2.50ch09:25887216-25887696","7","25887216","25887696","480","1534.31159643","0.312843884591"
"SL2.50ch09:25887304-25887706","7","25887304","25887706","402","1534.31159643","0.262006753345"
"SL2.50ch09:27249298-27250497","9","27249298","27250497","1199","1534.31159643","0.781457953383"
"SL2.50ch09:27730679-27731464","22","27730679","27731464","785","1534.31159643","0.511630102924"
"SL2.50ch09:27733037-27733692","21","27733037","27733692","655","1534.31159643","0.426901550847"
"SL2.50ch09:27891051-27891426","2","27891051","27891426","375","1534.31159643","0.244409284836"
"SL2.50ch09:28285369-28285744","3","28285369","28285744","375","1534.31159643","0.244409284836"
"SL2.50ch09:28762960-28763600","8","28762960","28763600","640","1534.31159643","0.417125179454"
"SL2.50ch09:28838378-28838972","8","28838378","28838972","594","1534.31159643","0.387144307181"
"SL2.50ch09:28987986-28988586","6","28987986","28988586","600","1534.31159643","0.391054855738"
"SL2.50ch09:29282249-29282761","10","29282249","29282761","512","1534.31159643","0.333700143563"
"SL2.50ch09:29455461-29456594","9","29455461","29456594","1133","1534.31159643","0.738441919252"
"SL2.50ch09:29741815-29742432","61","29741815","29742432","617","1534.31159643","0.402134743317"
"SL2.50ch09:29757793-29758168","5","29757793","29758168","375","1534.31159643","0.244409284836"
"SL2.50ch09:29912063-29912915","5","29912063","29912915","852","1534.31159643","0.555297895148"
"SL2.50ch09:29954305-29954866","2","29954305","29954866","561","1534.31159643","0.365636290115"
"SL2.50ch09:30236488-30236968","6","30236488","30236968","480","1534.31159643","0.312843884591"
"SL2.50ch09:33570958-33572285","2","33570958","33572285","1327","1534.31159643","0.864882989274"
"SL2.50ch09:34125225-34126397","2","34125225","34126397","1172","1534.31159643","0.763860484875"
"SL2.50ch09:34702464-34702969","1","34702464","34702969","505","1534.31159643","0.329137836913"
"SL2.50ch09:34844549-34845493","10","34844549","34845493","944","1534.31159643","0.615259639695"
"SL2.50ch09:34860382-34860983","2","34860382","34860983","601","1534.31159643","0.391706613831"
"SL2.50ch09:34987011-34988002","8","34987011","34988002","991","1534.31159643","0.645892270061"
"SL2.50ch09:35168289-35168779","1","35168289","35168779","490","1534.31159643","0.319361465519"
"SL2.50ch09:35300602-35302548","187","35300602","35302548","1946","1534.31159643","1.26832124878"
"SL2.50ch09:35300663-35302556","187","35300663","35302556","1893","1534.31159643","1.23377806985"
"SL2.50ch09:35303351-35308999","438","35303351","35308999","5648","1534.31159643","3.68112970868"
"SL2.50ch09:35303443-35305387","187","35303443","35305387","1944","1534.31159643","1.26701773259"
"SL2.50ch09:35306176-35308989","243","35306176","35308989","2813","1534.31159643","1.83339551532"
"SL2.50ch09:37196994-37197835","4","37196994","37197835","841","1534.31159643","0.548128556126"
"SL2.50ch09:37216149-37217048","8","37216149","37217048","899","1534.31159643","0.585930525514"
"SL2.50ch09:37249312-37249946","3","37249312","37249946","634","1534.31159643","0.413214630897"
"SL2.50ch09:37475320-37476676","5","37475320","37476676","1356","1534.31159643","0.883783973968"
"SL2.50ch09:37523057-37523715","20","37523057","37523715","658","1534.31159643","0.428856825126"
"SL2.50ch09:37523249-37523651","17","37523249","37523651","402","1534.31159643","0.262006753345"
"SL2.50ch09:3848301-3852522","25","3848301","3852522","4221","1534.31159643","2.75107091012"
"SL2.50ch09:38513258-38514429","7","38513258","38514429","1171","1534.31159643","0.763208726782"
"SL2.50ch09:40279709-40281584","2431","40279709","40281584","1875","1534.31159643","1.22204642418"
"SL2.50ch09:40280079-40281577","2429","40280079","40281577","1498","1534.31159643","0.97633362316"
"SL2.50ch09:40552759-40553134","2","40552759","40553134","375","1534.31159643","0.244409284836"
"SL2.50ch09:40947150-40948005","6","40947150","40948005","855","1534.31159643","0.557253169427"
"SL2.50ch09:41484055-41484889","4","41484055","41484889","834","1534.31159643","0.543566249476"
"SL2.50ch09:4209630-4210120","96","4209630","4210120","490","1534.31159643","0.319361465519"
"SL2.50ch09:42326378-42326753","1","42326378","42326753","375","1534.31159643","0.244409284836"
"SL2.50ch09:42545887-42546262","0","42545887","42546262","375","1534.31159643","0.244409284836"
"SL2.50ch09:43426394-43426930","4","43426394","43426930","536","1534.31159643","0.349342337793"
"SL2.50ch09:43698962-43699337","2","43698962","43699337","375","1534.31159643","0.244409284836"
"SL2.50ch09:44219804-44220533","3","44219804","44220533","729","1534.31159643","0.475131649722"
"SL2.50ch09:45397090-45398123","44","45397090","45398123","1033","1534.31159643","0.673266109962"
"SL2.50ch09:45397097-45398282","44","45397097","45398282","1185","1534.31159643","0.772333340083"
"SL2.50ch09:45408056-45408524","9","45408056","45408524","468","1534.31159643","0.305022787476"
"SL2.50ch09:45873708-45874276","0","45873708","45874276","568","1534.31159643","0.370198596765"
"SL2.50ch09:45954908-45955894","14","45954908","45955894","986","1534.31159643","0.642633479596"
"SL2.50ch09:45983903-45985557","9","45983903","45985557","1654","1534.31159643","1.07800788565"
"SL2.50ch09:46155173-46155548","2","46155173","46155548","375","1534.31159643","0.244409284836"
"SL2.50ch09:46262521-46263447","559","46262521","46263447","926","1534.31159643","0.603527994023"
"SL2.50ch09:46262538-46263493","559","46262538","46263493","955","1534.31159643","0.622428978717"
"SL2.50ch09:46321036-46321411","5","46321036","46321411","375","1534.31159643","0.244409284836"
"SL2.50ch09:46513407-46513782","3","46513407","46513782","375","1534.31159643","0.244409284836"
"SL2.50ch09:46933685-46934274","0","46933685","46934274","589","1534.31159643","0.383885516716"
"SL2.50ch09:47142074-47142625","3","47142074","47142625","551","1534.31159643","0.359118709186"
"SL2.50ch09:47738019-47738394","3","47738019","47738394","375","1534.31159643","0.244409284836"
"SL2.50ch09:48423702-48424298","1","48423702","48424298","596","1534.31159643","0.388447823367"
"SL2.50ch09:49050495-49050990","2","49050495","49050990","495","1534.31159643","0.322620255984"
"SL2.50ch09:49471027-49473562","27","49471027","49473562","2535","1534.31159643","1.65220676549"
"SL2.50ch09:50420333-50420882","1","50420333","50420882","549","1534.31159643","0.357815193"
"SL2.50ch09:50745497-50746146","12","50745497","50746146","649","1534.31159643","0.42299100229"
"SL2.50ch09:50745717-50746227","12","50745717","50746227","510","1534.31159643","0.332396627377"
"SL2.50ch09:51275981-51276471","51","51275981","51276471","490","1534.31159643","0.319361465519"
"SL2.50ch09:51344045-51344420","0","51344045","51344420","375","1534.31159643","0.244409284836"
"SL2.50ch09:51595983-51596497","16","51595983","51596497","514","1534.31159643","0.335003659749"
"SL2.50ch09:51905531-51905906","7","51905531","51905906","375","1534.31159643","0.244409284836"
"SL2.50ch09:53088338-53091071","235","53088338","53091071","2733","1534.31159643","1.78125486789"
"SL2.50ch09:53088398-53090475","231","53088398","53090475","2077","1534.31159643","1.35370155895"
"SL2.50ch09:53828985-53829972","5","53828985","53829972","987","1534.31159643","0.643285237689"
"SL2.50ch09:54057403-54057882","2","54057403","54057882","479","1534.31159643","0.312192126498"
"SL2.50ch09:54977957-54978359","16","54977957","54978359","402","1534.31159643","0.262006753345"
"SL2.50ch09:55002502-55003120","1","55002502","55003120","618","1534.31159643","0.40278650141"
"SL2.50ch09:55027619-55028153","43","55027619","55028153","534","1534.31159643","0.348038821607"
"SL2.50ch09:55543055-55543527","0","55543055","55543527","472","1534.31159643","0.307629819847"
"SL2.50ch09:56322382-56322784","5","56322382","56322784","402","1534.31159643","0.262006753345"
"SL2.50ch09:58045759-58046663","5","58045759","58046663","904","1534.31159643","0.589189315979"
"SL2.50ch09:58157621-58158308","0","58157621","58158308","687","1534.31159643","0.44775780982"
"SL2.50ch09:58182606-58182981","13","58182606","58182981","375","1534.31159643","0.244409284836"
"SL2.50ch09:58995412-58997131","228","58995412","58997131","1719","1534.31159643","1.12037216169"
"SL2.50ch09:58995750-58996791","227","58995750","58996791","1041","1534.31159643","0.678480174706"
"SL2.50ch09:60656705-60657375","24","60656705","60657375","670","1534.31159643","0.436677922241"
"SL2.50ch09:60656797-60657410","21","60656797","60657410","613","1534.31159643","0.399527710946"
"SL2.50ch09:61857371-61858195","232","61857371","61858195","824","1534.31159643","0.537048668547"
"SL2.50ch09:61857396-61858161","232","61857396","61858161","765","1534.31159643","0.498594941066"
"SL2.50ch09:62110628-62111030","22","62110628","62111030","402","1534.31159643","0.262006753345"
"SL2.50ch09:63666452-63666942","44","63666452","63666942","490","1534.31159643","0.319361465519"
"SL2.50ch09:63970859-63971481","177","63970859","63971481","622","1534.31159643","0.405393533782"
"SL2.50ch09:63970860-63971410","177","63970860","63971410","550","1534.31159643","0.358466951093"
"SL2.50ch09:64935402-64937389","32","64935402","64937389","1987","1534.31159643","1.29504333059"
"SL2.50ch09:65535129-65535619","23","65535129","65535619","490","1534.31159643","0.319361465519"
"SL2.50ch09:67002207-67003115","12","67002207","67003115","908","1534.31159643","0.59179634835"
"SL2.50ch09:67762875-67763250","3","67762875","67763250","375","1534.31159643","0.244409284836"
"SL2.50ch09:6789960-6791468","77","6789960","6791468","1508","1534.31159643","0.982851204088"
"SL2.50ch09:6789992-6791557","77","6789992","6791557","1565","1534.31159643","1.02000141538"
"SL2.50ch09:68837167-68838375","9","68837167","68838375","1208","1534.31159643","0.787323776219"
"SL2.50ch09:70696416-70697033","29","70696416","70697033","617","1534.31159643","0.402134743317"
"SL2.50ch09:70696434-70697040","29","70696434","70697040","606","1534.31159643","0.394965404296"
"SL2.50ch09:71682972-71683347","1","71682972","71683347","375","1534.31159643","0.244409284836"
"SL2.50ch09:7384132-7384605","1","7384132","7384605","473","1534.31159643","0.30828157794"
"SL2.50ch09:8067272-8067647","10","8067272","8067647","375","1534.31159643","0.244409284836"
"SL2.50ch09:8532278-8533253","3","8532278","8533253","975","1534.31159643","0.635464140574"
"SL2.50ch09:8551137-8551645","19","8551137","8551645","508","1534.31159643","0.331093111192"
"SL2.50ch09:8786424-8786799","4","8786424","8786799","375","1534.31159643","0.244409284836"
"SL2.50ch10:1-701","26","1","701","700","1534.31159643","0.456230665028"
"SL2.50ch10:10731514-10732335","31","10731514","10732335","821","1534.31159643","0.535093394268"
"SL2.50ch10:10731664-10732377","29","10731664","10732377","713","1534.31159643","0.464703520235"
"SL2.50ch10:10733637-10734143","12","10733637","10734143","506","1534.31159643","0.329789595006"
"SL2.50ch10:10734960-10735464","12","10734960","10735464","504","1534.31159643","0.32848607882"
"SL2.50ch10:11654073-11654599","1","11654073","11654599","526","1534.31159643","0.342824756864"
"SL2.50ch10:11687652-11689381","21","11687652","11689381","1729","1534.31159643","1.12688974262"
"SL2.50ch10:12559557-12560236","1","12559557","12560236","679","1534.31159643","0.442543745077"
"SL2.50ch10:13106178-13107086","4","13106178","13107086","908","1534.31159643","0.59179634835"
"SL2.50ch10:13112693-13113212","3","13112693","13113212","519","1534.31159643","0.338262450213"
"SL2.50ch10:14078179-14078554","3","14078179","14078554","375","1534.31159643","0.244409284836"
"SL2.50ch10:14203407-14204871","19","14203407","14204871","1464","1534.31159643","0.954173848001"
"SL2.50ch10:14222028-14222403","7","14222028","14222403","375","1534.31159643","0.244409284836"
"SL2.50ch10:14253242-14253617","7","14253242","14253617","375","1534.31159643","0.244409284836"
"SL2.50ch10:14308409-14308963","4","14308409","14308963","554","1534.31159643","0.361073983465"
"SL2.50ch10:14396595-14397204","2","14396595","14397204","609","1534.31159643","0.396920678574"
"SL2.50ch10:14724591-14726784","16","14724591","14726784","2193","1534.31159643","1.42930549772"
"SL2.50ch10:15241379-15242845","1032","15241379","15242845","1466","1534.31159643","0.955477364187"
"SL2.50ch10:15241454-15242846","1032","15241454","15242846","1392","1534.31159643","0.907247265312"
"SL2.50ch10:15272405-15273237","9","15272405","15273237","832","1534.31159643","0.54226273329"
"SL2.50ch10:15372211-15372855","4","15372211","15372855","644","1534.31159643","0.419732211826"
"SL2.50ch10:15650527-15651102","2","15650527","15651102","575","1534.31159643","0.374760903416"
"SL2.50ch10:15654170-15654545","2","15654170","15654545","375","1534.31159643","0.244409284836"
"SL2.50ch10:15721784-15725257","32","15721784","15725257","3473","1534.31159643","2.26355585663"
"SL2.50ch10:15742129-15745008","35","15742129","15745008","2879","1534.31159643","1.87641154945"
"SL2.50ch10:15782402-15786109","26","15782402","15786109","3707","1534.31159643","2.41606725037"
"SL2.50ch10:15874568-15875171","14","15874568","15875171","603","1534.31159643","0.393010130017"
"SL2.50ch10:15949441-15949909","5","15949441","15949909","468","1534.31159643","0.305022787476"
"SL2.50ch10:16275581-16276262","4","16275581","16276262","681","1534.31159643","0.443847261263"
"SL2.50ch10:16338716-16339287","4","16338716","16339287","571","1534.31159643","0.372153871044"
"SL2.50ch10:16372227-16372851","4","16372227","16372851","624","1534.31159643","0.406697049968"
"SL2.50ch10:16378991-16379660","5","16378991","16379660","669","1534.31159643","0.436026164148"
"SL2.50ch10:16717479-16717854","0","16717479","16717854","375","1534.31159643","0.244409284836"
"SL2.50ch10:16939078-16940016","4","16939078","16940016","938","1534.31159643","0.611349091137"
"SL2.50ch10:18-641","26","18","641","623","1534.31159643","0.406045291875"
"SL2.50ch10:18054873-18056070","19","18054873","18056070","1197","1534.31159643","0.780154437198"
"SL2.50ch10:18417510-18421836","58","18417510","18421836","4326","1534.31159643","2.81950550987"
"SL2.50ch10:18418674-18420316","37","18418674","18420316","1642","1534.31159643","1.07018678854"
"SL2.50ch10:18762999-18763489","45","18762999","18763489","490","1534.31159643","0.319361465519"
"SL2.50ch10:19088893-19089504","2","19088893","19089504","611","1534.31159643","0.39822419476"
"SL2.50ch10:19334782-19335157","1","19334782","19335157","375","1534.31159643","0.244409284836"
"SL2.50ch10:19988231-19988804","17","19988231","19988804","573","1534.31159643","0.37345738723"
"SL2.50ch10:20007176-20007918","3","20007176","20007918","742","1534.31159643","0.483604504929"
"SL2.50ch10:20194133-20195111","2","20194133","20195111","978","1534.31159643","0.637419414853"
"SL2.50ch10:20311622-20312105","1","20311622","20312105","483","1534.31159643","0.314799158869"
"SL2.50ch10:20635803-20636178","3","20635803","20636178","375","1534.31159643","0.244409284836"
"SL2.50ch10:21219967-21221128","23","21219967","21221128","1161","1534.31159643","0.756691145853"
"SL2.50ch10:21225499-21228599","29","21225499","21228599","3100","1534.31159643","2.02045008798"
"SL2.50ch10:21231545-21232691","8","21231545","21232691","1146","1534.31159643","0.74691477446"
"SL2.50ch10:21236001-21237691","20","21236001","21237691","1690","1534.31159643","1.101471177"
"SL2.50ch10:21247088-21247972","23","21247088","21247972","884","1534.31159643","0.576154154121"
"SL2.50ch10:21250900-21251570","7","21250900","21251570","670","1534.31159643","0.436677922241"
"SL2.50ch10:22463263-22463776","19","22463263","22463776","513","1534.31159643","0.334351901656"
"SL2.50ch10:22665297-22665974","16","22665297","22665974","677","1534.31159643","0.441240228891"
"SL2.50ch10:22665414-22665918","13","22665414","22665918","504","1534.31159643","0.32848607882"
"SL2.50ch10:23944452-23944854","4","23944452","23944854","402","1534.31159643","0.262006753345"
"SL2.50ch10:23945580-23946082","16","23945580","23946082","502","1534.31159643","0.327182562634"
"SL2.50ch10:23948704-23949277","10","23948704","23949277","573","1534.31159643","0.37345738723"
"SL2.50ch10:23948779-23949181","8","23948779","23949181","402","1534.31159643","0.262006753345"
"SL2.50ch10:23972110-23972485","3","23972110","23972485","375","1534.31159643","0.244409284836"
"SL2.50ch10:24143571-24146441","31","24143571","24146441","2870","1534.31159643","1.87054572661"
"SL2.50ch10:24474490-24474865","1","24474490","24474865","375","1534.31159643","0.244409284836"
"SL2.50ch10:24813287-24813755","8","24813287","24813755","468","1534.31159643","0.305022787476"
"SL2.50ch10:25679622-25680204","2","25679622","25680204","582","1534.31159643","0.379323210066"
"SL2.50ch10:25715786-25716490","4","25715786","25716490","704","1534.31159643","0.458837697399"
"SL2.50ch10:25777485-25777975","122","25777485","25777975","490","1534.31159643","0.319361465519"
"SL2.50ch10:26348586-26357575","102","26348586","26357575","8989","1534.31159643","5.85865349705"
"SL2.50ch10:26356202-26357520","28","26356202","26357520","1318","1534.31159643","0.859017166438"
"SL2.50ch10:26364134-26365086","15","26364134","26365086","952","1534.31159643","0.620473704438"
"SL2.50ch10:26364243-26365002","13","26364243","26365002","759","1534.31159643","0.494684392509"
"SL2.50ch10:26365611-26366196","8","26365611","26366196","585","1534.31159643","0.381278484345"
"SL2.50ch10:26371425-26374710","41","26371425","26374710","3285","1534.31159643","2.14102533517"
"SL2.50ch10:26801238-26804011","530","26801238","26804011","2773","1534.31159643","1.8073251916"
"SL2.50ch10:26801368-26803806","530","26801368","26803806","2438","1534.31159643","1.58898623048"
"SL2.50ch10:26805655-26806686","123","26805655","26806686","1031","1534.31159643","0.671962593777"
"SL2.50ch10:26805688-26806695","123","26805688","26806695","1007","1534.31159643","0.656320399547"
"SL2.50ch10:26986697-26987165","2","26986697","26987165","468","1534.31159643","0.305022787476"
"SL2.50ch10:27367989-27368602","119","27367989","27368602","613","1534.31159643","0.399527710946"
"SL2.50ch10:28171694-28172069","5","28171694","28172069","375","1534.31159643","0.244409284836"
"SL2.50ch10:28297575-28299380","26","28297575","28299380","1805","1534.31159643","1.17642335768"
"SL2.50ch10:28298074-28299384","21","28298074","28299384","1310","1534.31159643","0.853803101695"
"SL2.50ch10:28333936-28334311","5","28333936","28334311","375","1534.31159643","0.244409284836"
"SL2.50ch10:28974325-28975005","2","28974325","28975005","680","1534.31159643","0.44319550317"
"SL2.50ch10:29736412-29737191","3","29736412","29737191","779","1534.31159643","0.507719554367"
"SL2.50ch10:30176407-30176937","2","30176407","30176937","530","1534.31159643","0.345431789235"
"SL2.50ch10:30262764-30263256","3","30262764","30263256","492","1534.31159643","0.320664981705"
"SL2.50ch10:30914447-30915421","4","30914447","30915421","974","1534.31159643","0.634812382482"
"SL2.50ch10:3100798-3101427","11","3100798","3101427","629","1534.31159643","0.409955840432"
"SL2.50ch10:3100924-3101393","11","3100924","3101393","469","1534.31159643","0.305674545569"
"SL2.50ch10:31221287-31221662","6","31221287","31221662","375","1534.31159643","0.244409284836"
"SL2.50ch10:31948568-31949336","4","31948568","31949336","768","1534.31159643","0.500550215345"
"SL2.50ch10:32121655-32122145","6","32121655","32122145","490","1534.31159643","0.319361465519"
"SL2.50ch10:32243555-32244036","3","32243555","32244036","481","1534.31159643","0.313495642683"
"SL2.50ch10:32274552-32275126","1","32274552","32275126","574","1534.31159643","0.374109145323"
"SL2.50ch10:32295418-32296388","27","32295418","32296388","970","1534.31159643","0.63220535011"
"SL2.50ch10:32297514-32298129","5","32297514","32298129","615","1534.31159643","0.400831227132"
"SL2.50ch10:32437159-32437832","3","32437159","32437832","673","1534.31159643","0.43863319652"
"SL2.50ch10:33582526-33582901","1","33582526","33582901","375","1534.31159643","0.244409284836"
"SL2.50ch10:3515329-3517677","22","3515329","3517677","2348","1534.31159643","1.53032800212"
"SL2.50ch10:35324569-35324944","17","35324569","35324944","375","1534.31159643","0.244409284836"
"SL2.50ch10:35415878-35416280","1","35415878","35416280","402","1534.31159643","0.262006753345"
"SL2.50ch10:35971426-35971801","1","35971426","35971801","375","1534.31159643","0.244409284836"
"SL2.50ch10:36492781-36493290","0","36492781","36493290","509","1534.31159643","0.331744869285"
"SL2.50ch10:36675059-36675434","2","36675059","36675434","375","1534.31159643","0.244409284836"
"SL2.50ch10:36684431-36685513","35","36684431","36685513","1082","1534.31159643","0.705202256514"
"SL2.50ch10:36684467-36685379","35","36684467","36685379","912","1534.31159643","0.594403380722"
"SL2.50ch10:36692857-36693428","7","36692857","36693428","571","1534.31159643","0.372153871044"
"SL2.50ch10:37171312-37171802","68","37171312","37171802","490","1534.31159643","0.319361465519"
"SL2.50ch10:37171355-37171823","68","37171355","37171823","468","1534.31159643","0.305022787476"
"SL2.50ch10:37566299-37566866","0","37566299","37566866","567","1534.31159643","0.369546838673"
"SL2.50ch10:3773789-3775431","14","3773789","3775431","1642","1534.31159643","1.07018678854"
"SL2.50ch10:38100516-38105622","53","38100516","38105622","5106","1534.31159643","3.32787682233"
"SL2.50ch10:3824639-3826206","18","3824639","3826206","1567","1534.31159643","1.02130493157"
"SL2.50ch10:38517930-38518836","8","38517930","38518836","906","1534.31159643","0.590492832165"
"SL2.50ch10:39018233-39019133","22","39018233","39019133","900","1534.31159643","0.586582283607"
"SL2.50ch10:39018255-39019106","21","39018255","39019106","851","1534.31159643","0.554646137055"
"SL2.50ch10:39505430-39506103","93","39505430","39506103","673","1534.31159643","0.43863319652"
"SL2.50ch10:39505493-39505983","92","39505493","39505983","490","1534.31159643","0.319361465519"
"SL2.50ch10:39802143-39802518","0","39802143","39802518","375","1534.31159643","0.244409284836"
"SL2.50ch10:40793839-40797294","256","40793839","40797294","3455","1534.31159643","2.25182421096"
"SL2.50ch10:40798547-40799263","347","40798547","40799263","716","1534.31159643","0.466658794514"
"SL2.50ch10:40799672-40800178","27","40799672","40800178","506","1534.31159643","0.329789595006"
"SL2.50ch10:40803642-40804263","48","40803642","40804263","621","1534.31159643","0.404741775689"
"SL2.50ch10:40803669-40804328","48","40803669","40804328","659","1534.31159643","0.429508583219"
"SL2.50ch10:41437753-41438226","5","41437753","41438226","473","1534.31159643","0.30828157794"
"SL2.50ch10:41646844-41647246","21","41646844","41647246","402","1534.31159643","0.262006753345"
"SL2.50ch10:42461031-42462032","12","42461031","42462032","1001","1534.31159643","0.65240985099"
"SL2.50ch10:43054283-43060735","165","43054283","43060735","6452","1534.31159643","4.20514321537"
"SL2.50ch10:43055031-43060557","161","43055031","43060557","5526","1534.31159643","3.60161522135"
"SL2.50ch10:43880858-43882594","348","43880858","43882594","1736","1534.31159643","1.13145204927"
"SL2.50ch10:43880890-43882566","348","43880890","43882566","1676","1534.31159643","1.0923465637"
"SL2.50ch10:43884398-43885693","163","43884398","43885693","1295","1534.31159643","0.844026730301"
"SL2.50ch10:43884515-43885625","162","43884515","43885625","1110","1534.31159643","0.723451483116"
"SL2.50ch10:43886615-43888382","358","43886615","43888382","1767","1534.31159643","1.15165655015"
"SL2.50ch10:43886618-43888440","358","43886618","43888440","1822","1534.31159643","1.18750324526"
"SL2.50ch10:43892666-43893357","58","43892666","43893357","691","1534.31159643","0.450364842192"
"SL2.50ch10:43892709-43893629","60","43892709","43893629","920","1534.31159643","0.599617445465"
"SL2.50ch10:43989776-43990151","2","43989776","43990151","375","1534.31159643","0.244409284836"
"SL2.50ch10:45905625-45906385","143","45905625","45906385","760","1534.31159643","0.495336150602"
"SL2.50ch10:45905650-45906305","143","45905650","45906305","655","1534.31159643","0.426901550847"
"SL2.50ch10:46185706-46186727","10","46185706","46186727","1021","1534.31159643","0.665445012848"
"SL2.50ch10:46644232-46645002","0","46644232","46645002","770","1534.31159643","0.501853731531"
"SL2.50ch10:4700007-4700937","277","4700007","4700937","930","1534.31159643","0.606135026394"
"SL2.50ch10:4700036-4700898","277","4700036","4700898","862","1534.31159643","0.561815476077"
"SL2.50ch10:47369518-47369986","2","47369518","47369986","468","1534.31159643","0.305022787476"
"SL2.50ch10:47373453-47373828","4","47373453","47373828","375","1534.31159643","0.244409284836"
"SL2.50ch10:47595708-47598356","27","47595708","47598356","2648","1534.31159643","1.72585542999"
"SL2.50ch10:47596963-47598278","17","47596963","47598278","1315","1534.31159643","0.857061892159"
"SL2.50ch10:47837605-47837980","1","47837605","47837980","375","1534.31159643","0.244409284836"
"SL2.50ch10:48488925-48489300","1","48488925","48489300","375","1534.31159643","0.244409284836"
"SL2.50ch10:48524359-48524761","10","48524359","48524761","402","1534.31159643","0.262006753345"
"SL2.50ch10:48677438-48678027","1","48677438","48678027","589","1534.31159643","0.383885516716"
"SL2.50ch10:49149682-49150330","1","49149682","49150330","648","1534.31159643","0.422339244197"
"SL2.50ch10:50498192-50498674","4","50498192","50498674","482","1534.31159643","0.314147400776"
"SL2.50ch10:51068064-51068556","3","51068064","51068556","492","1534.31159643","0.320664981705"
"SL2.50ch10:51237020-51237865","3","51237020","51237865","845","1534.31159643","0.550735588498"
"SL2.50ch10:52342349-52342889","1","52342349","52342889","540","1534.31159643","0.351949370164"
"SL2.50ch10:53322775-53323337","70","53322775","53323337","562","1534.31159643","0.366288048208"
"SL2.50ch10:53322810-53323348","70","53322810","53323348","538","1534.31159643","0.350645853979"
"SL2.50ch10:53525541-53526156","39","53525541","53526156","615","1534.31159643","0.400831227132"
"SL2.50ch10:54021908-54024602","24","54021908","54024602","2694","1534.31159643","1.75583630226"
"SL2.50ch10:54023609-54024011","3","54023609","54024011","402","1534.31159643","0.262006753345"
"SL2.50ch10:54026726-54027542","9","54026726","54027542","816","1534.31159643","0.531834603804"
"SL2.50ch10:55347672-55348047","3","55347672","55348047","375","1534.31159643","0.244409284836"
"SL2.50ch10:57563929-57565882","21","57563929","57565882","1953","1534.31159643","1.27288355543"
"SL2.50ch10:57573299-57578498","79","57573299","57578498","5199","1534.31159643","3.38849032497"
"SL2.50ch10:57584192-57584885","10","57584192","57584885","693","1534.31159643","0.451668358378"
"SL2.50ch10:57587222-57588580","12","57587222","57588580","1358","1534.31159643","0.885087490154"
"SL2.50ch10:57594315-57595299","30","57594315","57595299","984","1534.31159643","0.641329963411"
"SL2.50ch10:57594383-57595217","30","57594383","57595217","834","1534.31159643","0.543566249476"
"SL2.50ch10:57647997-57648865","10","57647997","57648865","868","1534.31159643","0.565726024634"
"SL2.50ch10:57659221-57660171","22","57659221","57660171","950","1534.31159643","0.619170188252"
"SL2.50ch10:57686854-57687326","6","57686854","57687326","472","1534.31159643","0.307629819847"
"SL2.50ch10:57698042-57699159","15","57698042","57699159","1117","1534.31159643","0.728013789766"
"SL2.50ch10:57700866-57702286","22","57700866","57702286","1420","1534.31159643","0.925496491914"
"SL2.50ch10:58041839-58042241","13","58041839","58042241","402","1534.31159643","0.262006753345"
"SL2.50ch10:58689040-58689415","3","58689040","58689415","375","1534.31159643","0.244409284836"
"SL2.50ch10:59391562-59392485","6","59391562","59392485","923","1534.31159643","0.601572719744"
"SL2.50ch10:59458580-59458955","1","59458580","59458955","375","1534.31159643","0.244409284836"
"SL2.50ch10:60013538-60014033","9","60013538","60014033","495","1534.31159643","0.322620255984"
"SL2.50ch10:60632952-60633943","1","60632952","60633943","991","1534.31159643","0.645892270061"
"SL2.50ch10:60633553-60633955","1","60633553","60633955","402","1534.31159643","0.262006753345"
"SL2.50ch10:61674621-61675556","10","61674621","61675556","935","1534.31159643","0.609393816859"
"SL2.50ch10:6175070-6186660","2937","6175070","6186660","11590","1534.31159643","7.55387629667"
"SL2.50ch10:6175266-6186579","2937","6175266","6186579","11313","1534.31159643","7.37333930494"
"SL2.50ch10:6187225-6187761","58","6187225","6187761","536","1534.31159643","0.349342337793"
"SL2.50ch10:63001114-63001878","7","63001114","63001878","764","1534.31159643","0.497943182973"
"SL2.50ch10:65521191-65522972","36","65521191","65522972","1781","1534.31159643","1.16078116345"
"SL2.50ch10:65523714-65525561","24","65523714","65525561","1847","1534.31159643","1.20379719758"
"SL2.50ch10:6980397-6981026","1","6980397","6981026","629","1534.31159643","0.409955840432"
"SL2.50ch10:7026656-7027031","5","7026656","7027031","375","1534.31159643","0.244409284836"
"SL2.50ch10:7372271-7372746","13","7372271","7372746","475","1534.31159643","0.309585094126"
"SL2.50ch10:7372381-7372783","14","7372381","7372783","402","1534.31159643","0.262006753345"
"SL2.50ch10:7965182-7965557","5","7965182","7965557","375","1534.31159643","0.244409284836"
"SL2.50ch10:8853174-8853668","19","8853174","8853668","494","1534.31159643","0.321968497891"
"SL2.50ch10:9021012-9021414","14","9021012","9021414","402","1534.31159643","0.262006753345"
"SL2.50ch10:9939738-9940925","7","9939738","9940925","1187","1534.31159643","0.773636856269"
"SL2.50ch11:10861890-10862292","11","10861890","10862292","402","1534.31159643","0.262006753345"
"SL2.50ch11:11005906-11006652","17","11005906","11006652","746","1534.31159643","0.486211537301"
"SL2.50ch11:11091565-11093117","7","11091565","11093117","1552","1534.31159643","1.01152856018"
"SL2.50ch11:11288397-11288772","2","11288397","11288772","375","1534.31159643","0.244409284836"
"SL2.50ch11:11405368-11406109","0","11405368","11406109","741","1534.31159643","0.482952746837"
"SL2.50ch11:12015811-12016345","34","12015811","12016345","534","1534.31159643","0.348038821607"
"SL2.50ch11:12456445-12457150","3","12456445","12457150","705","1534.31159643","0.459489455492"
"SL2.50ch11:13246325-13247072","2","13246325","13247072","747","1534.31159643","0.486863295394"
"SL2.50ch11:13364969-13367360","67","13364969","13367360","2391","1534.31159643","1.55835360012"
"SL2.50ch11:13371699-13372835","24","13371699","13372835","1136","1534.31159643","0.740397193531"
"SL2.50ch11:13372079-13372569","19","13372079","13372569","490","1534.31159643","0.319361465519"
"SL2.50ch11:13374609-13375317","9","13374609","13375317","708","1534.31159643","0.461444729771"
"SL2.50ch11:13377232-13380988","1264","13377232","13380988","3756","1534.31159643","2.44800339692"
"SL2.50ch11:13378216-13380906","1246","13378216","13380906","2690","1534.31159643","1.75322926989"
"SL2.50ch11:13383723-13384959","239","13383723","13384959","1236","1534.31159643","0.805573002821"
"SL2.50ch11:13383731-13385920","270","13383731","13385920","2189","1534.31159643","1.42669846535"
"SL2.50ch11:13385499-13385901","26","13385499","13385901","402","1534.31159643","0.262006753345"
"SL2.50ch11:13386656-13388410","610","13386656","13388410","1754","1534.31159643","1.14318369494"
"SL2.50ch11:13386812-13388294","603","13386812","13388294","1482","1534.31159643","0.965905493673"
"SL2.50ch11:13390209-13392187","998","13390209","13392187","1978","1534.31159643","1.28917750775"
"SL2.50ch11:13390239-13392190","992","13390239","13392190","1951","1534.31159643","1.27158003924"
"SL2.50ch11:13394669-13399910","1717","13394669","13399910","5241","1534.31159643","3.41586416487"
"SL2.50ch11:13394681-13400108","1717","13394681","13400108","5427","1534.31159643","3.53709117015"
"SL2.50ch11:13401178-13402107","98","13401178","13402107","929","1534.31159643","0.605483268301"
"SL2.50ch11:13401366-13402088","97","13401366","13402088","722","1534.31159643","0.470569343072"
"SL2.50ch11:14275764-14276772","5","14275764","14276772","1008","1534.31159643","0.65697215764"
"SL2.50ch11:14383511-14384001","17","14383511","14384001","490","1534.31159643","0.319361465519"
"SL2.50ch11:14418958-14419333","3","14418958","14419333","375","1534.31159643","0.244409284836"
"SL2.50ch11:16103038-16104464","77","16103038","16104464","1426","1534.31159643","0.929407040471"
"SL2.50ch11:1651130-1651532","14","1651130","1651532","402","1534.31159643","0.262006753345"
"SL2.50ch11:16916961-16917908","6","16916961","16917908","947","1534.31159643","0.617214913973"
"SL2.50ch11:17210284-17210907","57","17210284","17210907","623","1534.31159643","0.406045291875"
"SL2.50ch11:17210290-17210902","57","17210290","17210902","612","1534.31159643","0.398875952853"
"SL2.50ch11:17769198-17769859","217","17769198","17769859","661","1534.31159643","0.430812099405"
"SL2.50ch11:17769254-17769867","217","17769254","17769867","613","1534.31159643","0.399527710946"
"SL2.50ch11:17832274-17833728","11","17832274","17833728","1454","1534.31159643","0.947656267072"
"SL2.50ch11:17850965-17851723","32","17850965","17851723","758","1534.31159643","0.494032634416"
"SL2.50ch11:17861238-17861852","62","17861238","17861852","614","1534.31159643","0.400179469039"
"SL2.50ch11:17872768-17874068","158","17872768","17874068","1300","1534.31159643","0.847285520766"
"SL2.50ch11:17898587-17899783","8","17898587","17899783","1196","1534.31159643","0.779502679105"
"SL2.50ch11:17940417-17941798","6","17940417","17941798","1381","1534.31159643","0.900077926291"
"SL2.50ch11:17948197-17948854","11","17948197","17948854","657","1534.31159643","0.428205067033"
"SL2.50ch11:17952477-17954993","28","17952477","17954993","2516","1534.31159643","1.63982336173"
"SL2.50ch11:17953886-17954979","21","17953886","17954979","1093","1534.31159643","0.712371595536"
"SL2.50ch11:17956473-17956952","7","17956473","17956952","479","1534.31159643","0.312192126498"
"SL2.50ch11:17963181-17963661","4","17963181","17963661","480","1534.31159643","0.312843884591"
"SL2.50ch11:17984475-17985156","10","17984475","17985156","681","1534.31159643","0.443847261263"
"SL2.50ch11:17987922-17989520","16","17987922","17989520","1598","1534.31159643","1.04150943245"
"SL2.50ch11:17990662-17991369","14","17990662","17991369","707","1534.31159643","0.460792971678"
"SL2.50ch11:17998453-18002543","50","17998453","18002543","4090","1534.31159643","2.66569059995"
"SL2.50ch11:18006123-18007075","10","18006123","18007075","952","1534.31159643","0.620473704438"
"SL2.50ch11:18015281-18019377","42","18015281","18019377","4096","1534.31159643","2.66960114851"
"SL2.50ch11:18020853-18026759","107","18020853","18026759","5906","1534.31159643","3.84928329665"
"SL2.50ch11:18024258-18026221","46","18024258","18026221","1963","1534.31159643","1.27940113636"
"SL2.50ch11:18031842-18034551","27","18031842","18034551","2709","1534.31159643","1.76561267366"
"SL2.50ch11:18032417-18033472","10","18032417","18033472","1055","1534.31159643","0.687604788006"
"SL2.50ch11:18034153-18034555","11","18034153","18034555","402","1534.31159643","0.262006753345"
"SL2.50ch11:18035054-18037120","41","18035054","18037120","2066","1534.31159643","1.34653221992"
"SL2.50ch11:18035360-18037075","37","18035360","18037075","1715","1534.31159643","1.11776512932"
"SL2.50ch11:18573851-18574412","6","18573851","18574412","561","1534.31159643","0.365636290115"
"SL2.50ch11:18584754-18585129","1","18584754","18585129","375","1534.31159643","0.244409284836"
"SL2.50ch11:18595359-18595971","56","18595359","18595971","612","1534.31159643","0.398875952853"
"SL2.50ch11:18627136-18627797","13","18627136","18627797","661","1534.31159643","0.430812099405"
"SL2.50ch11:18627183-18627859","13","18627183","18627859","676","1534.31159643","0.440588470798"
"SL2.50ch11:18644711-18645835","25","18644711","18645835","1124","1534.31159643","0.732576096416"
"SL2.50ch11:18645231-18645633","14","18645231","18645633","402","1534.31159643","0.262006753345"
"SL2.50ch11:18652070-18652572","1","18652070","18652572","502","1534.31159643","0.327182562634"
"SL2.50ch11:18669090-18669465","13","18669090","18669465","375","1534.31159643","0.244409284836"
"SL2.50ch11:18669137-18669539","15","18669137","18669539","402","1534.31159643","0.262006753345"
"SL2.50ch11:18682077-18682479","14","18682077","18682479","402","1534.31159643","0.262006753345"
"SL2.50ch11:18737416-18738053","22","18737416","18738053","637","1534.31159643","0.415169905175"
"SL2.50ch11:18832189-18832905","1","18832189","18832905","716","1534.31159643","0.466658794514"
"SL2.50ch11:19502071-19502648","6","19502071","19502648","577","1534.31159643","0.376064419601"
"SL2.50ch11:19929961-19930336","1","19929961","19930336","375","1534.31159643","0.244409284836"
"SL2.50ch11:2007312-2007887","22","2007312","2007887","575","1534.31159643","0.374760903416"
"SL2.50ch11:2007316-2007852","22","2007316","2007852","536","1534.31159643","0.349342337793"
"SL2.50ch11:20225229-20225817","6","20225229","20225817","588","1534.31159643","0.383233758623"
"SL2.50ch11:20288855-20289934","7","20288855","20289934","1079","1534.31159643","0.703246982236"
"SL2.50ch11:20415748-20416757","10","20415748","20416757","1009","1534.31159643","0.657623915733"
"SL2.50ch11:20415783-20416678","10","20415783","20416678","895","1534.31159643","0.583323493143"
"SL2.50ch11:20418887-20423089","175","20418887","20423089","4202","1534.31159643","2.73868750635"
"SL2.50ch11:20419051-20420293","42","20419051","20420293","1242","1534.31159643","0.809483551378"
"SL2.50ch11:20421557-20423119","127","20421557","20423119","1562","1534.31159643","1.0180461411"
"SL2.50ch11:20424366-20425295","33","20424366","20425295","929","1534.31159643","0.605483268301"
"SL2.50ch11:20424477-20425114","30","20424477","20425114","637","1534.31159643","0.415169905175"
"SL2.50ch11:20739247-20741244","17","20739247","20741244","1997","1534.31159643","1.30156091152"
"SL2.50ch11:20748465-20751023","20","20748465","20751023","2558","1534.31159643","1.66719720163"
"SL2.50ch11:20757194-20758479","11","20757194","20758479","1285","1534.31159643","0.837509149372"
"SL2.50ch11:20780226-20780694","2","20780226","20780694","468","1534.31159643","0.305022787476"
"SL2.50ch11:20785382-20786849","8","20785382","20786849","1467","1534.31159643","0.95612912228"
"SL2.50ch11:20798932-20803403","41","20798932","20803403","4471","1534.31159643","2.91401043334"
"SL2.50ch11:20806121-20808163","11","20806121","20808163","2042","1534.31159643","1.3308900257"
"SL2.50ch11:20813461-20813929","1","20813461","20813929","468","1534.31159643","0.305022787476"
"SL2.50ch11:20815127-20817429","9","20815127","20817429","2302","1534.31159643","1.50034712985"
"SL2.50ch11:20827370-20828506","10","20827370","20828506","1136","1534.31159643","0.740397193531"
"SL2.50ch11:20832239-20833742","16","20832239","20833742","1503","1534.31159643","0.979592413624"
"SL2.50ch11:20837860-20838896","6","20837860","20838896","1036","1534.31159643","0.675221384241"
"SL2.50ch11:20852200-20854359","17","20852200","20854359","2159","1534.31159643","1.40714572256"
"SL2.50ch11:21922290-21923240","17","21922290","21923240","950","1534.31159643","0.619170188252"
"SL2.50ch11:21922554-21923164","17","21922554","21923164","610","1534.31159643","0.397572436667"
"SL2.50ch11:22100621-22101537","6","22100621","22101537","916","1534.31159643","0.597010413094"
"SL2.50ch11:22560259-22560775","1","22560259","22560775","516","1534.31159643","0.336307175935"
"SL2.50ch11:23444510-23445113","2","23444510","23445113","603","1534.31159643","0.393010130017"
"SL2.50ch11:23447891-23448359","8","23447891","23448359","468","1534.31159643","0.305022787476"
"SL2.50ch11:23568763-23569351","11","23568763","23569351","588","1534.31159643","0.383233758623"
"SL2.50ch11:23839039-23840321","13","23839039","23840321","1282","1534.31159643","0.835553875094"
"SL2.50ch11:24012739-24014300","23","24012739","24014300","1561","1534.31159643","1.01739438301"
"SL2.50ch11:25050976-25051804","9","25050976","25051804","828","1534.31159643","0.539655700919"
"SL2.50ch11:25598236-25599066","6","25598236","25599066","830","1534.31159643","0.540959217104"
"SL2.50ch11:27896435-27896908","6","27896435","27896908","473","1534.31159643","0.30828157794"
"SL2.50ch11:28162925-28163513","5","28162925","28163513","588","1534.31159643","0.383233758623"
"SL2.50ch11:28248242-28248617","3","28248242","28248617","375","1534.31159643","0.244409284836"
"SL2.50ch11:28532238-28532809","5","28532238","28532809","571","1534.31159643","0.372153871044"
"SL2.50ch11:28734035-28734410","2","28734035","28734410","375","1534.31159643","0.244409284836"
"SL2.50ch11:30178500-30179077","1","30178500","30179077","577","1534.31159643","0.376064419601"
"SL2.50ch11:30180392-30180860","5","30180392","30180860","468","1534.31159643","0.305022787476"
"SL2.50ch11:30598125-30598615","62","30598125","30598615","490","1534.31159643","0.319361465519"
"SL2.50ch11:30742549-30743611","28","30742549","30743611","1062","1534.31159643","0.692167094656"
"SL2.50ch11:30742846-30743467","23","30742846","30743467","621","1534.31159643","0.404741775689"
"SL2.50ch11:30981366-30982622","6","30981366","30982622","1256","1534.31159643","0.818608164678"
"SL2.50ch11:31073478-31074322","2","31073478","31074322","844","1534.31159643","0.550083830405"
"SL2.50ch11:31298298-31298916","93","31298298","31298916","618","1534.31159643","0.40278650141"
"SL2.50ch11:31298333-31298901","93","31298333","31298901","568","1534.31159643","0.370198596765"
"SL2.50ch11:31585927-31587699","147","31585927","31587699","1772","1534.31159643","1.15491534061"
"SL2.50ch11:31585967-31587668","147","31585967","31587668","1701","1534.31159643","1.10864051602"
"SL2.50ch11:32406457-32407315","22","32406457","32407315","858","1534.31159643","0.559208443706"
"SL2.50ch11:32409607-32410111","12","32409607","32410111","504","1534.31159643","0.32848607882"
"SL2.50ch11:32416170-32416840","11","32416170","32416840","670","1534.31159643","0.436677922241"
"SL2.50ch11:32423926-32426840","505","32423926","32426840","2914","1534.31159643","1.8992230827"
"SL2.50ch11:32424004-32426786","505","32424004","32426786","2782","1534.31159643","1.81319101444"
"SL2.50ch11:33038626-33039160","21","33038626","33039160","534","1534.31159643","0.348038821607"
"SL2.50ch11:33038657-33039160","21","33038657","33039160","503","1534.31159643","0.327834320727"
"SL2.50ch11:34486737-34487207","2","34486737","34487207","470","1534.31159643","0.306326303662"
"SL2.50ch11:35491059-35491540","1","35491059","35491540","481","1534.31159643","0.313495642683"
"SL2.50ch11:36180587-36180962","9","36180587","36180962","375","1534.31159643","0.244409284836"
"SL2.50ch11:36311075-36311560","6","36311075","36311560","485","1534.31159643","0.316102675055"
"SL2.50ch11:37254852-37255227","1","37254852","37255227","375","1534.31159643","0.244409284836"
"SL2.50ch11:37661451-37661826","1","37661451","37661826","375","1534.31159643","0.244409284836"
"SL2.50ch11:37707177-37707552","1","37707177","37707552","375","1534.31159643","0.244409284836"
"SL2.50ch11:37761667-37762042","7","37761667","37762042","375","1534.31159643","0.244409284836"
"SL2.50ch11:38194523-38196143","28","38194523","38196143","1620","1534.31159643","1.05584811049"
"SL2.50ch11:38768420-38769019","1","38768420","38769019","599","1534.31159643","0.390403097645"
"SL2.50ch11:38960517-38961881","6","38960517","38961881","1364","1534.31159643","0.888998038711"
"SL2.50ch11:39472431-39472806","5","39472431","39472806","375","1534.31159643","0.244409284836"
"SL2.50ch11:40317148-40320530","347","40317148","40320530","3382","1534.31159643","2.20424587018"
"SL2.50ch11:40317234-40320467","347","40317234","40320467","3233","1534.31159643","2.10713391434"
"SL2.50ch11:40957143-40957785","2","40957143","40957785","642","1534.31159643","0.41842869564"
"SL2.50ch11:41400250-41400963","13","41400250","41400963","713","1534.31159643","0.464703520235"
"SL2.50ch11:42695683-42696164","5","42695683","42696164","481","1534.31159643","0.313495642683"
"SL2.50ch11:42792157-42792858","11","42792157","42792858","701","1534.31159643","0.456882423121"
"SL2.50ch11:42918205-42918703","21","42918205","42918703","498","1534.31159643","0.324575530263"
"SL2.50ch11:42918270-42918772","22","42918270","42918772","502","1534.31159643","0.327182562634"
"SL2.50ch11:43122296-43122671","2","43122296","43122671","375","1534.31159643","0.244409284836"
"SL2.50ch11:43658586-43659072","1","43658586","43659072","486","1534.31159643","0.316754433148"
"SL2.50ch11:44956600-44957298","6","44956600","44957298","698","1534.31159643","0.454927148842"
"SL2.50ch11:44961553-44962410","8","44961553","44962410","857","1534.31159643","0.558556685613"
"SL2.50ch11:45009815-45010925","7","45009815","45010925","1110","1534.31159643","0.723451483116"
"SL2.50ch11:45022509-45022978","1","45022509","45022978","469","1534.31159643","0.305674545569"
"SL2.50ch11:45027784-45028326","3","45027784","45028326","542","1534.31159643","0.35325288635"
"SL2.50ch11:45233322-45239721","781","45233322","45239721","6399","1534.31159643","4.17060003645"
"SL2.50ch11:45233611-45239698","781","45233611","45239698","6087","1534.31159643","3.96725151146"
"SL2.50ch11:45246230-45248244","216","45246230","45248244","2014","1534.31159643","1.31264079909"
"SL2.50ch11:45246271-45248409","216","45246271","45248409","2138","1534.31159643","1.39345880261"
"SL2.50ch11:45250531-45251283","178","45250531","45251283","752","1534.31159643","0.490122085858"
"SL2.50ch11:45250610-45251298","177","45250610","45251298","688","1534.31159643","0.448409567913"
"SL2.50ch11:45252807-45254478","196","45252807","45254478","1671","1534.31159643","1.08908777323"
"SL2.50ch11:45252841-45254425","190","45252841","45254425","1584","1534.31159643","1.03238481915"
"SL2.50ch11:45255681-45260487","602","45255681","45260487","4806","1534.31159643","3.13234939446"
"SL2.50ch11:45255682-45260461","602","45255682","45260461","4779","1534.31159643","3.11475192595"
"SL2.50ch11:45336898-45338922","276","45336898","45338922","2024","1534.31159643","1.31915838002"
"SL2.50ch11:45336998-45338797","274","45336998","45338797","1799","1534.31159643","1.17251280912"
"SL2.50ch11:45339523-45342194","227","45339523","45342194","2671","1534.31159643","1.74084586613"
"SL2.50ch11:45339954-45342124","222","45339954","45342124","2170","1534.31159643","1.41431506159"
"SL2.50ch11:45343872-45345788","224","45343872","45345788","1916","1534.31159643","1.24876850599"
"SL2.50ch11:45343920-45345749","221","45343920","45345749","1829","1534.31159643","1.19206555191"
"SL2.50ch11:45350079-45351514","142","45350079","45351514","1435","1534.31159643","0.935272863307"
"SL2.50ch11:45350094-45351490","142","45350094","45351490","1396","1534.31159643","0.909854297684"
"SL2.50ch11:45354466-45356001","163","45354466","45356001","1535","1534.31159643","1.0004486726"
"SL2.50ch11:45354488-45356004","163","45354488","45356004","1516","1534.31159643","0.988065268832"
"SL2.50ch11:45357881-45358722","63","45357881","45358722","841","1534.31159643","0.548128556126"
"SL2.50ch11:45357909-45358712","63","45357909","45358712","803","1534.31159643","0.523361748596"
"SL2.50ch11:45363862-45368020","618","45363862","45368020","4158","1534.31159643","2.71001015027"
"SL2.50ch11:45363948-45368134","617","45363948","45368134","4186","1534.31159643","2.72825937687"
"SL2.50ch11:45371051-45372719","109","45371051","45372719","1668","1534.31159643","1.08713249895"
"SL2.50ch11:45371067-45372307","106","45371067","45372307","1240","1534.31159643","0.808180035192"
"SL2.50ch11:45374326-45377827","385","45374326","45377827","3501","1534.31159643","2.28180508323"
"SL2.50ch11:45374344-45377693","385","45374344","45377693","3349","1534.31159643","2.18273785311"
"SL2.50ch11:45386703-45388297","224","45386703","45388297","1594","1534.31159643","1.03890240008"
"SL2.50ch11:45386738-45388227","221","45386738","45388227","1489","1534.31159643","0.970467800323"
"SL2.50ch11:45390128-45391152","128","45390128","45391152","1024","1534.31159643","0.667400287126"
"SL2.50ch11:45390135-45391197","128","45390135","45391197","1062","1534.31159643","0.692167094656"
"SL2.50ch11:45392566-45394336","127","45392566","45394336","1770","1534.31159643","1.15361182443"
"SL2.50ch11:45392780-45394226","122","45392780","45394226","1446","1534.31159643","0.942442202329"
"SL2.50ch11:45396292-45396782","17","45396292","45396782","490","1534.31159643","0.319361465519"
"SL2.50ch11:45397271-45397986","82","45397271","45397986","715","1534.31159643","0.466007036421"
"SL2.50ch11:45400835-45401237","5","45400835","45401237","402","1534.31159643","0.262006753345"
"SL2.50ch11:45400835-45401304","5","45400835","45401304","469","1534.31159643","0.305674545569"
"SL2.50ch11:45403889-45404808","13","45403889","45404808","919","1534.31159643","0.598965687372"
"SL2.50ch11:45403903-45404547","13","45403903","45404547","644","1534.31159643","0.419732211826"
"SL2.50ch11:45406044-45406720","11","45406044","45406720","676","1534.31159643","0.440588470798"
"SL2.50ch11:45406107-45406635","11","45406107","45406635","528","1534.31159643","0.34412827305"
"SL2.50ch11:45411470-45413031","146","45411470","45413031","1561","1534.31159643","1.01739438301"
"SL2.50ch11:45411477-45413071","146","45411477","45413071","1594","1534.31159643","1.03890240008"
"SL2.50ch11:45417254-45418460","54","45417254","45418460","1206","1534.31159643","0.786020260034"
"SL2.50ch11:45417317-45418319","51","45417317","45418319","1002","1534.31159643","0.653061609083"
"SL2.50ch11:45422580-45423774","119","45422580","45423774","1194","1534.31159643","0.778199162919"
"SL2.50ch11:45422586-45423618","119","45422586","45423618","1032","1534.31159643","0.67261435187"
"SL2.50ch11:45440165-45440879","47","45440165","45440879","714","1534.31159643","0.465355278328"
"SL2.50ch11:45440169-45441052","48","45440169","45441052","883","1534.31159643","0.575502396028"
"SL2.50ch11:45444323-45444945","32","45444323","45444945","622","1534.31159643","0.405393533782"
"SL2.50ch11:45444356-45444858","32","45444356","45444858","502","1534.31159643","0.327182562634"
"SL2.50ch11:45446552-45449056","232","45446552","45449056","2504","1534.31159643","1.63200226461"
"SL2.50ch11:45446644-45449027","227","45446644","45449027","2383","1534.31159643","1.55313953537"
"SL2.50ch11:45450191-45451961","92","45450191","45451961","1770","1534.31159643","1.15361182443"
"SL2.50ch11:45450196-45452029","92","45450196","45452029","1833","1534.31159643","1.19467258428"
"SL2.50ch11:45459797-45460432","86","45459797","45460432","635","1534.31159643","0.41386638899"
"SL2.50ch11:45459803-45460439","86","45459803","45460439","636","1534.31159643","0.414518147082"
"SL2.50ch11:45461227-45462145","74","45461227","45462145","918","1534.31159643","0.598313929279"
"SL2.50ch11:45461260-45462081","74","45461260","45462081","821","1534.31159643","0.535093394268"
"SL2.50ch11:45463519-45465554","144","45463519","45465554","2035","1534.31159643","1.32632771905"
"SL2.50ch11:45463548-45465554","144","45463548","45465554","2006","1534.31159643","1.30742673435"
"SL2.50ch11:45475461-45476498","31","45475461","45476498","1037","1534.31159643","0.675873142334"
"SL2.50ch11:45475497-45476105","30","45475497","45476105","608","1534.31159643","0.396268920481"
"SL2.50ch11:45556112-45556600","2","45556112","45556600","488","1534.31159643","0.318057949334"
"SL2.50ch11:45560372-45561169","3","45560372","45561169","797","1534.31159643","0.519451200039"
"SL2.50ch11:45581334-45581709","3","45581334","45581709","375","1534.31159643","0.244409284836"
"SL2.50ch11:45626619-45626994","2","45626619","45626994","375","1534.31159643","0.244409284836"
"SL2.50ch11:45864853-45865441","1","45864853","45865441","588","1534.31159643","0.383233758623"
"SL2.50ch11:48465837-48466212","2","48465837","48466212","375","1534.31159643","0.244409284836"
"SL2.50ch11:48691951-48692326","9","48691951","48692326","375","1534.31159643","0.244409284836"
"SL2.50ch11:48717882-48719513","199","48717882","48719513","1631","1534.31159643","1.06301744951"
"SL2.50ch11:48717894-48719621","199","48717894","48719621","1727","1534.31159643","1.12558622643"
"SL2.50ch11:48869778-48870955","362","48869778","48870955","1177","1534.31159643","0.76711927534"
"SL2.50ch11:48869826-48871305","362","48869826","48871305","1479","1534.31159643","0.963950219394"
"SL2.50ch11:48874032-48874407","2","48874032","48874407","375","1534.31159643","0.244409284836"
"SL2.50ch11:48951925-48952408","3","48951925","48952408","483","1534.31159643","0.314799158869"
"SL2.50ch11:49617710-49620670","272","49617710","49620670","2960","1534.31159643","1.92920395497"
"SL2.50ch11:49617835-49625590","715","49617835","49625590","7755","1534.31159643","5.05438401042"
"SL2.50ch11:49621245-49625665","437","49621245","49625665","4420","1534.31159643","2.8807707706"
"SL2.50ch11:49629321-49636174","560","49629321","49636174","6853","1534.31159643","4.46649821062"
"SL2.50ch11:49629371-49631187","145","49629371","49631187","1816","1534.31159643","1.1835926967"
"SL2.50ch11:49632467-49633328","105","49632467","49633328","861","1534.31159643","0.561163717984"
"SL2.50ch11:49633983-49636026","271","49633983","49636026","2043","1534.31159643","1.33154178379"
"SL2.50ch11:49638648-49644092","203","49638648","49644092","5444","1534.31159643","3.54817105773"
"SL2.50ch11:49638816-49640638","109","49638816","49640638","1822","1534.31159643","1.18750324526"
"SL2.50ch11:49641566-49642532","48","49641566","49642532","966","1534.31159643","0.629598317738"
"SL2.50ch11:49643051-49643844","27","49643051","49643844","793","1534.31159643","0.516844167667"
"SL2.50ch11:49647978-49649592","135","49647978","49649592","1614","1534.31159643","1.05193756194"
"SL2.50ch11:49648420-49649437","132","49648420","49649437","1017","1534.31159643","0.662837980476"
"SL2.50ch11:50256207-50256968","113","50256207","50256968","761","1534.31159643","0.495987908695"
"SL2.50ch11:50256234-50256904","113","50256234","50256904","670","1534.31159643","0.436677922241"
"SL2.50ch11:50269930-50270332","3","50269930","50270332","402","1534.31159643","0.262006753345"
"SL2.50ch11:50794388-50795063","9","50794388","50795063","675","1534.31159643","0.439936712705"
"SL2.50ch11:50794510-50795000","9","50794510","50795000","490","1534.31159643","0.319361465519"
"SL2.50ch11:51013007-51013677","2","51013007","51013677","670","1534.31159643","0.436677922241"
"SL2.50ch11:51640950-51641426","5","51640950","51641426","476","1534.31159643","0.310236852219"
"SL2.50ch11:51640969-51641482","5","51640969","51641482","513","1534.31159643","0.334351901656"
"SL2.50ch11:53074910-53075381","9","53074910","53075381","471","1534.31159643","0.306978061754"
"SL2.50ch11:53587494-53587869","3","53587494","53587869","375","1534.31159643","0.244409284836"
"SL2.50ch11:55434577-55435600","9","55434577","55435600","1023","1534.31159643","0.666748529034"
"SL2.50ch11:55434683-55435658","10","55434683","55435658","975","1534.31159643","0.635464140574"
"SL2.50ch11:5768911-5769313","6","5768911","5769313","402","1534.31159643","0.262006753345"
"SL2.50ch11:7156086-7156752","9","7156086","7156752","666","1534.31159643","0.434070889869"
"SL2.50ch11:7156309-7156711","8","7156309","7156711","402","1534.31159643","0.262006753345"
"SL2.50ch11:7159693-7160095","13","7159693","7160095","402","1534.31159643","0.262006753345"
"SL2.50ch11:7159713-7160182","13","7159713","7160182","469","1534.31159643","0.305674545569"
"SL2.50ch11:8237824-8238485","8","8237824","8238485","661","1534.31159643","0.430812099405"
"SL2.50ch11:8470492-8472596","37","8470492","8472596","2104","1534.31159643","1.37129902746"
"SL2.50ch11:8470516-8472378","37","8470516","8472378","1862","1534.31159643","1.21357356897"
"SL2.50ch11:8479927-8480850","10","8479927","8480850","923","1534.31159643","0.601572719744"
"SL2.50ch11:8488520-8488993","2","8488520","8488993","473","1534.31159643","0.30828157794"
"SL2.50ch11:8509929-8510717","12","8509929","8510717","788","1534.31159643","0.513585377203"
"SL2.50ch11:8509954-8510688","12","8509954","8510688","734","1534.31159643","0.478390440186"
"SL2.50ch11:8517008-8517476","3","8517008","8517476","468","1534.31159643","0.305022787476"
"SL2.50ch11:9484220-9484969","7","9484220","9484969","749","1534.31159643","0.48816681158"
"SL2.50ch12:11125600-11126165","24","11125600","11126165","565","1534.31159643","0.368243322487"
"SL2.50ch12:11702022-11702636","6","11702022","11702636","614","1534.31159643","0.400179469039"
"SL2.50ch12:12049577-12050049","6","12049577","12050049","472","1534.31159643","0.307629819847"
"SL2.50ch12:12502481-12502856","5","12502481","12502856","375","1534.31159643","0.244409284836"
"SL2.50ch12:1281241-1282093","195","1281241","1282093","852","1534.31159643","0.555297895148"
"SL2.50ch12:1281255-1282012","195","1281255","1282012","757","1534.31159643","0.493380876323"
"SL2.50ch12:13093684-13094156","2","13093684","13094156","472","1534.31159643","0.307629819847"
"SL2.50ch12:13250747-13251330","9","13250747","13251330","583","1534.31159643","0.379974968159"
"SL2.50ch12:13409476-13410083","1","13409476","13410083","607","1534.31159643","0.395617162388"
"SL2.50ch12:15633989-15634957","9","15633989","15634957","968","1534.31159643","0.630901833924"
"SL2.50ch12:16497032-16498359","22","16497032","16498359","1327","1534.31159643","0.864882989274"
"SL2.50ch12:16584261-16584887","4","16584261","16584887","626","1534.31159643","0.408000566153"
"SL2.50ch12:16612583-16613064","10","16612583","16613064","481","1534.31159643","0.313495642683"
"SL2.50ch12:17016267-17017171","4","17016267","17017171","904","1534.31159643","0.589189315979"
"SL2.50ch12:17284165-17285287","19","17284165","17285287","1122","1534.31159643","0.73127258023"
"SL2.50ch12:17316112-17316705","8","17316112","17316705","593","1534.31159643","0.386492549088"
"SL2.50ch12:17330786-17334032","43","17330786","17334032","3246","1534.31159643","2.11560676954"
"SL2.50ch12:17335049-17335912","13","17335049","17335912","863","1534.31159643","0.56246723417"
"SL2.50ch12:17336362-17340703","37","17336362","17340703","4341","1534.31159643","2.82928188127"
"SL2.50ch12:17343133-17343956","12","17343133","17343956","823","1534.31159643","0.536396910454"
"SL2.50ch12:17344734-17347336","26","17344734","17347336","2602","1534.31159643","1.69587455772"
"SL2.50ch12:17369690-17375684","60","17369690","17375684","5994","1534.31159643","3.90663800882"
"SL2.50ch12:17454017-17455033","13","17454017","17455033","1016","1534.31159643","0.662186222383"
"SL2.50ch12:17462286-17463613","12","17462286","17463613","1327","1534.31159643","0.864882989274"
"SL2.50ch12:17462782-17463618","10","17462782","17463618","836","1534.31159643","0.544869765662"
"SL2.50ch12:17468858-17470321","62","17468858","17470321","1463","1534.31159643","0.953522089908"
"SL2.50ch12:17469011-17470277","61","17469011","17470277","1266","1534.31159643","0.825125745607"
"SL2.50ch12:17570240-17573194","24","17570240","17573194","2954","1534.31159643","1.92529340642"
"SL2.50ch12:17570388-17571221","11","17570388","17571221","833","1534.31159643","0.542914491383"
"SL2.50ch12:17582615-17583813","38","17582615","17583813","1198","1534.31159643","0.78080619529"
"SL2.50ch12:17582628-17583817","38","17582628","17583817","1189","1534.31159643","0.774940372454"
"SL2.50ch12:17584490-17586478","49","17584490","17586478","1988","1534.31159643","1.29569508868"
"SL2.50ch12:17584580-17586620","51","17584580","17586620","2040","1534.31159643","1.32958650951"
"SL2.50ch12:17593329-17593704","2","17593329","17593704","375","1534.31159643","0.244409284836"
"SL2.50ch12:17598661-17599862","14","17598661","17599862","1201","1534.31159643","0.782761469569"
"SL2.50ch12:17598690-17599092","11","17598690","17599092","402","1534.31159643","0.262006753345"
"SL2.50ch12:17600360-17602099","22","17600360","17602099","1739","1534.31159643","1.13340732355"
"SL2.50ch12:17605325-17606548","8","17605325","17606548","1223","1534.31159643","0.797100147613"
"SL2.50ch12:17770873-17771640","1","17770873","17771640","767","1534.31159643","0.499898457252"
"SL2.50ch12:19410326-19411466","4","19410326","19411466","1140","1534.31159643","0.743004225902"
"SL2.50ch12:20029637-20030318","2","20029637","20030318","681","1534.31159643","0.443847261263"
"SL2.50ch12:20970666-20971159","0","20970666","20971159","493","1534.31159643","0.321316739798"
"SL2.50ch12:21136812-21137445","5","21136812","21137445","633","1534.31159643","0.412562872804"
"SL2.50ch12:21139397-21144310","37","21139397","21144310","4913","1534.31159643","3.2020875104"
"SL2.50ch12:21395345-21396276","13","21395345","21396276","931","1534.31159643","0.606786784487"
"SL2.50ch12:22083326-22083847","3","22083326","22083847","521","1534.31159643","0.339565966399"
"SL2.50ch12:22466405-22470000","78","22466405","22470000","3595","1534.31159643","2.34307034396"
"SL2.50ch12:22467023-22469411","69","22467023","22469411","2388","1534.31159643","1.55639832584"
"SL2.50ch12:22471365-22472124","25","22471365","22472124","759","1534.31159643","0.494684392509"
"SL2.50ch12:22471532-22472141","23","22471532","22472141","609","1534.31159643","0.396920678574"
"SL2.50ch12:22476830-22479067","52","22476830","22479067","2237","1534.31159643","1.45798285381"
"SL2.50ch12:22476972-22477998","51","22476972","22477998","1026","1534.31159643","0.668703803312"
"SL2.50ch12:22568860-22569567","9","22568860","22569567","707","1534.31159643","0.460792971678"
"SL2.50ch12:22571503-22572833","56","22571503","22572833","1330","1534.31159643","0.866838263553"
"SL2.50ch12:22571716-22572716","53","22571716","22572716","1000","1534.31159643","0.651758092897"
"SL2.50ch12:22575892-22577134","20","22575892","22577134","1242","1534.31159643","0.809483551378"
"SL2.50ch12:22575916-22577049","18","22575916","22577049","1133","1534.31159643","0.738441919252"
"SL2.50ch12:22587644-22589017","12","22587644","22589017","1373","1534.31159643","0.894863861547"
"SL2.50ch12:22587685-22588533","10","22587685","22588533","848","1534.31159643","0.552690862777"
"SL2.50ch12:22599424-22600377","38","22599424","22600377","953","1534.31159643","0.621125462531"
"SL2.50ch12:22607887-22609038","21","22607887","22609038","1151","1534.31159643","0.750173564924"
"SL2.50ch12:22609875-22611919","21","22609875","22611919","2044","1534.31159643","1.33219354188"
"SL2.50ch12:22619667-22621067","37","22619667","22621067","1400","1534.31159643","0.912461330056"
"SL2.50ch12:22619712-22621059","37","22619712","22621059","1347","1534.31159643","0.877918151132"
"SL2.50ch12:22622896-22624203","32","22622896","22624203","1307","1534.31159643","0.851847827416"
"SL2.50ch12:22622931-22624229","32","22622931","22624229","1298","1534.31159643","0.84598200458"
"SL2.50ch12:22626450-22627721","30","22626450","22627721","1271","1534.31159643","0.828384536072"
"SL2.50ch12:22626749-22627746","22","22626749","22627746","997","1534.31159643","0.649802818618"
"SL2.50ch12:22636213-22637123","26","22636213","22637123","910","1534.31159643","0.593099864536"
"SL2.50ch12:22636416-22637156","26","22636416","22637156","740","1534.31159643","0.482300988744"
"SL2.50ch12:22638777-22640115","69","22638777","22640115","1338","1534.31159643","0.872052328296"
"SL2.50ch12:22638777-22640151","69","22638777","22640151","1374","1534.31159643","0.89551561964"
"SL2.50ch12:22640807-22641801","32","22640807","22641801","994","1534.31159643","0.647847544339"
"SL2.50ch12:22640877-22641692","29","22640877","22641692","815","1534.31159643","0.531182845711"
"SL2.50ch12:22642968-22644320","42","22642968","22644320","1352","1534.31159643","0.881176941597"
"SL2.50ch12:22642977-22644344","42","22642977","22644344","1367","1534.31159643","0.89095331299"
"SL2.50ch12:22647671-22649157","53","22647671","22649157","1486","1534.31159643","0.968512526045"
"SL2.50ch12:22647686-22649146","53","22647686","22649146","1460","1534.31159643","0.951566815629"
"SL2.50ch12:22653598-22653973","8","22653598","22653973","375","1534.31159643","0.244409284836"
"SL2.50ch12:22661664-22664212","34","22661664","22664212","2548","1534.31159643","1.6606796207"
"SL2.50ch12:22663015-22663628","4","22663015","22663628","613","1534.31159643","0.399527710946"
"SL2.50ch12:22698656-22699443","13","22698656","22699443","787","1534.31159643","0.51293361911"
"SL2.50ch12:22698712-22699544","13","22698712","22699544","832","1534.31159643","0.54226273329"
"SL2.50ch12:22729497-22736133","60","22729497","22736133","6636","1534.31159643","4.32506670446"
"SL2.50ch12:22756163-22757148","13","22756163","22757148","985","1534.31159643","0.641981721503"
"SL2.50ch12:22765306-22770404","77","22765306","22770404","5098","1534.31159643","3.32266275759"
"SL2.50ch12:22770993-22773736","33","22770993","22773736","2743","1534.31159643","1.78777244882"
"SL2.50ch12:22791466-22791841","1","22791466","22791841","375","1534.31159643","0.244409284836"
"SL2.50ch12:23358906-23359281","5","23358906","23359281","375","1534.31159643","0.244409284836"
"SL2.50ch12:24078701-24079560","162","24078701","24079560","859","1534.31159643","0.559860201798"
"SL2.50ch12:24169458-24169930","2","24169458","24169930","472","1534.31159643","0.307629819847"
"SL2.50ch12:26175653-26176028","4","26175653","26176028","375","1534.31159643","0.244409284836"
"SL2.50ch12:26321657-26322032","9","26321657","26322032","375","1534.31159643","0.244409284836"
"SL2.50ch12:26463352-26463727","6","26463352","26463727","375","1534.31159643","0.244409284836"
"SL2.50ch12:26867044-26867419","5","26867044","26867419","375","1534.31159643","0.244409284836"
"SL2.50ch12:27365076-27365798","3","27365076","27365798","722","1534.31159643","0.470569343072"
"SL2.50ch12:29229996-29231202","9","29229996","29231202","1206","1534.31159643","0.786020260034"
"SL2.50ch12:29494451-29494826","6","29494451","29494826","375","1534.31159643","0.244409284836"
"SL2.50ch12:30017705-30018208","42","30017705","30018208","503","1534.31159643","0.327834320727"
"SL2.50ch12:31058653-31059028","4","31058653","31059028","375","1534.31159643","0.244409284836"
"SL2.50ch12:3209901-3210407","5","3209901","3210407","506","1534.31159643","0.329789595006"
"SL2.50ch12:32393559-32395295","9","32393559","32395295","1736","1534.31159643","1.13145204927"
"SL2.50ch12:32491718-32492238","2","32491718","32492238","520","1534.31159643","0.338914208306"
"SL2.50ch12:32676301-32676676","3","32676301","32676676","375","1534.31159643","0.244409284836"
"SL2.50ch12:33401409-33401784","0","33401409","33401784","375","1534.31159643","0.244409284836"
"SL2.50ch12:33815406-33815808","23","33815406","33815808","402","1534.31159643","0.262006753345"
"SL2.50ch12:33827523-33828515","9","33827523","33828515","992","1534.31159643","0.646544028154"
"SL2.50ch12:33961197-33961572","2","33961197","33961572","375","1534.31159643","0.244409284836"
"SL2.50ch12:34179760-34180304","7","34179760","34180304","544","1534.31159643","0.354556402536"
"SL2.50ch12:34295103-34305798","197","34295103","34305798","10695","1534.31159643","6.97055280353"
"SL2.50ch12:34306193-34319398","219","34306193","34319398","13205","1534.31159643","8.6064656167"
"SL2.50ch12:35956067-35956540","0","35956067","35956540","473","1534.31159643","0.30828157794"
"SL2.50ch12:36092612-36136248","670","36092612","36136248","43636","1534.31159643","28.4401161416"
"SL2.50ch12:36147721-36149541","14","36147721","36149541","1820","1534.31159643","1.18619972907"
"SL2.50ch12:36168713-36169186","3","36168713","36169186","473","1534.31159643","0.30828157794"
"SL2.50ch12:36172679-36176703","38","36172679","36176703","4024","1534.31159643","2.62267456582"
"SL2.50ch12:36178209-36178584","6","36178209","36178584","375","1534.31159643","0.244409284836"
"SL2.50ch12:36179078-36182664","21","36179078","36182664","3586","1534.31159643","2.33720452113"
"SL2.50ch12:36192610-36197008","44","36192610","36197008","4398","1534.31159643","2.86643209256"
"SL2.50ch12:36197435-36198793","16","36197435","36198793","1358","1534.31159643","0.885087490154"
"SL2.50ch12:36213291-36218331","18","36213291","36218331","5040","1534.31159643","3.2848607882"
"SL2.50ch12:36218739-36219696","15","36218739","36219696","957","1534.31159643","0.623732494902"
"SL2.50ch12:36223379-36226257","11","36223379","36226257","2878","1534.31159643","1.87575979136"
"SL2.50ch12:36240623-36241559","14","36240623","36241559","936","1534.31159643","0.610045574951"
"SL2.50ch12:36242452-36243295","7","36242452","36243295","843","1534.31159643","0.549432072312"
"SL2.50ch12:36243674-36246207","13","36243674","36246207","2533","1534.31159643","1.65090324931"
"SL2.50ch12:36247013-36250322","32","36247013","36250322","3309","1534.31159643","2.1566675294"
"SL2.50ch12:37504894-37505472","6","37504894","37505472","578","1534.31159643","0.376716177694"
"SL2.50ch12:37679988-37680515","24","37679988","37680515","527","1534.31159643","0.343476514957"
"SL2.50ch12:37680016-37680506","24","37680016","37680506","490","1534.31159643","0.319361465519"
"SL2.50ch12:38096537-38098487","12","38096537","38098487","1950","1534.31159643","1.27092828115"
"SL2.50ch12:39449893-39450478","7","39449893","39450478","585","1534.31159643","0.381278484345"
"SL2.50ch12:42006160-42006629","1","42006160","42006629","469","1534.31159643","0.305674545569"
"SL2.50ch12:42325906-42326396","10","42325906","42326396","490","1534.31159643","0.319361465519"
"SL2.50ch12:42620046-42620621","6","42620046","42620621","575","1534.31159643","0.374760903416"
"SL2.50ch12:4279797-4283741","173","4279797","4283741","3944","1534.31159643","2.57053391839"
"SL2.50ch12:4279848-4283783","173","4279848","4283783","3935","1534.31159643","2.56466809555"
"SL2.50ch12:4296541-4297125","7","4296541","4297125","584","1534.31159643","0.380626726252"
"SL2.50ch12:4297709-4298629","7","4297709","4298629","920","1534.31159643","0.599617445465"
"SL2.50ch12:4300147-4301817","25","4300147","4301817","1670","1534.31159643","1.08843601514"
"SL2.50ch12:4302871-4303457","8","4302871","4303457","586","1534.31159643","0.381930242438"
"SL2.50ch12:4308732-4310108","7","4308732","4310108","1376","1534.31159643","0.896819135826"
"SL2.50ch12:4311879-4312254","12","4311879","4312254","375","1534.31159643","0.244409284836"
"SL2.50ch12:4328906-4330117","31","4328906","4330117","1211","1534.31159643","0.789279050498"
"SL2.50ch12:4335353-4336360","13","4335353","4336360","1007","1534.31159643","0.656320399547"
"SL2.50ch12:4350346-4351076","14","4350346","4351076","730","1534.31159643","0.475783407815"
"SL2.50ch12:4350355-4351379","15","4350355","4351379","1024","1534.31159643","0.667400287126"
"SL2.50ch12:45737991-45738393","13","45737991","45738393","402","1534.31159643","0.262006753345"
"SL2.50ch12:46125872-46126868","7","46125872","46126868","996","1534.31159643","0.649151060525"
"SL2.50ch12:48944674-48945049","3","48944674","48945049","375","1534.31159643","0.244409284836"
"SL2.50ch12:49282718-49283274","65","49282718","49283274","556","1534.31159643","0.362377499651"
"SL2.50ch12:49661847-49662603","149","49661847","49662603","756","1534.31159643","0.49272911823"
"SL2.50ch12:49661919-49662621","149","49661919","49662621","702","1534.31159643","0.457534181214"
"SL2.50ch12:49894365-49895056","7","49894365","49895056","691","1534.31159643","0.450364842192"
"SL2.50ch12:50172170-50173835","36","50172170","50173835","1665","1534.31159643","1.08517722467"
"SL2.50ch12:50172603-50173705","34","50172603","50173705","1102","1534.31159643","0.718237418372"
"SL2.50ch12:5094055-5094457","12","5094055","5094457","402","1534.31159643","0.262006753345"
"SL2.50ch12:51036441-51037152","2","51036441","51037152","711","1534.31159643","0.46340000405"
"SL2.50ch12:51038594-51038996","7","51038594","51038996","402","1534.31159643","0.262006753345"
"SL2.50ch12:51040250-51042235","51","51040250","51042235","1985","1534.31159643","1.2937398144"
"SL2.50ch12:51040466-51041177","30","51040466","51041177","711","1534.31159643","0.46340000405"
"SL2.50ch12:51041623-51042025","19","51041623","51042025","402","1534.31159643","0.262006753345"
"SL2.50ch12:51073475-51073965","8","51073475","51073965","490","1534.31159643","0.319361465519"
"SL2.50ch12:51073582-51074050","8","51073582","51074050","468","1534.31159643","0.305022787476"
"SL2.50ch12:51538054-51538685","6","51538054","51538685","631","1534.31159643","0.411259356618"
"SL2.50ch12:51538141-51538905","6","51538141","51538905","764","1534.31159643","0.497943182973"
"SL2.50ch12:51544216-51545827","18","51544216","51545827","1611","1534.31159643","1.04998228766"
"SL2.50ch12:51544315-51545030","16","51544315","51545030","715","1534.31159643","0.466007036421"
"SL2.50ch12:51597168-51597798","101","51597168","51597798","630","1534.31159643","0.410607598525"
"SL2.50ch12:51597234-51597796","101","51597234","51597796","562","1534.31159643","0.366288048208"
"SL2.50ch12:5192094-5192691","5","5192094","5192691","597","1534.31159643","0.389099581459"
"SL2.50ch12:5194273-5194840","3","5194273","5194840","567","1534.31159643","0.369546838673"
"SL2.50ch12:52831357-52831732","1","52831357","52831732","375","1534.31159643","0.244409284836"
"SL2.50ch12:52832186-52833138","13","52832186","52833138","952","1534.31159643","0.620473704438"
"SL2.50ch12:53994766-53995245","7","53994766","53995245","479","1534.31159643","0.312192126498"
"SL2.50ch12:54088521-54089007","0","54088521","54089007","486","1534.31159643","0.316754433148"
"SL2.50ch12:54256028-54257444","19","54256028","54257444","1416","1534.31159643","0.922889459542"
"SL2.50ch12:54273685-54274175","107","54273685","54274175","490","1534.31159643","0.319361465519"
"SL2.50ch12:54273746-54274315","109","54273746","54274315","569","1534.31159643","0.370850354858"
"SL2.50ch12:54304479-54305831","18","54304479","54305831","1352","1534.31159643","0.881176941597"
"SL2.50ch12:54315136-54316473","17","54315136","54316473","1337","1534.31159643","0.871400570203"
"SL2.50ch12:54318549-54319669","8","54318549","54319669","1120","1534.31159643","0.729969064045"
"SL2.50ch12:54672271-54672742","6","54672271","54672742","471","1534.31159643","0.306978061754"
"SL2.50ch12:55224550-55225126","15","55224550","55225126","576","1534.31159643","0.375412661509"
"SL2.50ch12:55224649-55225051","14","55224649","55225051","402","1534.31159643","0.262006753345"
"SL2.50ch12:55407597-55408072","5","55407597","55408072","475","1534.31159643","0.309585094126"
"SL2.50ch12:56908861-56910045","275","56908861","56910045","1184","1534.31159643","0.77168158199"
"SL2.50ch12:56909105-56910099","271","56909105","56910099","994","1534.31159643","0.647847544339"
"SL2.50ch12:57042969-57043783","19","57042969","57043783","814","1534.31159643","0.530531087618"
"SL2.50ch12:57552167-57553571","30","57552167","57553571","1404","1534.31159643","0.915068362427"
"SL2.50ch12:57600573-57601099","0","57600573","57601099","526","1534.31159643","0.342824756864"
"SL2.50ch12:57621664-57622367","11","57621664","57622367","703","1534.31159643","0.458185939307"
"SL2.50ch12:57621722-57622278","11","57621722","57622278","556","1534.31159643","0.362377499651"
"SL2.50ch12:58258318-58258901","10","58258318","58258901","583","1534.31159643","0.379974968159"
"SL2.50ch12:5831512-5832564","18","5831512","5832564","1052","1534.31159643","0.685649513728"
"SL2.50ch12:58814694-58815220","3","58814694","58815220","526","1534.31159643","0.342824756864"
"SL2.50ch12:59137510-59138124","68","59137510","59138124","614","1534.31159643","0.400179469039"
"SL2.50ch12:59550555-59551646","11","59550555","59551646","1091","1534.31159643","0.71106807935"
"SL2.50ch12:60389381-60390063","0","60389381","60390063","682","1534.31159643","0.444499019356"
"SL2.50ch12:60463834-60464740","8","60463834","60464740","906","1534.31159643","0.590492832165"
"SL2.50ch12:60486630-60488203","11","60486630","60488203","1573","1534.31159643","1.02521548013"
"SL2.50ch12:60490968-60492417","16","60490968","60492417","1449","1534.31159643","0.944397476608"
"SL2.50ch12:60515989-60519415","29","60515989","60519415","3426","1534.31159643","2.23292322626"
"SL2.50ch12:60519967-60520916","16","60519967","60520916","949","1534.31159643","0.618518430159"
"SL2.50ch12:60523099-60526344","16","60523099","60526344","3245","1534.31159643","2.11495501145"
"SL2.50ch12:60531411-60533781","18","60531411","60533781","2370","1534.31159643","1.54466668017"
"SL2.50ch12:60539242-60543562","42","60539242","60543562","4320","1534.31159643","2.81559496131"
"SL2.50ch12:60544224-60545183","8","60544224","60545183","959","1534.31159643","0.625036011088"
"SL2.50ch12:60545801-60574312","443","60545801","60574312","28511","1534.31159643","18.5822749866"
"SL2.50ch12:60626176-60631414","48","60626176","60631414","5238","1534.31159643","3.41390889059"
"SL2.50ch12:60697245-60717814","352","60697245","60717814","20569","1534.31159643","13.4060122128"
"SL2.50ch12:60709767-60717648","176","60709767","60717648","7881","1534.31159643","5.13650553012"
"SL2.50ch12:60718776-60737505","379","60718776","60737505","18729","1534.31159643","12.2067773219"
"SL2.50ch12:60736444-60737079","26","60736444","60737079","635","1534.31159643","0.41386638899"
"SL2.50ch12:60945362-60945951","1","60945362","60945951","589","1534.31159643","0.383885516716"
"SL2.50ch12:60947730-60949734","172","60947730","60949734","2004","1534.31159643","1.30612321817"
"SL2.50ch12:60947758-60951646","195","60947758","60951646","3888","1534.31159643","2.53403546518"
"SL2.50ch12:61002478-61005865","65","61002478","61005865","3387","1534.31159643","2.20750466064"
"SL2.50ch12:61003004-61005586","65","61003004","61005586","2582","1534.31159643","1.68283939586"
"SL2.50ch12:61476812-61480913","20","61476812","61480913","4101","1534.31159643","2.67285993897"
"SL2.50ch12:61617077-61618674","27","61617077","61618674","1597","1534.31159643","1.04085767436"
"SL2.50ch12:61625619-61633960","65","61625619","61633960","8341","1534.31159643","5.43631425285"
"SL2.50ch12:61636552-61659148","341","61636552","61659148","22596","1534.31159643","14.7271258671"
"SL2.50ch12:61650844-61651914","30","61650844","61651914","1070","1534.31159643","0.6973811594"
"SL2.50ch12:6204133-6204665","8","6204133","6204665","532","1534.31159643","0.346735305421"
"SL2.50ch12:6208324-6208892","7","6208324","6208892","568","1534.31159643","0.370198596765"
"SL2.50ch12:62260216-62260714","17","62260216","62260714","498","1534.31159643","0.324575530263"
"SL2.50ch12:62260226-62260716","17","62260226","62260716","490","1534.31159643","0.319361465519"
"SL2.50ch12:62670986-62673764","30","62670986","62673764","2778","1534.31159643","1.81058398207"
"SL2.50ch12:63804493-63805112","37","63804493","63805112","619","1534.31159643","0.403438259503"
"SL2.50ch12:63804577-63805144","37","63804577","63805144","567","1534.31159643","0.369546838673"
"SL2.50ch12:63885211-63885989","18","63885211","63885989","778","1534.31159643","0.507067796274"
"SL2.50ch12:63885246-63885736","16","63885246","63885736","490","1534.31159643","0.319361465519"
"SL2.50ch12:65405426-65406020","109","65405426","65406020","594","1534.31159643","0.387144307181"
"SL2.50ch12:65405486-65406101","109","65405486","65406101","615","1534.31159643","0.400831227132"
"SL2.50ch12:65636064-65636966","291","65636064","65636966","902","1534.31159643","0.587885799793"
"SL2.50ch12:65636113-65636817","291","65636113","65636817","704","1534.31159643","0.458837697399"
"SL2.50ch12:65736494-65739214","36","65736494","65739214","2720","1534.31159643","1.77278201268"
"SL2.50ch12:65737654-65738267","20","65737654","65738267","613","1534.31159643","0.399527710946"
"SL2.50ch12:65744928-65745598","27","65744928","65745598","670","1534.31159643","0.436677922241"
"SL2.50ch12:65745102-65745592","26","65745102","65745592","490","1534.31159643","0.319361465519"
"SL2.50ch12:7262949-7263680","9","7262949","7263680","731","1534.31159643","0.476435165908"
"SL2.50ch12:7358547-7359341","165","7358547","7359341","794","1534.31159643","0.51749592576"
"SL2.50ch12:7358570-7359322","165","7358570","7359322","752","1534.31159643","0.490122085858"
"SL2.50ch12:8135988-8136573","6","8135988","8136573","585","1534.31159643","0.381278484345"
"SL2.50ch12:870448-871151","41","870448","871151","703","1534.31159643","0.458185939307"
"SL2.50ch12:870453-871063","41","870453","871063","610","1534.31159643","0.397572436667"
"SL2.50ch12:8743223-8743799","1","8743223","8743799","576","1534.31159643","0.375412661509"
"SL2.50ch12:8853115-8853588","15","8853115","8853588","473","1534.31159643","0.30828157794"
"SL2.50ch12:9622181-9623979","12","9622181","9623979","1798","1534.31159643","1.17186105103"
"SL2.50ch12:9687502-9687877","2","9687502","9687877","375","1534.31159643","0.244409284836"
