"Read","Counts","Read Position Start","Read Position End","Read Size (rs)","Mean Read Size (mrs)","mrs/rs"
"SL2.50ch00:10005141-10011112","3309","10005141","10011112","5971","1336.01441019","4.46926317147"
"SL2.50ch00:10065487-10066763","538","10065487","10066763","1276","1336.01441019","0.955079518806"
"SL2.50ch00:10068907-10069554","240","10068907","10069554","647","1336.01441019","0.484276213689"
"SL2.50ch00:10077002-10077940","329","10077002","10077940","938","1336.01441019","0.702088235611"
"SL2.50ch00:10083677-10084008","175","10083677","10084008","331","1336.01441019","0.24775181875"
"SL2.50ch00:10083717-10084121","211","10083717","10084121","404","1336.01441019","0.302391947961"
"SL2.50ch00:10087141-10087522","73","10087141","10087522","381","1336.01441019","0.285176564785"
"SL2.50ch00:10091503-10092106","216","10091503","10092106","603","1336.01441019","0.451342437179"
"SL2.50ch00:10093140-10093724","225","10093140","10093724","584","1336.01441019","0.437121033686"
"SL2.50ch00:10103496-10104116","326","10103496","10104116","620","1336.01441019","0.464066850831"
"SL2.50ch00:10105984-10106392","137","10105984","10106392","408","1336.01441019","0.305385927643"
"SL2.50ch00:10108110-10108526","204","10108110","10108526","416","1336.01441019","0.311373887009"
"SL2.50ch00:10111024-10111355","98","10111024","10111355","331","1336.01441019","0.24775181875"
"SL2.50ch00:10117335-10118295","394","10117335","10118295","960","1336.01441019","0.718555123867"
"SL2.50ch00:10120087-10122222","679","10120087","10122222","2135","1336.01441019","1.59803665568"
"SL2.50ch00:10120718-10122214","536","10120718","10122214","1496","1336.01441019","1.11974840136"
"SL2.50ch00:10152460-10155800","975","10152460","10155800","3340","1336.01441019","2.49997303512"
"SL2.50ch00:10152754-10155689","905","10152754","10155689","2935","1336.01441019","2.19683259224"
"SL2.50ch00:10157628-10158609","271","10157628","10158609","981","1336.01441019","0.734273517201"
"SL2.50ch00:10157650-10158569","270","10157650","10158569","919","1336.01441019","0.687866832118"
"SL2.50ch00:10272221-10272832","405","10272221","10272832","611","1336.01441019","0.457330396544"
"SL2.50ch00:10279819-10280479","274","10279819","10280479","660","1336.01441019","0.494006647658"
"SL2.50ch00:10289422-10289901","226","10289422","10289901","479","1336.01441019","0.358529067013"
"SL2.50ch00:10290736-10291286","177","10290736","10291286","550","1336.01441019","0.411672206382"
"SL2.50ch00:10291703-10292158","222","10291703","10292158","455","1336.01441019","0.340565188916"
"SL2.50ch00:10297595-10298546","693","10297595","10298546","951","1336.01441019","0.71181866958"
"SL2.50ch00:10297703-10298485","669","10297703","10298485","782","1336.01441019","0.585323027983"
"SL2.50ch00:10299741-10300252","229","10299741","10300252","511","1336.01441019","0.382480904475"
"SL2.50ch00:10302592-10303453","294","10302592","10303453","861","1336.01441019","0.644454126718"
"SL2.50ch00:10307193-10307574","117","10307193","10307574","381","1336.01441019","0.285176564785"
"SL2.50ch00:10312875-10313412","278","10312875","10313412","537","1336.01441019","0.401941772413"
"SL2.50ch00:10399107-10400823","1238","10399107","10400823","1716","1336.01441019","1.28441728391"
"SL2.50ch00:10399126-10400773","1238","10399126","10400773","1647","1336.01441019","1.23277113438"
"SL2.50ch00:10401962-10403570","1741","10401962","10403570","1608","1336.01441019","1.20357983248"
"SL2.50ch00:10402022-10403589","1737","10402022","10403589","1567","1336.01441019","1.17289154073"
"SL2.50ch00:10405120-10406139","476","10405120","10406139","1019","1336.01441019","0.762716324188"
"SL2.50ch00:10410732-10412157","1062","10410732","10412157","1425","1336.01441019","1.06660526199"
"SL2.50ch00:10413931-10414420","219","10413931","10414420","489","1336.01441019","0.36601401622"
"SL2.50ch00:10421271-10422036","342","10421271","10422036","765","1336.01441019","0.572598614331"
"SL2.50ch00:10421325-10421900","304","10421325","10421900","575","1336.01441019","0.430384579399"
"SL2.50ch00:10423992-10424622","239","10423992","10424622","630","1336.01441019","0.471551800037"
"SL2.50ch00:10428518-10429766","1073","10428518","10429766","1248","1336.01441019","0.934121661027"
"SL2.50ch00:10428560-10429877","1066","10428560","10429877","1317","1336.01441019","0.985767810555"
"SL2.50ch00:10431331-10432014","280","10431331","10432014","683","1336.01441019","0.511222030834"
"SL2.50ch00:10438317-10439161","546","10438317","10439161","844","1336.01441019","0.631729713066"
"SL2.50ch00:10476481-10481250","1633","10476481","10481250","4769","1336.01441019","3.56957227679"
"SL2.50ch00:10482665-10483675","415","10482665","10483675","1010","1336.01441019","0.755979869901"
"SL2.50ch00:10485707-10487511","1199","10485707","10487511","1804","1336.01441019","1.35028483693"
"SL2.50ch00:10502513-10503036","126","10502513","10503036","523","1336.01441019","0.391462843523"
"SL2.50ch00:10508200-10508581","216","10508200","10508581","381","1336.01441019","0.285176564785"
"SL2.50ch00:10512279-10513587","256","10512279","10513587","1308","1336.01441019","0.979031356268"
"SL2.50ch00:10574814-10576035","856","10574814","10576035","1221","1336.01441019","0.913912298168"
"SL2.50ch00:10574843-10576103","856","10574843","10576103","1260","1336.01441019","0.943103600075"
"SL2.50ch00:10577314-10578590","441","10577314","10578590","1276","1336.01441019","0.955079518806"
"SL2.50ch00:10581664-10582341","149","10581664","10582341","677","1336.01441019","0.50673106131"
"SL2.50ch00:10588136-10588834","245","10588136","10588834","698","1336.01441019","0.522449454645"
"SL2.50ch00:10600590-10600921","142","10600590","10600921","331","1336.01441019","0.24775181875"
"SL2.50ch00:10601253-10602032","349","10601253","10602032","779","1336.01441019","0.583077543221"
"SL2.50ch00:10603667-10606248","2242","10603667","10606248","2581","1336.01441019","1.93186539031"
"SL2.50ch00:10604061-10606228","2171","10604061","10606228","2167","1336.01441019","1.62198849314"
"SL2.50ch00:10607822-10610054","2621","10607822","10610054","2232","1336.01441019","1.67064066299"
"SL2.50ch00:10607854-10610082","2621","10607854","10610082","2228","1336.01441019","1.66764668331"
"SL2.50ch00:10617025-10618102","2378","10617025","10618102","1077","1336.01441019","0.806129029588"
"SL2.50ch00:10617045-10618174","2378","10617045","10618174","1129","1336.01441019","0.845050765464"
"SL2.50ch00:10627392-10628351","1874","10627392","10628351","959","1336.01441019","0.717806628946"
"SL2.50ch00:10627420-10628331","1874","10627420","10628331","911","1336.01441019","0.681878872753"
"SL2.50ch00:10630303-10630941","809","10630303","10630941","638","1336.01441019","0.477539759403"
"SL2.50ch00:10630322-10630895","809","10630322","10630895","573","1336.01441019","0.428887589558"
"SL2.50ch00:10632640-10636737","4590","10632640","10636737","4097","1336.01441019","3.06658369008"
"SL2.50ch00:10632707-10636726","4568","10632707","10636726","4019","1336.01441019","3.00820108627"
"SL2.50ch00:10638493-10640185","4037","10638493","10640185","1692","1336.01441019","1.26645340581"
"SL2.50ch00:10638591-10640187","4028","10638591","10640187","1596","1336.01441019","1.19459789343"
"SL2.50ch00:10642033-10643902","2950","10642033","10643902","1869","1336.01441019","1.39893700678"
"SL2.50ch00:10642037-10643846","2950","10642037","10643846","1809","1336.01441019","1.35402731154"
"SL2.50ch00:10644515-10646026","1538","10644515","10646026","1511","1336.01441019","1.13097582517"
"SL2.50ch00:10644516-10645874","1512","10644516","10645874","1358","1336.01441019","1.0164561023"
"SL2.50ch00:10651555-10652266","599","10651555","10652266","711","1336.01441019","0.532179888614"
"SL2.50ch00:10651628-10652252","589","10651628","10652252","624","1336.01441019","0.467060830513"
"SL2.50ch00:10653584-10655204","1103","10653584","10655204","1620","1336.01441019","1.21256177152"
"SL2.50ch00:10656082-10657809","890","10656082","10657809","1727","1336.01441019","1.29265072804"
"SL2.50ch00:10659682-10660159","235","10659682","10660159","477","1336.01441019","0.357032077171"
"SL2.50ch00:10660575-10661051","171","10660575","10661051","476","1336.01441019","0.356283582251"
"SL2.50ch00:10664093-10664879","2951","10664093","10664879","786","1336.01441019","0.588317007666"
"SL2.50ch00:10665512-10666210","5032","10665512","10666210","698","1336.01441019","0.522449454645"
"SL2.50ch00:10665535-10666163","5032","10665535","10666163","628","1336.01441019","0.470054810196"
"SL2.50ch00:10667197-10669630","19288","10667197","10669630","2433","1336.01441019","1.82108814205"
"SL2.50ch00:10667249-10669624","19207","10667249","10669624","2375","1336.01441019","1.77767543665"
"SL2.50ch00:10672327-10672995","4241","10672327","10672995","668","1336.01441019","0.499994607024"
"SL2.50ch00:10672331-10673001","4241","10672331","10673001","670","1336.01441019","0.501491596865"
"SL2.50ch00:10675576-10676676","5374","10675576","10676676","1100","1336.01441019","0.823344412764"
"SL2.50ch00:10675601-10676553","5362","10675601","10676553","952","1336.01441019","0.712567164501"
"SL2.50ch00:10680500-10686366","57017","10680500","10686366","5866","1336.01441019","4.39067120479"
"SL2.50ch00:10680507-10686395","57017","10680507","10686395","5888","1336.01441019","4.40713809305"
"SL2.50ch00:10687183-10692743","47622","10687183","10692743","5560","1336.01441019","4.16163175906"
"SL2.50ch00:10687194-10692736","47622","10687194","10692736","5542","1336.01441019","4.14815885049"
"SL2.50ch00:10721202-10722706","501","10721202","10722706","1504","1336.01441019","1.12573636072"
"SL2.50ch00:10729266-10730646","1524","10729266","10730646","1380","1336.01441019","1.03292299056"
"SL2.50ch00:10729366-10730692","1513","10729366","10730692","1326","1336.01441019","0.992504264841"
"SL2.50ch00:10731640-10733467","1732","10731640","10733467","1827","1336.01441019","1.36750022011"
"SL2.50ch00:10735708-10737046","378","10735708","10737046","1338","1336.01441019","1.00148620389"
"SL2.50ch00:10739930-10740261","98","10739930","10740261","331","1336.01441019","0.24775181875"
"SL2.50ch00:10743581-10745195","887","10743581","10745195","1614","1336.01441019","1.208070802"
"SL2.50ch00:10746713-10748833","954","10746713","10748833","2120","1336.01441019","1.58680923187"
"SL2.50ch00:10749908-10750239","65","10749908","10750239","331","1336.01441019","0.24775181875"
"SL2.50ch00:10751930-10752550","73","10751930","10752550","620","1336.01441019","0.464066850831"
"SL2.50ch00:10776616-10777858","585","10776616","10777858","1242","1336.01441019","0.929630691502"
"SL2.50ch00:10778540-10781054","864","10778540","10781054","2514","1336.01441019","1.88171623063"
"SL2.50ch00:10783354-10784036","380","10783354","10784036","682","1336.01441019","0.510473535914"
"SL2.50ch00:10783509-10783913","337","10783509","10783913","404","1336.01441019","0.302391947961"
"SL2.50ch00:10788509-10789242","501","10788509","10789242","733","1336.01441019","0.548646776869"
"SL2.50ch00:10788760-10789164","410","10788760","10789164","404","1336.01441019","0.302391947961"
"SL2.50ch00:10793463-10794063","325","10793463","10794063","600","1336.01441019","0.449096952417"
"SL2.50ch00:10793486-10794207","343","10793486","10794207","721","1336.01441019","0.539664837821"
"SL2.50ch00:10798448-10803540","2204","10798448","10803540","5092","1336.01441019","3.81133613618"
"SL2.50ch00:10830646-10832242","2133","10830646","10832242","1596","1336.01441019","1.19459789343"
"SL2.50ch00:10830818-10832276","2133","10830818","10832276","1458","1336.01441019","1.09130559437"
"SL2.50ch00:10834896-10835805","1127","10834896","10835805","909","1336.01441019","0.680381882911"
"SL2.50ch00:10834936-10835789","1117","10834936","10835789","853","1336.01441019","0.638466167352"
"SL2.50ch00:10842071-10842585","334","10842071","10842585","514","1336.01441019","0.384726389237"
"SL2.50ch00:10842074-10842575","334","10842074","10842575","501","1336.01441019","0.374995955268"
"SL2.50ch00:10843896-10845227","686","10843896","10845227","1331","1336.01441019","0.996246739444"
"SL2.50ch00:10846170-10847034","997","10846170","10847034","864","1336.01441019","0.64669961148"
"SL2.50ch00:10846224-10847047","997","10846224","10847047","823","1336.01441019","0.616011319731"
"SL2.50ch00:10848807-10849976","1021","10848807","10849976","1169","1336.01441019","0.874990562292"
"SL2.50ch00:10854621-10857569","1627","10854621","10857569","2948","1336.01441019","2.20656302621"
"SL2.50ch00:10868809-10869190","100","10868809","10869190","381","1336.01441019","0.285176564785"
"SL2.50ch00:10910268-10911385","1051","10910268","10911385","1117","1336.01441019","0.836068826416"
"SL2.50ch00:10910370-10911449","1052","10910370","10911449","1079","1336.01441019","0.807626019429"
"SL2.50ch00:10914174-10914910","565","10914174","10914910","736","1336.01441019","0.550892261631"
"SL2.50ch00:10914338-10914844","526","10914338","10914844","506","1336.01441019","0.378738429871"
"SL2.50ch00:10917250-10919722","3369","10917250","10919722","2472","1336.01441019","1.85027944396"
"SL2.50ch00:10917261-10919734","3368","10917261","10919734","2473","1336.01441019","1.85102793888"
"SL2.50ch00:10926623-10928866","1489","10926623","10928866","2243","1336.01441019","1.67887410712"
"SL2.50ch00:10926626-10929287","1557","10926626","10929287","2661","1336.01441019","1.99174498397"
"SL2.50ch00:10930953-10933110","1306","10930953","10933110","2157","1336.01441019","1.61450354394"
"SL2.50ch00:10931866-10933008","1041","10931866","10933008","1142","1336.01441019","0.854781199433"
"SL2.50ch00:10936035-10937735","561","10936035","10937735","1700","1336.01441019","1.27244136518"
"SL2.50ch00:10940054-10943891","1606","10940054","10943891","3837","1336.01441019","2.8719750107"
"SL2.50ch00:10945399-10946478","444","10945399","10946478","1079","1336.01441019","0.807626019429"
"SL2.50ch00:10947725-10954068","2080","10947725","10954068","6343","1336.01441019","4.74770328196"
"SL2.50ch00:10956482-10960667","1418","10956482","10960667","4185","1336.01441019","3.13245124311"
"SL2.50ch00:10963552-10964142","153","10963552","10964142","590","1336.01441019","0.44161200321"
"SL2.50ch00:10971004-10972145","338","10971004","10972145","1141","1336.01441019","0.854032704512"
"SL2.50ch00:10971048-10972223","345","10971048","10972223","1175","1336.01441019","0.879481531816"
"SL2.50ch00:10985064-10986782","1108","10985064","10986782","1718","1336.01441019","1.28591427375"
"SL2.50ch00:10985073-10986834","1108","10985073","10986834","1761","1336.01441019","1.31809955534"
"SL2.50ch00:10990687-10995808","2699","10990687","10995808","5121","1336.01441019","3.83304248888"
"SL2.50ch00:10998618-11000310","1073","10998618","11000310","1692","1336.01441019","1.26645340581"
"SL2.50ch00:11005052-11006987","1262","11005052","11006987","1935","1336.01441019","1.44833767154"
"SL2.50ch00:11007680-11008269","231","11007680","11008269","589","1336.01441019","0.440863508289"
"SL2.50ch00:11012514-11012895","161","11012514","11012895","381","1336.01441019","0.285176564785"
"SL2.50ch00:11031644-11031975","89","11031644","11031975","331","1336.01441019","0.24775181875"
"SL2.50ch00:11055079-11077480","156180","11055079","11077480","22401","1336.01441019","16.7670347185"
"SL2.50ch00:11055103-11077486","156180","11055103","11077486","22383","1336.01441019","16.7535618099"
"SL2.50ch00:11141761-11146375","1455","11141761","11146375","4614","1336.01441019","3.45355556408"
"SL2.50ch00:11147031-11148450","560","11147031","11148450","1419","1336.01441019","1.06211429247"
"SL2.50ch00:11147056-11148474","560","11147056","11148474","1418","1336.01441019","1.06136579754"
"SL2.50ch00:11156005-11156811","210","11156005","11156811","806","1336.01441019","0.60328690608"
"SL2.50ch00:11182413-11182990","142","11182413","11182990","577","1336.01441019","0.431881569241"
"SL2.50ch00:11182455-11182963","134","11182455","11182963","508","1336.01441019","0.380235419713"
"SL2.50ch00:11184554-11185987","409","11184554","11185987","1433","1336.01441019","1.07259322136"
"SL2.50ch00:11184559-11185963","409","11184559","11185963","1404","1336.01441019","1.05088686865"
"SL2.50ch00:11239943-11240920","527","11239943","11240920","977","1336.01441019","0.731279537518"
"SL2.50ch00:11242538-11243692","513","11242538","11243692","1154","1336.01441019","0.863763138481"
"SL2.50ch00:11244917-11246524","870","11244917","11246524","1607","1336.01441019","1.20283133756"
"SL2.50ch00:11251418-11254505","1537","11251418","11254505","3087","1336.01441019","2.31060382018"
"SL2.50ch00:11251473-11254521","1524","11251473","11254521","3048","1336.01441019","2.28141251828"
"SL2.50ch00:11256077-11257931","676","11256077","11257931","1854","1336.01441019","1.38770958297"
"SL2.50ch00:11293074-11293554","112","11293074","11293554","480","1336.01441019","0.359277561933"
"SL2.50ch00:11295501-11296038","168","11295501","11296038","537","1336.01441019","0.401941772413"
"SL2.50ch00:11297430-11297761","131","11297430","11297761","331","1336.01441019","0.24775181875"
"SL2.50ch00:11301434-11301838","203","11301434","11301838","404","1336.01441019","0.302391947961"
"SL2.50ch00:11301523-11301854","175","11301523","11301854","331","1336.01441019","0.24775181875"
"SL2.50ch00:11308046-11308427","131","11308046","11308427","381","1336.01441019","0.285176564785"
"SL2.50ch00:11310727-11313687","3100","11310727","11313687","2960","1336.01441019","2.21554496526"
"SL2.50ch00:11310886-11313674","3075","11310886","11313674","2788","1336.01441019","2.0868038389"
"SL2.50ch00:11314410-11315883","1709","11314410","11315883","1473","1336.01441019","1.10253301818"
"SL2.50ch00:11314447-11315959","1707","11314447","11315959","1512","1336.01441019","1.13172432009"
"SL2.50ch00:11317036-11318741","932","11317036","11318741","1705","1336.01441019","1.27618383978"
"SL2.50ch00:11321826-11325870","1714","11321826","11325870","4044","1336.01441019","3.02691345929"
"SL2.50ch00:11326911-11336372","3316","11326911","11336372","9461","1336.01441019","7.08151044469"
"SL2.50ch00:11337261-11343309","1987","11337261","11343309","6048","1336.01441019","4.52689728036"
"SL2.50ch00:11344369-11345115","237","11344369","11345115","746","1336.01441019","0.558377210838"
"SL2.50ch00:11362846-11363749","631","11362846","11363749","903","1336.01441019","0.675890913387"
"SL2.50ch00:11362909-11363764","616","11362909","11363764","855","1336.01441019","0.639963157194"
"SL2.50ch00:11369358-11374033","1779","11369358","11374033","4675","1336.01441019","3.49921375425"
"SL2.50ch00:11377464-11379406","1081","11377464","11379406","1942","1336.01441019","1.45357713599"
"SL2.50ch00:11377992-11379414","991","11377992","11379414","1422","1336.01441019","1.06435977723"
"SL2.50ch00:11396268-11398033","1503","11396268","11398033","1765","1336.01441019","1.32109353503"
"SL2.50ch00:11396281-11398063","1498","11396281","11398063","1782","1336.01441019","1.33381794868"
"SL2.50ch00:11398844-11404525","3854","11398844","11404525","5681","1336.01441019","4.25219964446"
"SL2.50ch00:11411131-11412638","1399","11411131","11412638","1507","1336.01441019","1.12798184549"
"SL2.50ch00:11411210-11412550","1387","11411210","11412550","1340","1336.01441019","1.00298319373"
"SL2.50ch00:11435021-11435402","96","11435021","11435402","381","1336.01441019","0.285176564785"
"SL2.50ch00:11443840-11444538","296","11443840","11444538","698","1336.01441019","0.522449454645"
"SL2.50ch00:11479280-11479661","40","11479280","11479661","381","1336.01441019","0.285176564785"
"SL2.50ch00:11490693-11491596","520","11490693","11491596","903","1336.01441019","0.675890913387"
"SL2.50ch00:11492825-11494397","660","11492825","11494397","1572","1336.01441019","1.17663401533"
"SL2.50ch00:11495640-11497102","707","11495640","11497102","1462","1336.01441019","1.09429957406"
"SL2.50ch00:11499381-11501263","1155","11499381","11501263","1882","1336.01441019","1.40866744075"
"SL2.50ch00:11501876-11503245","1104","11501876","11503245","1369","1336.01441019","1.02468954643"
"SL2.50ch00:11501908-11503138","1095","11501908","11503138","1230","1336.01441019","0.920648752454"
"SL2.50ch00:11504375-11505179","662","11504375","11505179","804","1336.01441019","0.601789916238"
"SL2.50ch00:11504386-11505193","658","11504386","11505193","807","1336.01441019","0.604035401"
"SL2.50ch00:11510384-11512323","640","11510384","11512323","1939","1336.01441019","1.45133165123"
"SL2.50ch00:11516613-11517616","302","11516613","11517616","1003","1336.01441019","0.750740405456"
"SL2.50ch00:11516614-11517613","302","11516614","11517613","999","1336.01441019","0.747746425774"
"SL2.50ch00:11520028-11520796","111","11520028","11520796","768","1336.01441019","0.574844099093"
"SL2.50ch00:11531048-11531810","192","11531048","11531810","762","1336.01441019","0.570353129569"
"SL2.50ch00:11534129-11548181","10433","11534129","11548181","14052","1336.01441019","10.5178506256"
"SL2.50ch00:11565499-11566054","178","11565499","11566054","555","1336.01441019","0.415414680985"
"SL2.50ch00:11576949-11583147","3024","11576949","11583147","6198","1336.01441019","4.63917151846"
"SL2.50ch00:11650849-11651285","227","11650849","11651285","436","1336.01441019","0.326343785423"
"SL2.50ch00:11655343-11656870","2743","11655343","11656870","1527","1336.01441019","1.1429517439"
"SL2.50ch00:11655363-11656901","2743","11655363","11656901","1538","1336.01441019","1.15118518803"
"SL2.50ch00:11658373-11659357","760","11658373","11659357","984","1336.01441019","0.736519001963"
"SL2.50ch00:11658413-11659410","760","11658413","11659410","997","1336.01441019","0.746249435932"
"SL2.50ch00:11685738-11686901","787","11685738","11686901","1163","1336.01441019","0.870499592768"
"SL2.50ch00:11687500-11689613","1598","11687500","11689613","2113","1336.01441019","1.58156976743"
"SL2.50ch00:11687565-11689537","1598","11687565","11689537","1972","1336.01441019","1.47603198361"
"SL2.50ch00:11690472-11694305","1441","11690472","11694305","3833","1336.01441019","2.86898103102"
"SL2.50ch00:11695255-11695660","236","11695255","11695660","405","1336.01441019","0.303140442881"
"SL2.50ch00:11697545-11698487","659","11697545","11698487","942","1336.01441019","0.705082215294"
"SL2.50ch00:11736257-11738084","2507","11736257","11738084","1827","1336.01441019","1.36750022011"
"SL2.50ch00:11736295-11738062","2504","11736295","11738062","1767","1336.01441019","1.32259052487"
"SL2.50ch00:11773888-11775696","10208","11773888","11775696","1808","1336.01441019","1.35327881662"
"SL2.50ch00:11773931-11775731","10151","11773931","11775731","1800","1336.01441019","1.34729085725"
"SL2.50ch00:11777402-11778481","7266","11777402","11778481","1079","1336.01441019","0.807626019429"
"SL2.50ch00:11777453-11778470","7092","11777453","11778470","1017","1336.01441019","0.761219334346"
"SL2.50ch00:11780895-11782018","6723","11780895","11782018","1123","1336.01441019","0.84055979594"
"SL2.50ch00:11780914-11782081","6668","11780914","11782081","1167","1336.01441019","0.87349357245"
"SL2.50ch00:11782576-11786164","19922","11782576","11786164","3588","1336.01441019","2.68559977545"
"SL2.50ch00:11782593-11786224","19929","11782593","11786224","3631","1336.01441019","2.71778505704"
"SL2.50ch00:11789600-11790182","156","11789600","11790182","582","1336.01441019","0.435624043844"
"SL2.50ch00:11789639-11790399","198","11789639","11790399","760","1336.01441019","0.568856139728"
"SL2.50ch00:11796752-11810419","97793","11796752","11810419","13667","1336.01441019","10.2296800811"
"SL2.50ch00:11798253-11810444","97496","11798253","11810444","12191","1336.01441019","9.12490157819"
"SL2.50ch00:11819282-11819771","131","11819282","11819771","489","1336.01441019","0.36601401622"
"SL2.50ch00:11851636-11852113","137","11851636","11852113","477","1336.01441019","0.357032077171"
"SL2.50ch00:11855496-11855877","119","11855496","11855877","381","1336.01441019","0.285176564785"
"SL2.50ch00:11857574-11857905","107","11857574","11857905","331","1336.01441019","0.24775181875"
"SL2.50ch00:11901425-11901973","114","11901425","11901973","548","1336.01441019","0.410175216541"
"SL2.50ch00:11913173-11913606","115","11913173","11913606","433","1336.01441019","0.324098300661"
"SL2.50ch00:11919657-11919988","78","11919657","11919988","331","1336.01441019","0.24775181875"
"SL2.50ch00:11922194-11922525","102","11922194","11922525","331","1336.01441019","0.24775181875"
"SL2.50ch00:11934769-11935958","713","11934769","11935958","1189","1336.01441019","0.889960460706"
"SL2.50ch00:11944473-11945832","651","11944473","11945832","1359","1336.01441019","1.01720459722"
"SL2.50ch00:11966724-11976904","64114","11966724","11976904","10180","1336.01441019","7.61967829267"
"SL2.50ch00:11966763-11976921","64093","11966763","11976921","10158","1336.01441019","7.60321140441"
"SL2.50ch00:11986901-11987970","1119","11986901","11987970","1069","1336.01441019","0.800141070222"
"SL2.50ch00:11986947-11988035","1119","11986947","11988035","1088","1336.01441019","0.814362473716"
"SL2.50ch00:11990826-11991727","618","11990826","11991727","901","1336.01441019","0.674393923546"
"SL2.50ch00:11993083-11994663","2232","11993083","11994663","1580","1336.01441019","1.1826219747"
"SL2.50ch00:11993108-11994595","2232","11993108","11994595","1487","1336.01441019","1.11301194707"
"SL2.50ch00:11996161-11996887","902","11996161","11996887","726","1336.01441019","0.543407312424"
"SL2.50ch00:11996165-11996956","908","11996165","11996956","791","1336.01441019","0.592059482269"
"SL2.50ch00:12005346-12016200","99218","12005346","12016200","10854","1336.01441019","8.12416386922"
"SL2.50ch00:12006247-12016261","98987","12006247","12016261","10014","1336.01441019","7.49542813583"
"SL2.50ch00:12039409-12041187","311","12039409","12041187","1778","1336.01441019","1.33082396899"
"SL2.50ch00:12088095-12089625","644","12088095","12089625","1530","1336.01441019","1.14519722866"
"SL2.50ch00:12090869-12091736","462","12090869","12091736","867","1336.01441019","0.648945096242"
"SL2.50ch00:12128069-12129195","355","12128069","12129195","1126","1336.01441019","0.842805280702"
"SL2.50ch00:12128080-12154019","121578","12128080","12154019","25939","1336.01441019","19.4152097479"
"SL2.50ch00:12129811-12133841","2070","12129811","12133841","4030","1336.01441019","3.0164345304"
"SL2.50ch00:12135070-12154020","118843","12135070","12154020","18950","1336.01441019","14.1839787472"
"SL2.50ch00:12211658-12219923","2873","12211658","12219923","8265","1336.01441019","6.18631051954"
"SL2.50ch00:12212183-12219705","2750","12212183","12219705","7522","1336.01441019","5.63017879346"
"SL2.50ch00:12266042-12266373","57","12266042","12266373","331","1336.01441019","0.24775181875"
"SL2.50ch00:12266855-12282012","109726","12266855","12282012","15157","1336.01441019","11.344937513"
"SL2.50ch00:12266900-12282088","109726","12266900","12282088","15188","1336.01441019","11.3681408555"
"SL2.50ch00:12300631-12302445","541","12300631","12302445","1814","1336.01441019","1.35776978614"
"SL2.50ch00:12301258-12302308","384","12301258","12302308","1050","1336.01441019","0.785919666729"
"SL2.50ch00:12312511-12319827","2369","12312511","12319827","7316","1336.01441019","5.4759888398"
"SL2.50ch00:12322626-12323776","325","12322626","12323776","1150","1336.01441019","0.860769158799"
"SL2.50ch00:12327818-12328740","194","12327818","12328740","922","1336.01441019","0.69011231688"
"SL2.50ch00:12339756-12340219","95","12339756","12340219","463","1336.01441019","0.346553148282"
"SL2.50ch00:12348859-12349873","477","12348859","12349873","1014","1336.01441019","0.758973849584"
"SL2.50ch00:12348900-12349859","469","12348900","12349859","959","1336.01441019","0.717806628946"
"SL2.50ch00:12492800-12501089","2556","12492800","12501089","8289","1336.01441019","6.20427439764"
"SL2.50ch00:12492909-12499238","2026","12492909","12499238","6329","1336.01441019","4.73722435307"
"SL2.50ch00:12499680-12501104","447","12499680","12501104","1424","1336.01441019","1.06585676707"
"SL2.50ch00:12504572-12506066","413","12504572","12506066","1494","1336.01441019","1.11825141152"
"SL2.50ch00:12561321-12561702","91","12561321","12561702","381","1336.01441019","0.285176564785"
"SL2.50ch00:12570057-12572446","692","12570057","12572446","2389","1336.01441019","1.78815436554"
"SL2.50ch00:12643039-12645240","715","12643039","12645240","2201","1336.01441019","1.64743732045"
"SL2.50ch00:12646321-12647655","448","12646321","12647655","1334","1336.01441019","0.998492224206"
"SL2.50ch00:12648597-12648928","105","12648597","12648928","331","1336.01441019","0.24775181875"
"SL2.50ch00:12669261-12669592","45","12669261","12669592","331","1336.01441019","0.24775181875"
"SL2.50ch00:12704257-12704588","62","12704257","12704588","331","1336.01441019","0.24775181875"
"SL2.50ch00:12754371-12754752","210","12754371","12754752","381","1336.01441019","0.285176564785"
"SL2.50ch00:12756548-12757566","995","12756548","12757566","1018","1336.01441019","0.761967829267"
"SL2.50ch00:12756562-12757520","995","12756562","12757520","958","1336.01441019","0.717058134025"
"SL2.50ch00:12758317-12760221","2650","12758317","12760221","1904","1336.01441019","1.425134329"
"SL2.50ch00:12758322-12760244","2650","12758322","12760244","1922","1336.01441019","1.43860723757"
"SL2.50ch00:12772555-12778363","2766","12772555","12778363","5808","1336.01441019","4.34725849939"
"SL2.50ch00:12783643-12784259","133","12783643","12784259","616","1336.01441019","0.461072871148"
"SL2.50ch00:12885083-12890446","1117","12885083","12890446","5363","1336.01441019","4.01417825968"
"SL2.50ch00:12935953-12936381","98","12935953","12936381","428","1336.01441019","0.320355826057"
"SL2.50ch00:12942422-12943337","280","12942422","12943337","915","1336.01441019","0.684872852435"
"SL2.50ch00:12944934-12947743","839","12944934","12947743","2809","1336.01441019","2.10252223223"
"SL2.50ch00:12953378-12958577","23327","12953378","12958577","5199","1336.01441019","3.89142509269"
"SL2.50ch00:12953577-12958707","23300","12953577","12958707","5130","1336.01441019","3.83977894316"
"SL2.50ch00:13043047-13043844","255","13043047","13043844","797","1336.01441019","0.596550451793"
"SL2.50ch00:13052241-13053765","811","13052241","13053765","1524","1336.01441019","1.14070625914"
"SL2.50ch00:13173913-13179168","2710","13173913","13179168","5255","1336.01441019","3.93334080825"
"SL2.50ch00:13173921-13179092","2710","13173921","13179092","5171","1336.01441019","3.87046723491"
"SL2.50ch00:13301729-13302241","754","13301729","13302241","512","1336.01441019","0.383229399396"
"SL2.50ch00:13301742-13302823","842","13301742","13302823","1081","1336.01441019","0.809123009271"
"SL2.50ch00:13305980-13306972","437","13305980","13306972","992","1336.01441019","0.742506961329"
"SL2.50ch00:13361691-13362228","95","13361691","13362228","537","1336.01441019","0.401941772413"
"SL2.50ch00:13374943-13375813","3893","13374943","13375813","870","1336.01441019","0.651190581004"
"SL2.50ch00:13374976-13375803","3890","13374976","13375803","827","1336.01441019","0.619005299414"
"SL2.50ch00:13379479-13380282","6274","13379479","13380282","803","1336.01441019","0.601041421318"
"SL2.50ch00:13379519-13380293","6274","13379519","13380293","774","1336.01441019","0.579335068617"
"SL2.50ch00:13386663-13388093","441","13386663","13388093","1430","1336.01441019","1.07034773659"
"SL2.50ch00:13386717-13388034","424","13386717","13388034","1317","1336.01441019","0.985767810555"
"SL2.50ch00:13458176-13459472","255","13458176","13459472","1296","1336.01441019","0.97004941722"
"SL2.50ch00:13460498-13460879","102","13460498","13460879","381","1336.01441019","0.285176564785"
"SL2.50ch00:13493342-13494542","494","13493342","13494542","1200","1336.01441019","0.898193904833"
"SL2.50ch00:13493457-13494539","487","13493457","13494539","1082","1336.01441019","0.809871504191"
"SL2.50ch00:13496769-13498228","505","13496769","13498228","1459","1336.01441019","1.09205408929"
"SL2.50ch00:13496785-13498305","505","13496785","13498305","1520","1336.01441019","1.13771227946"
"SL2.50ch00:13503356-13507621","14189","13503356","13507621","4265","1336.01441019","3.19233083676"
"SL2.50ch00:13503403-13508200","14318","13503403","13508200","4797","1336.01441019","3.59053013457"
"SL2.50ch00:13568829-13570343","307","13568829","13570343","1514","1336.01441019","1.13322130993"
"SL2.50ch00:13572199-13572797","129","13572199","13572797","598","1336.01441019","0.447599962575"
"SL2.50ch00:13602752-13608403","28293","13602752","13608403","5651","1336.01441019","4.22974479684"
"SL2.50ch00:13603461-13608253","28157","13603461","13608253","4792","1336.01441019","3.58678765997"
"SL2.50ch00:13633641-13634122","64","13633641","13634122","481","1336.01441019","0.360026056854"
"SL2.50ch00:13689157-13689857","452","13689157","13689857","700","1336.01441019","0.523946444486"
"SL2.50ch00:13689180-13689957","459","13689180","13689957","777","1336.01441019","0.58158055338"
"SL2.50ch00:13690408-13691287","363","13690408","13691287","879","1336.01441019","0.65792703529"
"SL2.50ch00:13690425-13691314","362","13690425","13691314","889","1336.01441019","0.665411984497"
"SL2.50ch00:13764589-13769479","26332","13764589","13769479","4890","1336.01441019","3.6601401622"
"SL2.50ch00:13764737-13769414","26329","13764737","13769414","4677","1336.01441019","3.50071074409"
"SL2.50ch00:13854221-13854967","169","13854221","13854967","746","1336.01441019","0.558377210838"
"SL2.50ch00:14017873-14019202","519","14017873","14019202","1329","1336.01441019","0.994749749603"
"SL2.50ch00:14038179-14039142","286","14038179","14039142","963","1336.01441019","0.720800608629"
"SL2.50ch00:14041264-14041595","131","14041264","14041595","331","1336.01441019","0.24775181875"
"SL2.50ch00:14094954-14095722","279","14094954","14095722","768","1336.01441019","0.574844099093"
"SL2.50ch00:14120430-14121460","769","14120430","14121460","1030","1336.01441019","0.770949768315"
"SL2.50ch00:14123191-14124822","749","14123191","14124822","1631","1336.01441019","1.22079521565"
"SL2.50ch00:14257985-14258578","119","14257985","14258578","593","1336.01441019","0.443857487972"
"SL2.50ch00:14287172-14287849","521","14287172","14287849","677","1336.01441019","0.50673106131"
"SL2.50ch00:14287293-14287697","481","14287293","14287697","404","1336.01441019","0.302391947961"
"SL2.50ch00:14290585-14291568","1449","14290585","14291568","983","1336.01441019","0.735770507043"
"SL2.50ch00:14290663-14291631","1443","14290663","14291631","968","1336.01441019","0.724543083232"
"SL2.50ch00:14296307-14297182","335","14296307","14297182","875","1336.01441019","0.654933055608"
"SL2.50ch00:14297986-14300488","831","14297986","14300488","2502","1336.01441019","1.87273429158"
"SL2.50ch00:14314049-14314915","338","14314049","14314915","866","1336.01441019","0.648196601321"
"SL2.50ch00:14317136-14318077","377","14317136","14318077","941","1336.01441019","0.704333720373"
"SL2.50ch00:14349829-14350343","178","14349829","14350343","514","1336.01441019","0.384726389237"
"SL2.50ch00:14351727-14353626","470","14351727","14353626","1899","1336.01441019","1.4213918544"
"SL2.50ch00:14409749-14411023","445","14409749","14411023","1274","1336.01441019","0.953582528965"
"SL2.50ch00:14437478-14441688","3631","14437478","14441688","4210","1336.01441019","3.15116361612"
"SL2.50ch00:14437498-14441691","3631","14437498","14441691","4193","1336.01441019","3.13843920247"
"SL2.50ch00:14505476-14506375","398","14505476","14506375","899","1336.01441019","0.672896933704"
"SL2.50ch00:14507677-14509080","607","14507677","14509080","1403","1336.01441019","1.05013837373"
"SL2.50ch00:14510949-14511428","291","14510949","14511428","479","1336.01441019","0.358529067013"
"SL2.50ch00:14514523-14515709","401","14514523","14515709","1186","1336.01441019","0.887714975944"
"SL2.50ch00:14520219-14524162","1360","14520219","14524162","3943","1336.01441019","2.9513154723"
"SL2.50ch00:14545972-14550325","45133","14545972","14550325","4353","1336.01441019","3.25819838978"
"SL2.50ch00:14545992-14550404","45135","14545992","14550404","4412","1336.01441019","3.3023595901"
"SL2.50ch00:14561598-14562390","178","14561598","14562390","792","1336.01441019","0.59280797719"
"SL2.50ch00:14572010-14572963","369","14572010","14572963","953","1336.01441019","0.713315659422"
"SL2.50ch00:14575166-14576019","375","14575166","14576019","853","1336.01441019","0.638466167352"
"SL2.50ch00:14645339-14645670","84","14645339","14645670","331","1336.01441019","0.24775181875"
"SL2.50ch00:14653788-14654316","109","14653788","14654316","528","1336.01441019","0.395205318127"
"SL2.50ch00:14665275-14665864","239","14665275","14665864","589","1336.01441019","0.440863508289"
"SL2.50ch00:14670395-14675844","18951","14670395","14675844","5449","1336.01441019","4.07854882286"
"SL2.50ch00:14670525-14675767","18951","14670525","14675767","5242","1336.01441019","3.92361037428"
"SL2.50ch00:14677135-14679038","3175","14677135","14679038","1903","1336.01441019","1.42438583408"
"SL2.50ch00:14677163-14679046","3179","14677163","14679046","1883","1336.01441019","1.40941593567"
"SL2.50ch00:14696340-14697784","409","14696340","14697784","1444","1336.01441019","1.08082666548"
"SL2.50ch00:14696486-14697741","388","14696486","14697741","1255","1336.01441019","0.939361125471"
"SL2.50ch00:14734757-14735547","157","14734757","14735547","790","1336.01441019","0.591310987349"
"SL2.50ch00:14735013-14735427","126","14735013","14735427","414","1336.01441019","0.309876897167"
"SL2.50ch00:14736771-14737175","59","14736771","14737175","404","1336.01441019","0.302391947961"
"SL2.50ch00:14764000-14767741","808","14764000","14767741","3741","1336.01441019","2.80011949832"
"SL2.50ch00:14793282-14793762","147","14793282","14793762","480","1336.01441019","0.359277561933"
"SL2.50ch00:14793283-14793806","158","14793283","14793806","523","1336.01441019","0.391462843523"
"SL2.50ch00:14796368-14797271","362","14796368","14797271","903","1336.01441019","0.675890913387"
"SL2.50ch00:14796377-14797277","365","14796377","14797277","900","1336.01441019","0.673645428625"
"SL2.50ch00:14801714-14802210","306","14801714","14802210","496","1336.01441019","0.371253480664"
"SL2.50ch00:14801773-14802270","301","14801773","14802270","497","1336.01441019","0.372001975585"
"SL2.50ch00:14804058-14805706","2264","14804058","14805706","1648","1336.01441019","1.2335196293"
"SL2.50ch00:14804095-14805725","2261","14804095","14805725","1630","1336.01441019","1.22004672073"
"SL2.50ch00:14888134-14888815","189","14888134","14888815","681","1336.01441019","0.509725040993"
"SL2.50ch00:14959726-14961346","600","14959726","14961346","1620","1336.01441019","1.21256177152"
"SL2.50ch00:14962661-14963710","941","14962661","14963710","1049","1336.01441019","0.785171171808"
"SL2.50ch00:14962671-14963673","941","14962671","14963673","1002","1336.01441019","0.749991910536"
"SL2.50ch00:14992539-14993226","244","14992539","14993226","687","1336.01441019","0.514216010517"
"SL2.50ch00:14994776-14995888","339","14994776","14995888","1112","1336.01441019","0.832326351812"
"SL2.50ch00:14999669-15000581","553","14999669","15000581","912","1336.01441019","0.682627367673"
"SL2.50ch00:14999676-15000635","552","14999676","15000635","959","1336.01441019","0.717806628946"
"SL2.50ch00:15070998-15071624","150","15070998","15071624","626","1336.01441019","0.468557820355"
"SL2.50ch00:15134732-15135537","231","15134732","15135537","805","1336.01441019","0.602538411159"
"SL2.50ch00:15138691-15139738","332","15138691","15139738","1047","1336.01441019","0.783674181967"
"SL2.50ch00:15138813-15139728","320","15138813","15139728","915","1336.01441019","0.684872852435"
"SL2.50ch00:15142980-15144082","577","15142980","15144082","1102","1336.01441019","0.824841402605"
"SL2.50ch00:15145088-15146391","965","15145088","15146391","1303","1336.01441019","0.975288881665"
"SL2.50ch00:15154016-15154525","227","15154016","15154525","509","1336.01441019","0.380983914633"
"SL2.50ch00:15154030-15154559","227","15154030","15154559","529","1336.01441019","0.395953813047"
"SL2.50ch00:15290029-15291592","649","15290029","15291592","1563","1336.01441019","1.16989756105"
"SL2.50ch00:15292792-15293760","459","15292792","15293760","968","1336.01441019","0.724543083232"
"SL2.50ch00:15313888-15314555","219","15313888","15314555","667","1336.01441019","0.499246112103"
"SL2.50ch00:15321388-15322417","1101","15321388","15322417","1029","1336.01441019","0.770201273395"
"SL2.50ch00:15321397-15322420","1101","15321397","15322420","1023","1336.01441019","0.76571030387"
"SL2.50ch00:15324297-15325292","1247","15324297","15325292","995","1336.01441019","0.744752446091"
"SL2.50ch00:15324335-15325255","1247","15324335","15325255","920","1336.01441019","0.688615327039"
"SL2.50ch00:15345063-15346309","427","15345063","15346309","1246","1336.01441019","0.932624671185"
"SL2.50ch00:15348034-15348911","949","15348034","15348911","877","1336.01441019","0.656430045449"
"SL2.50ch00:15348056-15348874","949","15348056","15348874","818","1336.01441019","0.612268845128"
"SL2.50ch00:15360713-15361740","468","15360713","15361740","1027","1336.01441019","0.768704283553"
"SL2.50ch00:15363024-15364385","465","15363024","15364385","1361","1336.01441019","1.01870158707"
"SL2.50ch00:15385981-15387196","249","15385981","15387196","1215","1336.01441019","0.909421328644"
"SL2.50ch00:15450246-15451248","313","15450246","15451248","1002","1336.01441019","0.749991910536"
"SL2.50ch00:15452864-15453865","468","15452864","15453865","1001","1336.01441019","0.749243415615"
"SL2.50ch00:15473445-15477143","2929","15473445","15477143","3698","1336.01441019","2.76793421673"
"SL2.50ch00:15473462-15477114","2925","15473462","15477114","3652","1336.01441019","2.73350345038"
"SL2.50ch00:15534748-15536183","4762","15534748","15536183","1435","1336.01441019","1.0740902112"
"SL2.50ch00:15534758-15536224","4760","15534758","15536224","1466","1336.01441019","1.09729355374"
"SL2.50ch00:15538081-15542520","28336","15538081","15542520","4439","1336.01441019","3.32256895296"
"SL2.50ch00:15538103-15542548","28336","15538103","15542548","4445","1336.01441019","3.32705992249"
"SL2.50ch00:15578074-15578388","67","15578074","15578388","314","1336.01441019","0.235027405098"
"SL2.50ch00:15813952-15814601","569","15813952","15814601","649","1336.01441019","0.485773203531"
"SL2.50ch00:15813970-15814627","569","15813970","15814627","657","1336.01441019","0.491761162896"
"SL2.50ch00:15816234-15816914","182","15816234","15816914","680","1336.01441019","0.508976546072"
"SL2.50ch00:15864653-15865067","95","15864653","15865067","414","1336.01441019","0.309876897167"
"SL2.50ch00:15877075-15880575","2348","15877075","15880575","3500","1336.01441019","2.61973222243"
"SL2.50ch00:15885500-15887828","626","15885500","15887828","2328","1336.01441019","1.74249617538"
"SL2.50ch00:15902875-15903796","268","15902875","15903796","921","1336.01441019","0.68936382196"
"SL2.50ch00:15903091-15903778","225","15903091","15903778","687","1336.01441019","0.514216010517"
"SL2.50ch00:15905698-15906355","255","15905698","15906355","657","1336.01441019","0.491761162896"
"SL2.50ch00:15905708-15906356","255","15905708","15906356","648","1336.01441019","0.48502470861"
"SL2.50ch00:15918006-15920903","567","15918006","15920903","2897","1336.01441019","2.16838978525"
"SL2.50ch00:15961412-15961891","222","15961412","15961891","479","1336.01441019","0.358529067013"
"SL2.50ch00:15964571-15964902","275","15964571","15964902","331","1336.01441019","0.24775181875"
"SL2.50ch00:15997706-16001208","1071","15997706","16001208","3502","1336.01441019","2.62122921227"
"SL2.50ch00:15997711-16001117","1071","15997711","16001117","3406","1336.01441019","2.54937369989"
"SL2.50ch00:16026769-16030121","1878","16026769","16030121","3352","1336.01441019","2.50895497417"
"SL2.50ch00:16026779-16030092","1876","16026779","16030092","3313","1336.01441019","2.47976367226"
"SL2.50ch00:16051830-16055470","28227","16051830","16055470","3640","1336.01441019","2.72452151133"
"SL2.50ch00:16051969-16055507","28227","16051969","16055507","3538","1336.01441019","2.64817502942"
"SL2.50ch00:16145943-16146508","159","16145943","16146508","565","1336.01441019","0.422899630192"
"SL2.50ch00:16180734-16184190","21027","16180734","16184190","3456","1336.01441019","2.58679844592"
"SL2.50ch00:16180765-16184240","21033","16180765","16184240","3475","1336.01441019","2.60101984941"
"SL2.50ch00:16194906-16198191","755","16194906","16198191","3285","1336.01441019","2.45880581448"
"SL2.50ch00:16195205-16198127","720","16195205","16198127","2922","1336.01441019","2.18710215827"
"SL2.50ch00:16210756-16211485","162","16210756","16211485","729","1336.01441019","0.545652797186"
"SL2.50ch00:16246756-16247263","152","16246756","16247263","507","1336.01441019","0.379486924792"
"SL2.50ch00:16246838-16247326","157","16246838","16247326","488","1336.01441019","0.365265521299"
"SL2.50ch00:16278313-16278791","83","16278313","16278791","478","1336.01441019","0.357780572092"
"SL2.50ch00:16310917-16312270","1155","16310917","16312270","1353","1336.01441019","1.0127136277"
"SL2.50ch00:16310949-16312354","1154","16310949","16312354","1405","1336.01441019","1.05163536358"
"SL2.50ch00:16313964-16314440","323","16313964","16314440","476","1336.01441019","0.356283582251"
"SL2.50ch00:16384298-16387525","1528","16384298","16387525","3227","1336.01441019","2.41539310908"
"SL2.50ch00:16388450-16388781","83","16388450","16388781","331","1336.01441019","0.24775181875"
"SL2.50ch00:16397955-16401517","20878","16397955","16401517","3562","1336.01441019","2.66613890751"
"SL2.50ch00:16397999-16401447","20877","16397999","16401447","3448","1336.01441019","2.58081048655"
"SL2.50ch00:16430804-16431135","105","16430804","16431135","331","1336.01441019","0.24775181875"
"SL2.50ch00:16531969-16535132","781","16531969","16535132","3163","1336.01441019","2.36748943416"
"SL2.50ch00:16532007-16533836","500","16532007","16533836","1829","1336.01441019","1.36899720995"
"SL2.50ch00:16548945-16549634","246","16548945","16549634","689","1336.01441019","0.515713000358"
"SL2.50ch00:16548956-16549611","244","16548956","16549611","655","1336.01441019","0.490264173055"
"SL2.50ch00:16562494-16565702","1558","16562494","16565702","3208","1336.01441019","2.40117170559"
"SL2.50ch00:16562500-16565709","1558","16562500","16565709","3209","1336.01441019","2.40192020051"
"SL2.50ch00:16636841-16639820","9776","16636841","16639820","2979","1336.01441019","2.22976636875"
"SL2.50ch00:16636881-16639873","9776","16636881","16639873","2992","1336.01441019","2.23949680272"
"SL2.50ch00:16661165-16666646","1714","16661165","16666646","5481","1336.01441019","4.10250066033"
"SL2.50ch00:16663475-16666668","1229","16663475","16666668","3193","1336.01441019","2.38994428178"
"SL2.50ch00:16797253-16797657","66","16797253","16797657","404","1336.01441019","0.302391947961"
"SL2.50ch00:16878589-16880003","520","16878589","16880003","1414","1336.01441019","1.05837181786"
"SL2.50ch00:16879504-16880165","437","16879504","16880165","661","1336.01441019","0.494755142579"
"SL2.50ch00:16901279-16904607","3291","16901279","16904607","3328","1336.01441019","2.49099109607"
"SL2.50ch00:16950216-16951189","783","16950216","16951189","973","1336.01441019","0.728285557836"
"SL2.50ch00:16950256-16951168","783","16950256","16951168","912","1336.01441019","0.682627367673"
"SL2.50ch00:16952569-16953405","573","16952569","16953405","836","1336.01441019","0.625741753701"
"SL2.50ch00:16952609-16953413","573","16952609","16953413","804","1336.01441019","0.601789916238"
"SL2.50ch00:16963074-16963968","1318","16963074","16963968","894","1336.01441019","0.669154459101"
"SL2.50ch00:16963082-16963996","1318","16963082","16963996","914","1336.01441019","0.684124357515"
"SL2.50ch00:16965766-16966448","818","16965766","16966448","682","1336.01441019","0.510473535914"
"SL2.50ch00:16965791-16966390","817","16965791","16966390","599","1336.01441019","0.448348457496"
"SL2.50ch00:17011668-17014680","1591","17011668","17014680","3012","1336.01441019","2.25446670113"
"SL2.50ch00:17108480-17109201","153","17108480","17109201","721","1336.01441019","0.539664837821"
"SL2.50ch00:17155544-17158777","19290","17155544","17158777","3233","1336.01441019","2.41988407861"
"SL2.50ch00:17155546-17158805","19290","17155546","17158805","3259","1336.01441019","2.43934494654"
"SL2.50ch00:17182659-17183378","265","17182659","17183378","719","1336.01441019","0.538167847979"
"SL2.50ch00:17231558-17234427","911","17231558","17234427","2869","1336.01441019","2.14743192747"
"SL2.50ch00:17297364-17300415","1381","17297364","17300415","3051","1336.01441019","2.28365800304"
"SL2.50ch00:17347283-17350087","1464","17347283","17350087","2804","1336.01441019","2.09877975763"
"SL2.50ch00:17347292-17350171","1463","17347292","17350171","2879","1336.01441019","2.15491687668"
"SL2.50ch00:17458434-17461318","1379","17458434","17461318","2884","1336.01441019","2.15865935128"
"SL2.50ch00:17458495-17461319","1368","17458495","17461319","2824","1336.01441019","2.11374965604"
"SL2.50ch00:17522874-17525226","7313","17522874","17525226","2352","1336.01441019","1.76046005347"
"SL2.50ch00:17522889-17525278","7309","17522889","17525278","2389","1336.01441019","1.78815436554"
"SL2.50ch00:17606813-17607227","94","17606813","17607227","414","1336.01441019","0.309876897167"
"SL2.50ch00:17634547-17637649","4773","17634547","17637649","3102","1336.01441019","2.32183124399"
"SL2.50ch00:17634761-17637622","4743","17634761","17637622","2861","1336.01441019","2.14144396811"
"SL2.50ch00:17652875-17654256","476","17652875","17654256","1381","1336.01441019","1.03367148548"
"SL2.50ch00:17662605-17663003","92","17662605","17663003","398","1336.01441019","0.297900978436"
"SL2.50ch00:17769432-17772007","1125","17769432","17772007","2575","1336.01441019","1.92737442079"
"SL2.50ch00:17836018-17836532","103","17836018","17836532","514","1336.01441019","0.384726389237"
"SL2.50ch00:17840077-17843083","18433","17840077","17843083","3006","1336.01441019","2.24997573161"
"SL2.50ch00:17840196-17843104","18433","17840196","17843104","2908","1336.01441019","2.17662322938"
"SL2.50ch00:17892171-17892552","74","17892171","17892552","381","1336.01441019","0.285176564785"
"SL2.50ch00:18009672-18010223","147","18009672","18010223","551","1336.01441019","0.412420701303"
"SL2.50ch00:18038938-18041196","623","18038938","18041196","2258","1336.01441019","1.69010153093"
"SL2.50ch00:18049283-18053552","4109","18049283","18053552","4269","1336.01441019","3.19532481644"
"SL2.50ch00:18049355-18052967","4039","18049355","18052967","3612","1336.01441019","2.70356365355"
"SL2.50ch00:18116598-18122150","2585","18116598","18122150","5552","1336.01441019","4.1556437997"
"SL2.50ch00:18116660-18121783","2521","18116660","18121783","5123","1336.01441019","3.83453947872"
"SL2.50ch00:18137599-18137930","87","18137599","18137930","331","1336.01441019","0.24775181875"
"SL2.50ch00:18176835-18178099","604","18176835","18178099","1264","1336.01441019","0.946097579758"
"SL2.50ch00:18176848-18178416","668","18176848","18178416","1568","1336.01441019","1.17364003565"
"SL2.50ch00:18179054-18179487","83","18179054","18179487","433","1336.01441019","0.324098300661"
"SL2.50ch00:18179162-18179493","74","18179162","18179493","331","1336.01441019","0.24775181875"
"SL2.50ch00:18194215-18194596","48","18194215","18194596","381","1336.01441019","0.285176564785"
"SL2.50ch00:18228174-18230796","1356","18228174","18230796","2622","1336.01441019","1.96255368206"
"SL2.50ch00:18228184-18230875","1356","18228184","18230875","2691","1336.01441019","2.01419983159"
"SL2.50ch00:18254279-18256460","911","18254279","18256460","2181","1336.01441019","1.63246742203"
"SL2.50ch00:18315775-18318681","8779","18315775","18318681","2906","1336.01441019","2.17512623954"
"SL2.50ch00:18315870-18318744","8781","18315870","18318744","2874","1336.01441019","2.15117440208"
"SL2.50ch00:18352333-18355283","22154","18352333","18355283","2950","1336.01441019","2.20806001605"
"SL2.50ch00:18352416-18355347","22153","18352416","18355347","2931","1336.01441019","2.19383861256"
"SL2.50ch00:18428537-18429641","248","18428537","18429641","1104","1336.01441019","0.826338392447"
"SL2.50ch00:18432632-18433517","300","18432632","18433517","885","1336.01441019","0.662418004815"
"SL2.50ch00:18432804-18433385","268","18432804","18433385","581","1336.01441019","0.434875548923"
"SL2.50ch00:18490010-18491237","939","18490010","18491237","1227","1336.01441019","0.918403267692"
"SL2.50ch00:18490245-18490886","801","18490245","18490886","641","1336.01441019","0.479785244165"
"SL2.50ch00:18581649-18582348","247","18581649","18582348","699","1336.01441019","0.523197949565"
"SL2.50ch00:18649134-18651349","816","18649134","18651349","2215","1336.01441019","1.65791624934"
"SL2.50ch00:18649169-18651636","872","18649169","18651636","2467","1336.01441019","1.84653696935"
"SL2.50ch00:18776737-18779461","2823","18776737","18779461","2724","1336.01441019","2.03890016397"
"SL2.50ch00:18776875-18779471","2823","18776875","18779471","2596","1336.01441019","1.94309281412"
"SL2.50ch00:1885338-1885820","124","1885338","1885820","482","1336.01441019","0.360774551775"
"SL2.50ch00:18865856-18866709","228","18865856","18866709","853","1336.01441019","0.638466167352"
"SL2.50ch00:18867677-18868170","131","18867677","18868170","493","1336.01441019","0.369007995902"
"SL2.50ch00:18909157-18910829","473","18909157","18910829","1672","1336.01441019","1.2514835074"
"SL2.50ch00:18980667-18983048","837","18980667","18983048","2381","1336.01441019","1.78216640617"
"SL2.50ch00:19091691-19094230","2635","19091691","19094230","2539","1336.01441019","1.90042860364"
"SL2.50ch00:19091698-19094232","2635","19091698","19094232","2534","1336.01441019","1.89668612904"
"SL2.50ch00:19120501-19123287","14360","19120501","19123287","2786","1336.01441019","2.08530684905"
"SL2.50ch00:19120525-19123230","14358","19120525","19123230","2705","1336.01441019","2.02467876048"
"SL2.50ch00:19131608-19132209","153","19131608","19132209","601","1336.01441019","0.449845447337"
"SL2.50ch00:19131950-19132504","117","19131950","19132504","554","1336.01441019","0.414666186065"
"SL2.50ch00:19180932-19181473","121","19180932","19181473","541","1336.01441019","0.404935752096"
"SL2.50ch00:19308067-19310382","1604","19308067","19310382","2315","1336.01441019","1.73276574141"
"SL2.50ch00:19308098-19310458","1593","19308098","19310458","2360","1336.01441019","1.76644801284"
"SL2.50ch00:19322220-19323243","224","19322220","19323243","1023","1336.01441019","0.76571030387"
"SL2.50ch00:19374874-19377192","1083","19374874","19377192","2318","1336.01441019","1.73501122617"
"SL2.50ch00:19408079-19410522","1713","19408079","19410522","2443","1336.01441019","1.82857309126"
"SL2.50ch00:19408101-19410482","1713","19408101","19410482","2381","1336.01441019","1.78216640617"
"SL2.50ch00:19415713-19418074","777","19415713","19418074","2361","1336.01441019","1.76719650776"
"SL2.50ch00:19429051-19429382","75","19429051","19429382","331","1336.01441019","0.24775181875"
"SL2.50ch00:19514497-19514901","54","19514497","19514901","404","1336.01441019","0.302391947961"
"SL2.50ch00:19613113-19615861","36149","19613113","19615861","2748","1336.01441019","2.05686404207"
"SL2.50ch00:19613115-19615800","36146","19613115","19615800","2685","1336.01441019","2.00970886206"
"SL2.50ch00:19656469-19656850","715","19656469","19656850","381","1336.01441019","0.285176564785"
"SL2.50ch00:19703281-19705830","4161","19703281","19705830","2549","1336.01441019","1.90791355285"
"SL2.50ch00:19703414-19705826","4161","19703414","19705826","2412","1336.01441019","1.80536974871"
"SL2.50ch00:19810183-19812494","2311","19810183","19812494","2311","1336.01441019","1.72977176172"
"SL2.50ch00:19810216-19812455","2311","19810216","19812455","2239","1336.01441019","1.67588012743"
"SL2.50ch00:19862417-19862961","124","19862417","19862961","544","1336.01441019","0.407181236858"
"SL2.50ch00:19863641-19864151","97","19863641","19864151","510","1336.01441019","0.381732409554"
"SL2.50ch00:19880094-19880475","64","19880094","19880475","381","1336.01441019","0.285176564785"
"SL2.50ch00:19915935-19918331","13110","19915935","19918331","2396","1336.01441019","1.79339382998"
"SL2.50ch00:19916106-19918382","13110","19916106","19918382","2276","1336.01441019","1.7035744395"
"SL2.50ch00:19964863-19967219","7189","19964863","19967219","2356","1336.01441019","1.76345403316"
"SL2.50ch00:19964870-19967190","7189","19964870","19967190","2320","1336.01441019","1.73650821601"
"SL2.50ch00:19980221-19981086","189","19980221","19981086","865","1336.01441019","0.647448106401"
"SL2.50ch00:19987617-19988611","320","19987617","19988611","994","1336.01441019","0.74400395117"
"SL2.50ch00:19987645-19989080","399","19987645","19989080","1435","1336.01441019","1.0740902112"
"SL2.50ch00:20025783-20028020","1202","20025783","20028020","2237","1336.01441019","1.67438313759"
"SL2.50ch00:20087225-20087703","72","20087225","20087703","478","1336.01441019","0.357780572092"
"SL2.50ch00:20105564-20107750","788","20105564","20107750","2186","1336.01441019","1.63620989664"
"SL2.50ch00:20105628-20107558","742","20105628","20107558","1930","1336.01441019","1.44459519694"
"SL2.50ch00:20160648-20163226","6435","20160648","20163226","2578","1336.01441019","1.92961990555"
"SL2.50ch00:20160692-20163201","6433","20160692","20163201","2509","1336.01441019","1.87797375602"
"SL2.50ch00:20173631-20174283","89","20173631","20174283","652","1336.01441019","0.488018688293"
"SL2.50ch00:20292068-20292865","718","20292068","20292865","797","1336.01441019","0.596550451793"
"SL2.50ch00:20292093-20292795","704","20292093","20292795","702","1336.01441019","0.525443434327"
"SL2.50ch00:20365240-20366583","618","20365240","20366583","1343","1336.01441019","1.00522867849"
"SL2.50ch00:20415234-20416037","101","20415234","20416037","803","1336.01441019","0.601041421318"
"SL2.50ch00:20417264-20417769","91","20417264","20417769","505","1336.01441019","0.377989934951"
"SL2.50ch00:20426195-20428426","525","20426195","20428426","2231","1336.01441019","1.66989216807"
"SL2.50ch00:20470636-20471139","130","20470636","20471139","503","1336.01441019","0.376492945109"
"SL2.50ch00:20491758-20492380","514","20491758","20492380","622","1336.01441019","0.465563840672"
"SL2.50ch00:20492857-20493771","922","20492857","20493771","914","1336.01441019","0.684124357515"
"SL2.50ch00:20530312-20530643","79","20530312","20530643","331","1336.01441019","0.24775181875"
"SL2.50ch00:20605664-20606045","84","20605664","20606045","381","1336.01441019","0.285176564785"
"SL2.50ch00:20710222-20711351","235","20710222","20711351","1129","1336.01441019","0.845050765464"
"SL2.50ch00:20749078-20749459","1334","20749078","20749459","381","1336.01441019","0.285176564785"
"SL2.50ch00:20749085-20749595","1339","20749085","20749595","510","1336.01441019","0.381732409554"
"SL2.50ch00:20777915-20780000","953","20777915","20780000","2085","1336.01441019","1.56061190965"
"SL2.50ch00:20784793-20785193","82","20784793","20785193","400","1336.01441019","0.299397968278"
"SL2.50ch00:20830070-20830987","1010","20830070","20830987","917","1336.01441019","0.686369842277"
"SL2.50ch00:20830166-20830861","985","20830166","20830861","695","1336.01441019","0.520203969883"
"SL2.50ch00:20831358-20832314","1651","20831358","20832314","956","1336.01441019","0.715561144184"
"SL2.50ch00:20831457-20832301","1625","20831457","20832301","844","1336.01441019","0.631729713066"
"SL2.50ch00:20864257-20866167","380","20864257","20866167","1910","1336.01441019","1.42962529853"
"SL2.50ch00:20878069-20879473","293","20878069","20879473","1404","1336.01441019","1.05088686865"
"SL2.50ch00:20882006-20884381","5608","20882006","20884381","2375","1336.01441019","1.77767543665"
"SL2.50ch00:20882048-20884353","5608","20882048","20884353","2305","1336.01441019","1.7252807922"
"SL2.50ch00:20907004-20907534","209","20907004","20907534","530","1336.01441019","0.396702307968"
"SL2.50ch00:20907083-20907697","225","20907083","20907697","614","1336.01441019","0.459575881306"
"SL2.50ch00:21044568-21045013","65","21044568","21045013","445","1336.01441019","0.333080239709"
"SL2.50ch00:21068476-21068953","169","21068476","21068953","477","1336.01441019","0.357032077171"
"SL2.50ch00:21113313-21114882","507","21113313","21114882","1569","1336.01441019","1.17438853057"
"SL2.50ch00:21116064-21116378","61","21116064","21116378","314","1336.01441019","0.235027405098"
"SL2.50ch00:21116185-21116516","68","21116185","21116516","331","1336.01441019","0.24775181875"
"SL2.50ch00:21135846-21136930","200","21135846","21136930","1084","1336.01441019","0.811368494033"
"SL2.50ch00:21146210-21148266","5679","21146210","21148266","2056","1336.01441019","1.53890555695"
"SL2.50ch00:21146244-21148246","5620","21146244","21148246","2002","1336.01441019","1.49848683123"
"SL2.50ch00:2114752-2115336","182","2114752","2115336","584","1336.01441019","0.437121033686"
"SL2.50ch00:21174982-21176828","409","21174982","21176828","1846","1336.01441019","1.3817216236"
"SL2.50ch00:21188120-21188524","84","21188120","21188524","404","1336.01441019","0.302391947961"
"SL2.50ch00:21199080-21203445","2588","21199080","21203445","4365","1336.01441019","3.26718032883"
"SL2.50ch00:21199212-21203412","2588","21199212","21203412","4200","1336.01441019","3.14367866692"
"SL2.50ch00:21261347-21262919","504","21261347","21262919","1572","1336.01441019","1.17663401533"
"SL2.50ch00:21271917-21273901","725","21271917","21273901","1984","1336.01441019","1.48501392266"
"SL2.50ch00:21287693-21289149","374","21287693","21289149","1456","1336.01441019","1.08980860453"
"SL2.50ch00:2128936-2129666","189","2128936","2129666","730","1336.01441019","0.546401292107"
"SL2.50ch00:21301637-21302041","77","21301637","21302041","404","1336.01441019","0.302391947961"
"SL2.50ch00:21320571-21320984","115","21320571","21320984","413","1336.01441019","0.309128402247"
"SL2.50ch00:21346162-21348020","509","21346162","21348020","1858","1336.01441019","1.39070356265"
"SL2.50ch00:21458967-21459934","1714","21458967","21459934","967","1336.01441019","0.723794588311"
"SL2.50ch00:21458976-21460861","2174","21458976","21460861","1885","1336.01441019","1.41091292551"
"SL2.50ch00:21460278-21460885","449","21460278","21460885","607","1336.01441019","0.454336416862"
"SL2.50ch00:21472624-21473911","517","21472624","21473911","1287","1336.01441019","0.963312962934"
"SL2.50ch00:2151051-2151649","371","2151051","2151649","598","1336.01441019","0.447599962575"
"SL2.50ch00:2152502-2153479","416","2152502","2153479","977","1336.01441019","0.731279537518"
"SL2.50ch00:21534232-21536466","11118","21534232","21536466","2234","1336.01441019","1.67213765283"
"SL2.50ch00:21534374-21536490","11125","21534374","21536490","2116","1336.01441019","1.58381525219"
"SL2.50ch00:21544960-21546933","1472","21544960","21546933","1973","1336.01441019","1.47678047853"
"SL2.50ch00:21545013-21546964","1476","21545013","21546964","1951","1336.01441019","1.46031359027"
"SL2.50ch00:21609090-21609930","3046","21609090","21609930","840","1336.01441019","0.628735733383"
"SL2.50ch00:21609101-21610027","3052","21609101","21610027","926","1336.01441019","0.693106296563"
"SL2.50ch00:21610769-21611150","281","21610769","21611150","381","1336.01441019","0.285176564785"
"SL2.50ch00:21610784-21611216","281","21610784","21611216","432","1336.01441019","0.32334980574"
"SL2.50ch00:2165685-2166066","207","2165685","2166066","381","1336.01441019","0.285176564785"
"SL2.50ch00:21691996-21694217","13604","21691996","21694217","2221","1336.01441019","1.66240721886"
"SL2.50ch00:21692076-21694771","13712","21692076","21694771","2695","1336.01441019","2.01719381127"
"SL2.50ch00:21702960-21704560","496","21702960","21704560","1600","1336.01441019","1.19759187311"
"SL2.50ch00:21723887-21725208","417","21723887","21725208","1321","1336.01441019","0.988761790237"
"SL2.50ch00:21747062-21748950","756","21747062","21748950","1888","1336.01441019","1.41315841027"
"SL2.50ch00:21751304-21752003","216","21751304","21752003","699","1336.01441019","0.523197949565"
"SL2.50ch00:21763937-21765897","849","21763937","21765897","1960","1336.01441019","1.46705004456"
"SL2.50ch00:21763942-21765934","849","21763942","21765934","1992","1336.01441019","1.49100188202"
"SL2.50ch00:21774466-21776406","727","21774466","21776406","1940","1336.01441019","1.45208014615"
"SL2.50ch00:2348479-2348971","122","2348479","2348971","492","1336.01441019","0.368259500982"
"SL2.50ch00:3299013-3299394","104","3299013","3299394","381","1336.01441019","0.285176564785"
"SL2.50ch00:4061651-4061982","70","4061651","4061982","331","1336.01441019","0.24775181875"
"SL2.50ch00:4157750-4160909","9769","4157750","4160909","3159","1336.01441019","2.36449545447"
"SL2.50ch00:4157756-4160945","9769","4157756","4160945","3189","1336.01441019","2.38695030209"
"SL2.50ch00:4161615-4164606","3677","4161615","4164606","2991","1336.01441019","2.2387483078"
"SL2.50ch00:4161618-4164579","3677","4161618","4164579","2961","1336.01441019","2.21629346018"
"SL2.50ch00:4167859-4177035","9385","4167859","4177035","9176","1336.01441019","6.86818939229"
"SL2.50ch00:4167874-4177035","9385","4167874","4177035","9161","1336.01441019","6.85696196848"
"SL2.50ch00:4276842-4277455","1142","4276842","4277455","613","1336.01441019","0.458827386386"
"SL2.50ch00:4276842-4277479","1143","4276842","4277479","637","1336.01441019","0.476791264482"
"SL2.50ch00:5616640-5620363","1397","5616640","5620363","3723","1336.01441019","2.78664658975"
"SL2.50ch00:5633474-5633958","108","5633474","5633958","484","1336.01441019","0.362271541616"
"SL2.50ch00:5640469-5640850","118","5640469","5640850","381","1336.01441019","0.285176564785"
"SL2.50ch00:5642602-5643172","222","5642602","5643172","570","1336.01441019","0.426642104796"
"SL2.50ch00:5650451-5651372","310","5650451","5651372","921","1336.01441019","0.68936382196"
"SL2.50ch00:5663075-5664604","528","5663075","5664604","1529","1336.01441019","1.14444873374"
"SL2.50ch00:5670366-5671502","580","5670366","5671502","1136","1336.01441019","0.850290229909"
"SL2.50ch00:5678648-5680437","716","5678648","5680437","1789","1336.01441019","1.33905741312"
"SL2.50ch00:6997912-6998316","84","6997912","6998316","404","1336.01441019","0.302391947961"
"SL2.50ch00:7045751-7046155","83","7045751","7046155","404","1336.01441019","0.302391947961"
"SL2.50ch00:7101268-7101772","209","7101268","7101772","504","1336.01441019","0.37724144003"
"SL2.50ch00:7103674-7104919","493","7103674","7104919","1245","1336.01441019","0.931876176265"
"SL2.50ch00:7117855-7118835","283","7117855","7118835","980","1336.01441019","0.733525022281"
"SL2.50ch00:7128074-7128405","157","7128074","7128405","331","1336.01441019","0.24775181875"
"SL2.50ch00:7357050-7357431","106","7357050","7357431","381","1336.01441019","0.285176564785"
"SL2.50ch00:7367846-7369725","1922","7367846","7369725","1879","1336.01441019","1.40642195598"
"SL2.50ch00:7367871-7369670","1922","7367871","7369670","1799","1336.01441019","1.34654236233"
"SL2.50ch00:7371642-7372531","892","7371642","7372531","889","1336.01441019","0.665411984497"
"SL2.50ch00:7371688-7372642","891","7371688","7372642","954","1336.01441019","0.714064154342"
"SL2.50ch00:7383910-7384751","327","7383910","7384751","841","1336.01441019","0.629484228304"
"SL2.50ch00:7385175-7385556","147","7385175","7385556","381","1336.01441019","0.285176564785"
"SL2.50ch00:7398004-7398335","117","7398004","7398335","331","1336.01441019","0.24775181875"
"SL2.50ch00:7409757-7410235","158","7409757","7410235","478","1336.01441019","0.357780572092"
"SL2.50ch00:7411313-7411841","176","7411313","7411841","528","1336.01441019","0.395205318127"
"SL2.50ch00:7416677-7433620","13119","7416677","7433620","16943","1336.01441019","12.6817494413"
"SL2.50ch00:7439180-7440063","481","7439180","7440063","883","1336.01441019","0.660921014973"
"SL2.50ch00:7444731-7446486","514","7444731","7446486","1755","1336.01441019","1.31360858582"
"SL2.50ch00:7447128-7447722","150","7447128","7447722","594","1336.01441019","0.444605982892"
"SL2.50ch00:7450990-7452233","578","7450990","7452233","1243","1336.01441019","0.930379186423"
"SL2.50ch00:7471662-7472874","427","7471662","7472874","1212","1336.01441019","0.907175843882"
"SL2.50ch00:7473607-7476274","867","7473607","7476274","2667","1336.01441019","1.99623595349"
"SL2.50ch00:7480796-7482370","489","7480796","7482370","1574","1336.01441019","1.17813100517"
"SL2.50ch00:7483299-7486491","909","7483299","7486491","3192","1336.01441019","2.38919578686"
"SL2.50ch00:7489225-7489606","42","7489225","7489606","381","1336.01441019","0.285176564785"
"SL2.50ch00:7493647-7496794","1072","7493647","7496794","3147","1336.01441019","2.35551351543"
"SL2.50ch00:7497691-7505701","2435","7497691","7505701","8010","1336.01441019","5.99544431476"
"SL2.50ch00:7548540-7549016","125","7548540","7549016","476","1336.01441019","0.356283582251"
"SL2.50ch00:7579535-7579916","416","7579535","7579916","381","1336.01441019","0.285176564785"
"SL2.50ch00:7579537-7579941","416","7579537","7579941","404","1336.01441019","0.302391947961"
"SL2.50ch00:7656812-7660521","1169","7656812","7660521","3709","1336.01441019","2.77616766086"
"SL2.50ch00:7661257-7666762","1807","7661257","7666762","5505","1336.01441019","4.12046453842"
"SL2.50ch00:7671945-7672276","86","7671945","7672276","331","1336.01441019","0.24775181875"
"SL2.50ch00:7691363-7691814","79","7691363","7691814","451","1336.01441019","0.337571209233"
"SL2.50ch00:7721224-7722043","378","7721224","7722043","819","1336.01441019","0.613017340049"
"SL2.50ch00:7753861-7754192","68","7753861","7754192","331","1336.01441019","0.24775181875"
"SL2.50ch00:7759814-7760675","234","7759814","7760675","861","1336.01441019","0.644454126718"
"SL2.50ch00:7782569-7782900","129","7782569","7782900","331","1336.01441019","0.24775181875"
"SL2.50ch00:7785175-7785556","125","7785175","7785556","381","1336.01441019","0.285176564785"
"SL2.50ch00:7791369-7791750","95","7791369","7791750","381","1336.01441019","0.285176564785"
"SL2.50ch00:7799427-7805883","3800","7799427","7805883","6456","1336.01441019","4.832283208"
"SL2.50ch00:7806307-7806912","417","7806307","7806912","605","1336.01441019","0.45283942702"
"SL2.50ch00:7806334-7806780","417","7806334","7806780","446","1336.01441019","0.33382873463"
"SL2.50ch00:7809352-7810164","324","7809352","7810164","812","1336.01441019","0.607777875604"
"SL2.50ch00:7814409-7815341","381","7814409","7815341","932","1336.01441019","0.697597266087"
"SL2.50ch00:7818026-7820661","1681","7818026","7820661","2635","1336.01441019","1.97228411603"
"SL2.50ch00:7828659-7840838","4744","7828659","7840838","12179","1336.01441019","9.11591963914"
"SL2.50ch00:7844700-7847495","1039","7844700","7847495","2795","1336.01441019","2.09204330334"
"SL2.50ch00:7851343-7857107","2135","7851343","7857107","5764","1336.01441019","4.31432472288"
"SL2.50ch00:7861042-7865109","1483","7861042","7865109","4067","1336.01441019","3.04412884246"
"SL2.50ch00:7865595-7869991","1676","7865595","7869991","4396","1336.01441019","3.29038367137"
"SL2.50ch00:7874473-7875566","224","7874473","7875566","1093","1336.01441019","0.818104948319"
"SL2.50ch00:7894339-7894918","212","7894339","7894918","579","1336.01441019","0.433378559082"
"SL2.50ch00:7908152-7909933","753","7908152","7909933","1781","1336.01441019","1.33306945376"
"SL2.50ch00:7920594-7921036","186","7920594","7921036","442","1336.01441019","0.330834754947"
"SL2.50ch00:7929686-7930805","492","7929686","7930805","1119","1336.01441019","0.837565816257"
"SL2.50ch00:7932993-7933496","184","7932993","7933496","503","1336.01441019","0.376492945109"
"SL2.50ch00:7955702-7956245","202","7955702","7956245","543","1336.01441019","0.406432741937"
"SL2.50ch00:7981894-7984640","1095","7981894","7984640","2746","1336.01441019","2.05536705223"
"SL2.50ch00:7992280-7995772","2275","7992280","7995772","3492","1336.01441019","2.61374426306"
"SL2.50ch00:7997050-7999590","1479","7997050","7999590","2540","1336.01441019","1.90117709856"
"SL2.50ch00:8003805-8008288","1842","8003805","8008288","4483","1336.01441019","3.35550272947"
"SL2.50ch00:8211969-8213519","554","8211969","8213519","1550","1336.01441019","1.16016712708"
"SL2.50ch00:8215981-8216312","233","8215981","8216312","331","1336.01441019","0.24775181875"
"SL2.50ch00:8220236-8221108","264","8220236","8221108","872","1336.01441019","0.652687570846"
"SL2.50ch00:8226836-8227347","287","8226836","8227347","511","1336.01441019","0.382480904475"
"SL2.50ch00:8239260-8240239","662","8239260","8240239","979","1336.01441019","0.73277652736"
"SL2.50ch00:8239286-8240213","649","8239286","8240213","927","1336.01441019","0.693854791484"
"SL2.50ch00:8248127-8248821","213","8248127","8248821","694","1336.01441019","0.519455474962"
"SL2.50ch00:8261022-8261479","205","8261022","8261479","457","1336.01441019","0.342062178757"
"SL2.50ch00:8272962-8273984","452","8272962","8273984","1022","1336.01441019","0.76496180895"
"SL2.50ch00:8274420-8274933","290","8274420","8274933","513","1336.01441019","0.383977894316"
"SL2.50ch00:8278002-8278581","244","8278002","8278581","579","1336.01441019","0.433378559082"
"SL2.50ch00:8289099-8290072","283","8289099","8290072","973","1336.01441019","0.728285557836"
"SL2.50ch00:8290565-8291088","120","8290565","8291088","523","1336.01441019","0.391462843523"
"SL2.50ch00:8308289-8309515","580","8308289","8309515","1226","1336.01441019","0.917654772771"
"SL2.50ch00:8316667-8317356","218","8316667","8317356","689","1336.01441019","0.515713000358"
"SL2.50ch00:8317943-8318944","351","8317943","8318944","1001","1336.01441019","0.749243415615"
"SL2.50ch00:8337579-8338281","253","8337579","8338281","702","1336.01441019","0.525443434327"
"SL2.50ch00:8352245-8353277","3303","8352245","8353277","1032","1336.01441019","0.772446758157"
"SL2.50ch00:8364154-8364535","179","8364154","8364535","381","1336.01441019","0.285176564785"
"SL2.50ch00:8365619-8366000","148","8365619","8366000","381","1336.01441019","0.285176564785"
"SL2.50ch00:8373129-8374954","711","8373129","8374954","1825","1336.01441019","1.36600323027"
"SL2.50ch00:8390588-8391066","133","8390588","8391066","478","1336.01441019","0.357780572092"
"SL2.50ch00:8394886-8395764","318","8394886","8395764","878","1336.01441019","0.65717854037"
"SL2.50ch00:8397257-8398381","342","8397257","8398381","1124","1336.01441019","0.841308290861"
"SL2.50ch00:8404870-8407969","858","8404870","8407969","3099","1336.01441019","2.31958575923"
"SL2.50ch00:8408883-8412450","1353","8408883","8412450","3567","1336.01441019","2.66988138212"
"SL2.50ch00:8594461-8594943","201","8594461","8594943","482","1336.01441019","0.360774551775"
"SL2.50ch00:8609823-8611996","1168","8609823","8611996","2173","1336.01441019","1.62647946267"
"SL2.50ch00:8613794-8619779","3066","8613794","8619779","5985","1336.01441019","4.47974210036"
"SL2.50ch00:8620573-8625297","2261","8620573","8625297","4724","1336.01441019","3.53589000536"
"SL2.50ch00:8634190-8643955","4765","8634190","8643955","9765","1336.01441019","7.30905290058"
"SL2.50ch00:8665372-8665998","146","8665372","8665998","626","1336.01441019","0.468557820355"
"SL2.50ch00:8693413-8694710","377","8693413","8694710","1297","1336.01441019","0.970797912141"
"SL2.50ch00:8718576-8718907","96","8718576","8718907","331","1336.01441019","0.24775181875"
"SL2.50ch00:8733703-8734280","383","8733703","8734280","577","1336.01441019","0.431881569241"
"SL2.50ch00:8733739-8734376","397","8733739","8734376","637","1336.01441019","0.476791264482"
"SL2.50ch00:8949323-8950643","642","8949323","8950643","1320","1336.01441019","0.988013295317"
"SL2.50ch00:8951629-8952554","314","8951629","8952554","925","1336.01441019","0.692357801642"
"SL2.50ch00:8956889-8957937","504","8956889","8957937","1048","1336.01441019","0.784422676888"
"SL2.50ch00:8959158-8961918","1183","8959158","8961918","2760","1336.01441019","2.06584598112"
"SL2.50ch00:8964673-8967254","1114","8964673","8967254","2581","1336.01441019","1.93186539031"
"SL2.50ch00:8968434-8969133","341","8968434","8969133","699","1336.01441019","0.523197949565"
"SL2.50ch00:8976463-8979122","1957","8976463","8979122","2659","1336.01441019","1.99024799413"
"SL2.50ch00:8976500-8979074","1957","8976500","8979074","2574","1336.01441019","1.92662592587"
"SL2.50ch00:8985607-8990373","1996","8985607","8990373","4766","1336.01441019","3.56732679203"
"SL2.50ch00:8991170-8996945","2122","8991170","8996945","5775","1336.01441019","4.32255816701"
"SL2.50ch00:9002719-9008080","1879","9002719","9008080","5361","1336.01441019","4.01268126984"
"SL2.50ch00:9015043-9015861","432","9015043","9015861","818","1336.01441019","0.612268845128"
"SL2.50ch00:9017163-9020271","1349","9017163","9020271","3108","1336.01441019","2.32632221352"
"SL2.50ch00:9030190-9032107","1307","9030190","9032107","1917","1336.01441019","1.43486476297"
"SL2.50ch00:9032873-9033452","161","9032873","9033452","579","1336.01441019","0.433378559082"
"SL2.50ch00:9039135-9039732","196","9039135","9039732","597","1336.01441019","0.446851467655"
"SL2.50ch00:9046200-9047902","1461","9046200","9047902","1702","1336.01441019","1.27393835502"
"SL2.50ch00:9046202-9047927","1461","9046202","9047927","1725","1336.01441019","1.2911537382"
"SL2.50ch00:9049667-9051611","1853","9049667","9051611","1944","1336.01441019","1.45507412583"
"SL2.50ch00:9049687-9051617","1853","9049687","9051617","1930","1336.01441019","1.44459519694"
"SL2.50ch00:9055419-9056439","630","9055419","9056439","1020","1336.01441019","0.763464819108"
"SL2.50ch00:9058057-9062380","3696","9058057","9062380","4323","1336.01441019","3.23574354216"
"SL2.50ch00:9058130-9062366","3692","9058130","9062366","4236","1336.01441019","3.17062448406"
"SL2.50ch00:9068652-9071643","2406","9068652","9071643","2991","1336.01441019","2.2387483078"
"SL2.50ch00:9068669-9071580","2406","9068669","9071580","2911","1336.01441019","2.17886871414"
"SL2.50ch00:9078238-9081468","1630","9078238","9081468","3230","1336.01441019","2.41763859384"
"SL2.50ch00:9090020-9091344","914","9090020","9091344","1324","1336.01441019","0.991007274999"
"SL2.50ch00:9090129-9091328","888","9090129","9091328","1199","1336.01441019","0.897445409913"
"SL2.50ch00:9096399-9098580","839","9096399","9098580","2181","1336.01441019","1.63246742203"
"SL2.50ch00:9098778-9101782","991","9098778","9101782","3004","1336.01441019","2.24847874177"
"SL2.50ch00:9123049-9123430","95","9123049","9123430","381","1336.01441019","0.285176564785"
"SL2.50ch00:9149049-9149380","96","9149049","9149380","331","1336.01441019","0.24775181875"
"SL2.50ch00:9239301-9242365","1299","9239301","9242365","3064","1336.01441019","2.29338843701"
"SL2.50ch00:9254842-9256563","840","9254842","9256563","1721","1336.01441019","1.28815975852"
"SL2.50ch00:9255016-9256573","829","9255016","9256573","1557","1336.01441019","1.16540659152"
"SL2.50ch00:9258981-9260290","518","9258981","9260290","1309","1336.01441019","0.979779851189"
"SL2.50ch00:9261209-9262659","529","9261209","9262659","1450","1336.01441019","1.08531763501"
"SL2.50ch00:9271913-9272294","132","9271913","9272294","381","1336.01441019","0.285176564785"
"SL2.50ch00:9337679-9338502","215","9337679","9338502","823","1336.01441019","0.616011319731"
"SL2.50ch00:9342636-9343189","180","9342636","9343189","553","1336.01441019","0.413917691144"
"SL2.50ch00:9366793-9367269","287","9366793","9367269","476","1336.01441019","0.356283582251"
"SL2.50ch00:9368011-9368406","117","9368011","9368406","395","1336.01441019","0.295655493674"
"SL2.50ch00:9369290-9370561","375","9369290","9370561","1271","1336.01441019","0.951337044203"
"SL2.50ch00:9395581-9395962","135","9395581","9395962","381","1336.01441019","0.285176564785"
"SL2.50ch00:9405622-9406110","196","9405622","9406110","488","1336.01441019","0.365265521299"
"SL2.50ch00:9407427-9409207","536","9407427","9409207","1780","1336.01441019","1.33232095884"
"SL2.50ch00:9411353-9417249","2290","9411353","9417249","5896","1336.01441019","4.41312605241"
"SL2.50ch00:9418329-9422868","1840","9418329","9422868","4539","1336.01441019","3.39741844503"
"SL2.50ch00:9423650-9427773","2208","9423650","9427773","4123","1336.01441019","3.08604455802"
"SL2.50ch00:9432373-9435895","1395","9432373","9435895","3522","1336.01441019","2.63619911069"
"SL2.50ch00:9438461-9438842","88","9438461","9438842","381","1336.01441019","0.285176564785"
"SL2.50ch00:9450109-9458110","3591","9450109","9458110","8001","1336.01441019","5.98870786048"
"SL2.50ch00:9459722-9461061","522","9459722","9461061","1339","1336.01441019","1.00223469881"
"SL2.50ch00:9469117-9469704","458","9469117","9469704","587","1336.01441019","0.439366518448"
"SL2.50ch00:9469184-9469660","421","9469184","9469660","476","1336.01441019","0.356283582251"
"SL2.50ch00:9472299-9474303","882","9472299","9474303","2004","1336.01441019","1.49998382107"
"SL2.50ch00:9478102-9485702","3379","9478102","9485702","7600","1336.01441019","5.68856139728"
"SL2.50ch00:9499085-9500608","354","9499085","9500608","1523","1336.01441019","1.13995776422"
"SL2.50ch00:9526293-9526787","102","9526293","9526787","494","1336.01441019","0.369756490823"
"SL2.50ch00:9563167-9565730","852","9563167","9565730","2563","1336.01441019","1.91839248174"
"SL2.50ch00:9570000-9571436","536","9570000","9571436","1436","1336.01441019","1.07483870612"
"SL2.50ch00:9571925-9573357","564","9571925","9573357","1432","1336.01441019","1.07184472643"
"SL2.50ch00:9574017-9574759","308","9574017","9574759","742","1336.01441019","0.555383231155"
"SL2.50ch00:9588332-9589715","560","9588332","9589715","1383","1336.01441019","1.03516847532"
"SL2.50ch00:9599366-9599921","251","9599366","9599921","555","1336.01441019","0.415414680985"
"SL2.50ch00:9601085-9601527","225","9601085","9601527","442","1336.01441019","0.330834754947"
"SL2.50ch00:9610173-9610782","251","9610173","9610782","609","1336.01441019","0.455833406703"
"SL2.50ch00:9619051-9619527","227","9619051","9619527","476","1336.01441019","0.356283582251"
"SL2.50ch00:9621309-9625027","1826","9621309","9625027","3718","1336.01441019","2.78290411514"
"SL2.50ch00:9626034-9626852","432","9626034","9626852","818","1336.01441019","0.612268845128"
"SL2.50ch00:9627319-9628335","602","9627319","9628335","1016","1336.01441019","0.760470839426"
"SL2.50ch00:9629895-9630299","249","9629895","9630299","404","1336.01441019","0.302391947961"
"SL2.50ch00:9629917-9630298","247","9629917","9630298","381","1336.01441019","0.285176564785"
"SL2.50ch00:9722309-9729289","3636","9722309","9729289","6980","1336.01441019","5.22449454645"
"SL2.50ch00:9753122-9755092","675","9753122","9755092","1970","1336.01441019","1.47453499377"
"SL2.50ch00:9757260-9760710","1288","9757260","9760710","3450","1336.01441019","2.5823074764"
"SL2.50ch00:9771534-9776201","2892","9771534","9776201","4667","1336.01441019","3.49322579488"
"SL2.50ch00:9781941-9782556","308","9781941","9782556","615","1336.01441019","0.460324376227"
"SL2.50ch00:9784250-9784845","235","9784250","9784845","595","1336.01441019","0.445354477813"
"SL2.50ch00:9788325-9788922","347","9788325","9788922","597","1336.01441019","0.446851467655"
"SL2.50ch00:9790477-9791122","204","9790477","9791122","645","1336.01441019","0.482779223848"
"SL2.50ch00:9794415-9796017","3925","9794415","9796017","1602","1336.01441019","1.19908886295"
"SL2.50ch00:9802137-9804804","1152","9802137","9804804","2667","1336.01441019","1.99623595349"
"SL2.50ch00:9814132-9815563","360","9814132","9815563","1431","1336.01441019","1.07109623151"
"SL2.50ch00:9819957-9820446","222","9819957","9820446","489","1336.01441019","0.36601401622"
"SL2.50ch00:9834856-9836719","1186","9834856","9836719","1863","1336.01441019","1.39444603725"
"SL2.50ch00:9834870-9836717","1184","9834870","9836717","1847","1336.01441019","1.38247011852"
"SL2.50ch00:9837981-9839049","632","9837981","9839049","1068","1336.01441019","0.799392575302"
"SL2.50ch00:9855831-9856465","130","9855831","9856465","634","1336.01441019","0.47454577972"
"SL2.50ch00:9858531-9858862","102","9858531","9858862","331","1336.01441019","0.24775181875"
"SL2.50ch00:9862095-9862680","478","9862095","9862680","585","1336.01441019","0.437869528606"
"SL2.50ch00:9864934-9865951","271","9864934","9865951","1017","1336.01441019","0.761219334346"
"SL2.50ch00:9880761-9881168","107","9880761","9881168","407","1336.01441019","0.304637432723"
"SL2.50ch00:9954134-9960010","2224","9954134","9960010","5876","1336.01441019","4.398156154"
"SL2.50ch00:9963927-9971391","2767","9963927","9971391","7464","1336.01441019","5.58676608806"
"SL2.50ch00:9972941-9982190","3559","9972941","9982190","9249","1336.01441019","6.9228295215"
"SL2.50ch00:9983433-9987686","1730","9983433","9987686","4253","1336.01441019","3.18334889771"
"SL2.50ch00:9990143-9993954","1650","9990143","9993954","3811","1336.01441019","2.85251414277"
"SL2.50ch00:9998705-10002129","1489","9998705","10002129","3424","1336.01441019","2.56284660846"
"SL2.50ch01:11458478-11458882","48","11458478","11458882","404","1336.01441019","0.302391947961"
"SL2.50ch01:1333605-1333936","100","1333605","1333936","331","1336.01441019","0.24775181875"
"SL2.50ch01:14955668-14956176","117","14955668","14956176","508","1336.01441019","0.380235419713"
"SL2.50ch01:15605509-15606315","439","15605509","15606315","806","1336.01441019","0.60328690608"
"SL2.50ch01:15605583-15606193","422","15605583","15606193","610","1336.01441019","0.456581901624"
"SL2.50ch01:1627796-1628204","262","1627796","1628204","408","1336.01441019","0.305385927643"
"SL2.50ch01:1627802-1628244","263","1627802","1628244","442","1336.01441019","0.330834754947"
"SL2.50ch01:18123312-18123806","95","18123312","18123806","494","1336.01441019","0.369756490823"
"SL2.50ch01:1839633-1903351","3707523","1839633","1903351","63718","1336.01441019","47.6925993568"
"SL2.50ch01:1839799-1903298","3707518","1839799","1903298","63499","1336.01441019","47.5286789692"
"SL2.50ch01:18654278-18654759","120","18654278","18654759","481","1336.01441019","0.360026056854"
"SL2.50ch01:20263642-20264023","48","20263642","20264023","381","1336.01441019","0.285176564785"
"SL2.50ch01:22522140-22522710","93","22522140","22522710","570","1336.01441019","0.426642104796"
"SL2.50ch01:22596207-22597081","329","22596207","22597081","874","1336.01441019","0.654184560687"
"SL2.50ch01:22596263-22597008","318","22596263","22597008","745","1336.01441019","0.557628715917"
"SL2.50ch01:23874904-23875672","250","23874904","23875672","768","1336.01441019","0.574844099093"
"SL2.50ch01:23874966-23875520","199","23874966","23875520","554","1336.01441019","0.414666186065"
"SL2.50ch01:23892238-23892823","112","23892238","23892823","585","1336.01441019","0.437869528606"
"SL2.50ch01:23934743-23935506","1043","23934743","23935506","763","1336.01441019","0.57110162449"
"SL2.50ch01:23934748-23939734","4510","23934748","23939734","4986","1336.01441019","3.73199567458"
"SL2.50ch01:23935933-23937367","2251","23935933","23937367","1434","1336.01441019","1.07334171628"
"SL2.50ch01:23937759-23938302","628","23937759","23938302","543","1336.01441019","0.406432741937"
"SL2.50ch01:23939235-23939566","173","23939235","23939566","331","1336.01441019","0.24775181875"
"SL2.50ch01:23941132-23943641","10418","23941132","23943641","2509","1336.01441019","1.87797375602"
"SL2.50ch01:23941250-23943069","10294","23941250","23943069","1819","1336.01441019","1.36151226074"
"SL2.50ch01:23952360-23953431","403","23952360","23953431","1071","1336.01441019","0.801638060064"
"SL2.50ch01:23964499-23964830","108","23964499","23964830","331","1336.01441019","0.24775181875"
"SL2.50ch01:23965493-23966287","2258","23965493","23966287","794","1336.01441019","0.594304967031"
"SL2.50ch01:23965531-23966303","2259","23965531","23966303","772","1336.01441019","0.577838078776"
"SL2.50ch01:24228623-24229100","217","24228623","24229100","477","1336.01441019","0.357032077171"
"SL2.50ch01:24233748-24236055","772","24233748","24236055","2307","1336.01441019","1.72677778204"
"SL2.50ch01:24233801-24235923","745","24233801","24235923","2122","1336.01441019","1.58830622171"
"SL2.50ch01:25453551-25453932","129","25453551","25453932","381","1336.01441019","0.285176564785"
"SL2.50ch01:26706804-26707135","67","26706804","26707135","331","1336.01441019","0.24775181875"
"SL2.50ch01:27417571-27417952","514","27417571","27417952","381","1336.01441019","0.285176564785"
"SL2.50ch01:27884780-27885588","817","27884780","27885588","808","1336.01441019","0.604783895921"
"SL2.50ch01:27884839-27885443","802","27884839","27885443","604","1336.01441019","0.452090932099"
"SL2.50ch01:28719574-28719905","28","28719574","28719905","331","1336.01441019","0.24775181875"
"SL2.50ch01:31877343-31877674","59","31877343","31877674","331","1336.01441019","0.24775181875"
"SL2.50ch01:32158559-32158989","66","32158559","32158989","430","1336.01441019","0.321852815899"
"SL2.50ch01:35397387-35397768","96","35397387","35397768","381","1336.01441019","0.285176564785"
"SL2.50ch01:36875461-36876083","132","36875461","36876083","622","1336.01441019","0.465563840672"
"SL2.50ch01:36888496-36896597","4622","36888496","36896597","8101","1336.01441019","6.06355735255"
"SL2.50ch01:36888528-36896680","4628","36888528","36896680","8152","1336.01441019","6.1017305935"
"SL2.50ch01:36950541-36950872","123","36950541","36950872","331","1336.01441019","0.24775181875"
"SL2.50ch01:36985947-36988070","1767","36985947","36988070","2123","1336.01441019","1.58905471663"
"SL2.50ch01:39121305-39123184","979","39121305","39123184","1879","1336.01441019","1.40642195598"
"SL2.50ch01:39123633-39124598","290","39123633","39124598","965","1336.01441019","0.72229759847"
"SL2.50ch01:39132531-39133845","1564","39132531","39133845","1314","1336.01441019","0.983522325792"
"SL2.50ch01:39132587-39133511","1388","39132587","39133511","924","1336.01441019","0.691609306722"
"SL2.50ch01:39135383-39136962","910","39135383","39136962","1579","1336.01441019","1.18187347978"
"SL2.50ch01:39137335-39138333","506","39137335","39138333","998","1336.01441019","0.746997930853"
"SL2.50ch01:39769240-39770437","729","39769240","39770437","1197","1336.01441019","0.895948420071"
"SL2.50ch01:39769398-39770139","648","39769398","39770139","741","1336.01441019","0.554634736235"
"SL2.50ch01:40523723-40524199","96","40523723","40524199","476","1336.01441019","0.356283582251"
"SL2.50ch01:40903454-40903835","65","40903454","40903835","381","1336.01441019","0.285176564785"
"SL2.50ch01:41729423-41731299","546","41729423","41731299","1876","1336.01441019","1.40417647122"
"SL2.50ch01:41729508-41731215","544","41729508","41731215","1707","1336.01441019","1.27768082963"
"SL2.50ch01:41733234-41733827","134","41733234","41733827","593","1336.01441019","0.443857487972"
"SL2.50ch01:41734282-41734663","93","41734282","41734663","381","1336.01441019","0.285176564785"
"SL2.50ch01:41753105-41753553","95","41753105","41753553","448","1336.01441019","0.335325724471"
"SL2.50ch01:42362393-42362883","158","42362393","42362883","490","1336.01441019","0.36676251114"
"SL2.50ch01:43039497-43039883","856","43039497","43039883","386","1336.01441019","0.288919039388"
"SL2.50ch01:43647892-43648464","562","43647892","43648464","572","1336.01441019","0.428139094637"
"SL2.50ch01:43647919-43648405","553","43647919","43648405","486","1336.01441019","0.363768531457"
"SL2.50ch01:43779509-43779840","129","43779509","43779840","331","1336.01441019","0.24775181875"
"SL2.50ch01:44088990-44089371","78","44088990","44089371","381","1336.01441019","0.285176564785"
"SL2.50ch01:44093384-44094080","175","44093384","44094080","696","1336.01441019","0.520952464803"
"SL2.50ch01:44467103-44467591","134","44467103","44467591","488","1336.01441019","0.365265521299"
"SL2.50ch01:44528790-44530874","653","44528790","44530874","2084","1336.01441019","1.55986341473"
"SL2.50ch01:44531920-44532301","88","44531920","44532301","381","1336.01441019","0.285176564785"
"SL2.50ch01:44610177-44610661","119","44610177","44610661","484","1336.01441019","0.362271541616"
"SL2.50ch01:44654861-44657190","472","44654861","44657190","2329","1336.01441019","1.7432446703"
"SL2.50ch01:44706862-44707193","60","44706862","44707193","331","1336.01441019","0.24775181875"
"SL2.50ch01:44757077-44758026","227","44757077","44758026","949","1336.01441019","0.710321679739"
"SL2.50ch01:44757085-44758009","224","44757085","44758009","924","1336.01441019","0.691609306722"
"SL2.50ch01:44787696-44789005","268","44787696","44789005","1309","1336.01441019","0.979779851189"
"SL2.50ch01:44790727-44791309","162","44790727","44791309","582","1336.01441019","0.435624043844"
"SL2.50ch01:44799367-44801189","523","44799367","44801189","1822","1336.01441019","1.36375774551"
"SL2.50ch01:44815432-44816107","144","44815432","44816107","675","1336.01441019","0.505234071469"
"SL2.50ch01:44821828-44822517","161","44821828","44822517","689","1336.01441019","0.515713000358"
"SL2.50ch01:44830447-44831700","351","44830447","44831700","1253","1336.01441019","0.93786413563"
"SL2.50ch01:44835583-44836248","166","44835583","44836248","665","1336.01441019","0.497749122262"
"SL2.50ch01:44835607-44836280","170","44835607","44836280","673","1336.01441019","0.503737081627"
"SL2.50ch01:44843039-44843522","113","44843039","44843522","483","1336.01441019","0.361523046695"
"SL2.50ch01:44860997-44861575","141","44860997","44861575","578","1336.01441019","0.432630064161"
"SL2.50ch01:44881671-44882093","101","44881671","44882093","422","1336.01441019","0.315864856533"
"SL2.50ch01:44914556-44915097","109","44914556","44915097","541","1336.01441019","0.404935752096"
"SL2.50ch01:44921668-44922273","198","44921668","44922273","605","1336.01441019","0.45283942702"
"SL2.50ch01:44946354-44946735","67","44946354","44946735","381","1336.01441019","0.285176564785"
"SL2.50ch01:44981212-44982326","338","44981212","44982326","1114","1336.01441019","0.833823341654"
"SL2.50ch01:44981256-44982262","334","44981256","44982262","1006","1336.01441019","0.752985890219"
"SL2.50ch01:44982919-44986729","983","44982919","44986729","3810","1336.01441019","2.85176564785"
"SL2.50ch01:44994737-44995068","103","44994737","44995068","331","1336.01441019","0.24775181875"
"SL2.50ch01:45009206-45009799","4483","45009206","45009799","593","1336.01441019","0.443857487972"
"SL2.50ch01:45009246-45009813","4474","45009246","45009813","567","1336.01441019","0.424396620034"
"SL2.50ch01:45271272-45271996","207","45271272","45271996","724","1336.01441019","0.541910322583"
"SL2.50ch01:45276944-45277463","189","45276944","45277463","519","1336.01441019","0.38846886384"
"SL2.50ch01:45786008-45786339","66","45786008","45786339","331","1336.01441019","0.24775181875"
"SL2.50ch01:48286870-48287201","49","48286870","48287201","331","1336.01441019","0.24775181875"
"SL2.50ch01:51091098-51091429","42","51091098","51091429","331","1336.01441019","0.24775181875"
"SL2.50ch01:5240590-5240921","216","5240590","5240921","331","1336.01441019","0.24775181875"
"SL2.50ch01:53020786-53021273","92","53020786","53021273","487","1336.01441019","0.364517026378"
"SL2.50ch01:5319851-5322326","603","5319851","5322326","2475","1336.01441019","1.85252492872"
"SL2.50ch01:53294157-53294555","50","53294157","53294555","398","1336.01441019","0.297900978436"
"SL2.50ch01:53321430-53321927","124","53321430","53321927","497","1336.01441019","0.372001975585"
"SL2.50ch01:53328203-53328584","153","53328203","53328584","381","1336.01441019","0.285176564785"
"SL2.50ch01:53392195-53392852","4019","53392195","53392852","657","1336.01441019","0.491761162896"
"SL2.50ch01:53392227-53392832","4018","53392227","53392832","605","1336.01441019","0.45283942702"
"SL2.50ch01:53476716-53477201","63","53476716","53477201","485","1336.01441019","0.363020036537"
"SL2.50ch01:53507603-53507984","26","53507603","53507984","381","1336.01441019","0.285176564785"
"SL2.50ch01:54529003-54529517","211","54529003","54529517","514","1336.01441019","0.384726389237"
"SL2.50ch01:54964667-54965302","147","54964667","54965302","635","1336.01441019","0.475294274641"
"SL2.50ch01:55578885-55580294","1865","55578885","55580294","1409","1336.01441019","1.05462934326"
"SL2.50ch01:55579459-55580281","1787","55579459","55580281","822","1336.01441019","0.615262824811"
"SL2.50ch01:56092195-56092526","141","56092195","56092526","331","1336.01441019","0.24775181875"
"SL2.50ch01:56249140-56249692","1715","56249140","56249692","552","1336.01441019","0.413169196223"
"SL2.50ch01:56249191-56249695","1709","56249191","56249695","504","1336.01441019","0.37724144003"
"SL2.50ch01:56268229-56268560","68","56268229","56268560","331","1336.01441019","0.24775181875"
"SL2.50ch01:57183190-57183893","356","57183190","57183893","703","1336.01441019","0.526191929248"
"SL2.50ch01:57183302-57183748","347","57183302","57183748","446","1336.01441019","0.33382873463"
"SL2.50ch01:59207046-59207706","489","59207046","59207706","660","1336.01441019","0.494006647658"
"SL2.50ch01:59207067-59207653","471","59207067","59207653","586","1336.01441019","0.438618023527"
"SL2.50ch01:5969794-5970125","180","5969794","5970125","331","1336.01441019","0.24775181875"
"SL2.50ch01:59811765-59812268","57","59811765","59812268","503","1336.01441019","0.376492945109"
"SL2.50ch01:59925016-59925397","40","59925016","59925397","381","1336.01441019","0.285176564785"
"SL2.50ch01:60203089-60203470","94","60203089","60203470","381","1336.01441019","0.285176564785"
"SL2.50ch01:60368301-60368894","151","60368301","60368894","593","1336.01441019","0.443857487972"
"SL2.50ch01:60369273-60370381","433","60369273","60370381","1108","1336.01441019","0.829332372129"
"SL2.50ch01:60369363-60370299","405","60369363","60370299","936","1336.01441019","0.70059124577"
"SL2.50ch01:60876741-60878784","856","60876741","60878784","2043","1336.01441019","1.52917512298"
"SL2.50ch01:60876808-60878696","842","60876808","60878696","1888","1336.01441019","1.41315841027"
"SL2.50ch01:61418930-61419311","159","61418930","61419311","381","1336.01441019","0.285176564785"
"SL2.50ch01:61861812-61862416","524","61861812","61862416","604","1336.01441019","0.452090932099"
"SL2.50ch01:61862024-61862416","514","61862024","61862416","392","1336.01441019","0.293410008912"
"SL2.50ch01:61983838-61984471","123","61983838","61984471","633","1336.01441019","0.4737972848"
"SL2.50ch01:62189554-62191710","486","62189554","62191710","2156","1336.01441019","1.61375504902"
"SL2.50ch01:62189644-62190491","248","62189644","62190491","847","1336.01441019","0.633975197828"
"SL2.50ch01:63514700-63515104","77","63514700","63515104","404","1336.01441019","0.302391947961"
"SL2.50ch01:63631337-63631718","84","63631337","63631718","381","1336.01441019","0.285176564785"
"SL2.50ch01:63798121-63798929","338","63798121","63798929","808","1336.01441019","0.604783895921"
"SL2.50ch01:63800218-63800840","143","63800218","63800840","622","1336.01441019","0.465563840672"
"SL2.50ch01:63800335-63800716","123","63800335","63800716","381","1336.01441019","0.285176564785"
"SL2.50ch01:63802373-63803524","327","63802373","63803524","1151","1336.01441019","0.861517653719"
"SL2.50ch01:63802467-63803487","306","63802467","63803487","1020","1336.01441019","0.763464819108"
"SL2.50ch01:64585497-64585988","135","64585497","64585988","491","1336.01441019","0.367511006061"
"SL2.50ch01:64585607-64585938","126","64585607","64585938","331","1336.01441019","0.24775181875"
"SL2.50ch01:64640123-64640584","1061","64640123","64640584","461","1336.01441019","0.34505615844"
"SL2.50ch01:64824499-64824830","63","64824499","64824830","331","1336.01441019","0.24775181875"
"SL2.50ch01:65150074-65150455","80","65150074","65150455","381","1336.01441019","0.285176564785"
"SL2.50ch01:65151039-65151567","102","65151039","65151567","528","1336.01441019","0.395205318127"
"SL2.50ch01:65152349-65153034","169","65152349","65153034","685","1336.01441019","0.512719020676"
"SL2.50ch01:65152378-65152953","164","65152378","65152953","575","1336.01441019","0.430384579399"
"SL2.50ch01:65651771-65652420","3898","65651771","65652420","649","1336.01441019","0.485773203531"
"SL2.50ch01:65651851-65652388","3889","65651851","65652388","537","1336.01441019","0.401941772413"
"SL2.50ch01:65923152-65923483","48","65923152","65923483","331","1336.01441019","0.24775181875"
"SL2.50ch01:66008980-66011338","792","66008980","66011338","2358","1336.01441019","1.764951023"
"SL2.50ch01:66013156-66014283","354","66013156","66014283","1127","1336.01441019","0.843553775623"
"SL2.50ch01:66013167-66014271","347","66013167","66014271","1104","1336.01441019","0.826338392447"
"SL2.50ch01:66014871-66016094","410","66014871","66016094","1223","1336.01441019","0.915409288009"
"SL2.50ch01:66014873-66016068","409","66014873","66016068","1195","1336.01441019","0.89445143023"
"SL2.50ch01:66433502-66434215","442","66433502","66434215","713","1336.01441019","0.533676878455"
"SL2.50ch01:66433506-66434095","425","66433506","66434095","589","1336.01441019","0.440863508289"
"SL2.50ch01:67724905-67725308","209","67724905","67725308","403","1336.01441019","0.30164345304"
"SL2.50ch01:69689806-69690539","122","69689806","69690539","733","1336.01441019","0.548646776869"
"SL2.50ch01:69749012-69749393","55","69749012","69749393","381","1336.01441019","0.285176564785"
"SL2.50ch01:7029754-7030489","1251","7029754","7030489","735","1336.01441019","0.55014376671"
"SL2.50ch01:7029756-7030764","1291","7029756","7030764","1008","1336.01441019","0.75448288006"
"SL2.50ch01:7080465-7081931","483","7080465","7081931","1466","1336.01441019","1.09729355374"
"SL2.50ch01:7080467-7082059","500","7080467","7082059","1592","1336.01441019","1.19160391375"
"SL2.50ch01:72633577-72634315","1009","72633577","72634315","738","1336.01441019","0.552389251472"
"SL2.50ch01:72633594-72634284","1004","72633594","72634284","690","1336.01441019","0.516461495279"
"SL2.50ch01:73893700-73894081","99","73893700","73894081","381","1336.01441019","0.285176564785"
"SL2.50ch01:76143227-76143705","415","76143227","76143705","478","1336.01441019","0.357780572092"
"SL2.50ch01:76143301-76143794","419","76143301","76143794","493","1336.01441019","0.369007995902"
"SL2.50ch01:76743963-76744344","361","76743963","76744344","381","1336.01441019","0.285176564785"
"SL2.50ch01:77179128-77179727","72","77179128","77179727","599","1336.01441019","0.448348457496"
"SL2.50ch01:77501278-77502364","334","77501278","77502364","1086","1336.01441019","0.812865483874"
"SL2.50ch01:77501328-77502394","332","77501328","77502394","1066","1336.01441019","0.79789558546"
"SL2.50ch01:77505676-77506654","304","77505676","77506654","978","1336.01441019","0.732028032439"
"SL2.50ch01:77533691-77534343","139","77533691","77534343","652","1336.01441019","0.488018688293"
"SL2.50ch01:77533811-77534373","130","77533811","77534373","562","1336.01441019","0.42065414543"
"SL2.50ch01:78119763-78120315","143","78119763","78120315","552","1336.01441019","0.413169196223"
"SL2.50ch01:78119806-78120283","137","78119806","78120283","477","1336.01441019","0.357032077171"
"SL2.50ch01:80499781-80500543","143","80499781","80500543","762","1336.01441019","0.570353129569"
"SL2.50ch01:81744183-81744564","122","81744183","81744564","381","1336.01441019","0.285176564785"
"SL2.50ch01:82435930-82436624","580","82435930","82436624","694","1336.01441019","0.519455474962"
"SL2.50ch01:82436081-82436557","573","82436081","82436557","476","1336.01441019","0.356283582251"
"SL2.50ch01:82806773-82807407","536","82806773","82807407","634","1336.01441019","0.47454577972"
"SL2.50ch01:82806852-82807233","475","82806852","82807233","381","1336.01441019","0.285176564785"
"SL2.50ch01:84251043-84251523","146","84251043","84251523","480","1336.01441019","0.359277561933"
"SL2.50ch01:84251073-84251675","150","84251073","84251675","602","1336.01441019","0.450593942258"
"SL2.50ch01:84679602-84679985","550","84679602","84679985","383","1336.01441019","0.286673554626"
"SL2.50ch01:84679623-84680027","551","84679623","84680027","404","1336.01441019","0.302391947961"
"SL2.50ch01:84936641-84937409","234","84936641","84937409","768","1336.01441019","0.574844099093"
"SL2.50ch01:84936740-84937321","228","84936740","84937321","581","1336.01441019","0.434875548923"
"SL2.50ch01:85496822-85497632","112","85496822","85497632","810","1336.01441019","0.606280885762"
"SL2.50ch01:85505495-85506453","139","85505495","85506453","958","1336.01441019","0.717058134025"
"SL2.50ch01:86035460-86035841","727","86035460","86035841","381","1336.01441019","0.285176564785"
"SL2.50ch01:86035470-86035891","727","86035470","86035891","421","1336.01441019","0.315116361612"
"SL2.50ch01:87072429-87072760","1229","87072429","87072760","331","1336.01441019","0.24775181875"
"SL2.50ch01:8745060-8745391","39","8745060","8745391","331","1336.01441019","0.24775181875"
"SL2.50ch01:88104737-88105141","582","88104737","88105141","404","1336.01441019","0.302391947961"
"SL2.50ch01:88104760-88105141","582","88104760","88105141","381","1336.01441019","0.285176564785"
"SL2.50ch01:9006265-9006884","2241","9006265","9006884","619","1336.01441019","0.46331835591"
"SL2.50ch01:90133369-90133970","2277","90133369","90133970","601","1336.01441019","0.449845447337"
"SL2.50ch01:90133382-90134008","2278","90133382","90134008","626","1336.01441019","0.468557820355"
"SL2.50ch01:91495632-91496119","3192","91495632","91496119","487","1336.01441019","0.364517026378"
"SL2.50ch01:91495700-91496155","3188","91495700","91496155","455","1336.01441019","0.340565188916"
"SL2.50ch01:92021042-92021481","463","92021042","92021481","439","1336.01441019","0.328589270185"
"SL2.50ch01:92021077-92021560","465","92021077","92021560","483","1336.01441019","0.361523046695"
"SL2.50ch01:93670610-93671740","1510","93670610","93671740","1130","1336.01441019","0.845799260385"
"SL2.50ch01:93670622-93671737","1510","93670622","93671737","1115","1336.01441019","0.834571836574"
"SL2.50ch01:95967789-95968120","90","95967789","95968120","331","1336.01441019","0.24775181875"
"SL2.50ch01:96868512-96870416","1415","96868512","96870416","1904","1336.01441019","1.425134329"
"SL2.50ch01:96868535-96870495","1421","96868535","96870495","1960","1336.01441019","1.46705004456"
"SL2.50ch01:96871050-96871716","332","96871050","96871716","666","1336.01441019","0.498497617182"
"SL2.50ch01:96871112-96871662","317","96871112","96871662","550","1336.01441019","0.411672206382"
"SL2.50ch01:98472724-98473480","225","98472724","98473480","756","1336.01441019","0.565862160045"
"SL2.50ch01:98472911-98473612","201","98472911","98473612","701","1336.01441019","0.524694939407"
"SL2.50ch01:98477499-98477880","106","98477499","98477880","381","1336.01441019","0.285176564785"
"SL2.50ch01:98480524-98480981","241","98480524","98480981","457","1336.01441019","0.342062178757"
"SL2.50ch01:98481412-98482215","269","98481412","98482215","803","1336.01441019","0.601041421318"
"SL2.50ch01:98483865-98484651","219","98483865","98484651","786","1336.01441019","0.588317007666"
"SL2.50ch01:98484076-98484616","187","98484076","98484616","540","1336.01441019","0.404187257175"
"SL2.50ch01:98485517-98485911","100","98485517","98485911","394","1336.01441019","0.294906998754"
"SL2.50ch01:98486289-98487292","339","98486289","98487292","1003","1336.01441019","0.750740405456"
"SL2.50ch01:98488591-98489679","225","98488591","98489679","1088","1336.01441019","0.814362473716"
"SL2.50ch01:98492353-98492828","156","98492353","98492828","475","1336.01441019","0.35553508733"
"SL2.50ch01:98497780-98499222","371","98497780","98499222","1442","1336.01441019","1.07932967564"
"SL2.50ch01:98497809-98499117","356","98497809","98499117","1308","1336.01441019","0.979031356268"
"SL2.50ch01:98501332-98501762","83","98501332","98501762","430","1336.01441019","0.321852815899"
"SL2.50ch01:98502853-98505157","710","98502853","98505157","2304","1336.01441019","1.72453229728"
"SL2.50ch01:98502942-98504832","635","98502942","98504832","1890","1336.01441019","1.41465540011"
"SL2.50ch01:98506801-98507467","193","98506801","98507467","666","1336.01441019","0.498497617182"
"SL2.50ch01:98510382-98510893","94","98510382","98510893","511","1336.01441019","0.382480904475"
"SL2.50ch01:98530565-98530946","106","98530565","98530946","381","1336.01441019","0.285176564785"
"SL2.50ch01:98534666-98535190","177","98534666","98535190","524","1336.01441019","0.392211338444"
"SL2.50ch01:98534700-98535176","177","98534700","98535176","476","1336.01441019","0.356283582251"
"SL2.50ch02:12829609-12830132","123","12829609","12830132","523","1336.01441019","0.391462843523"
"SL2.50ch02:12836089-12838255","748","12836089","12838255","2166","1336.01441019","1.62123999822"
"SL2.50ch02:12839260-12844314","1589","12839260","12844314","5054","1336.01441019","3.78289332919"
"SL2.50ch02:12845287-12847581","740","12845287","12847581","2294","1336.01441019","1.71704734807"
"SL2.50ch02:12850240-12857594","2151","12850240","12857594","7354","1336.01441019","5.50443164679"
"SL2.50ch02:12859332-12864932","2298","12859332","12864932","5600","1336.01441019","4.19157155589"
"SL2.50ch02:12866874-12868146","388","12866874","12868146","1272","1336.01441019","0.952085539123"
"SL2.50ch02:12867016-12868053","365","12867016","12868053","1037","1336.01441019","0.77618923276"
"SL2.50ch02:12883728-12884393","223","12883728","12884393","665","1336.01441019","0.497749122262"
"SL2.50ch02:12887543-12888578","500","12887543","12888578","1035","1336.01441019","0.774692242919"
"SL2.50ch02:12918392-12919241","171","12918392","12919241","849","1336.01441019","0.63547218767"
"SL2.50ch02:12971061-12972855","636","12971061","12972855","1794","1336.01441019","1.34279988773"
"SL2.50ch02:12993663-12995536","597","12993663","12995536","1873","1336.01441019","1.40193098646"
"SL2.50ch02:13002579-13003837","357","13002579","13003837","1258","1336.01441019","0.941606610234"
"SL2.50ch02:13773265-13773884","217","13773265","13773884","619","1336.01441019","0.46331835591"
"SL2.50ch02:13775574-13775995","142","13775574","13775995","421","1336.01441019","0.315116361612"
"SL2.50ch02:13775666-13775997","132","13775666","13775997","331","1336.01441019","0.24775181875"
"SL2.50ch02:13779183-13780814","3148","13779183","13780814","1631","1336.01441019","1.22079521565"
"SL2.50ch02:13784653-13786368","2215","13784653","13786368","1715","1336.01441019","1.28366878899"
"SL2.50ch02:13787338-13787905","1085","13787338","13787905","567","1336.01441019","0.424396620034"
"SL2.50ch02:13787398-13787830","1075","13787398","13787830","432","1336.01441019","0.32334980574"
"SL2.50ch02:13788336-13788667","179","13788336","13788667","331","1336.01441019","0.24775181875"
"SL2.50ch02:13823623-13824558","830","13823623","13824558","935","1336.01441019","0.699842750849"
"SL2.50ch02:13823686-13824265","784","13823686","13824265","579","1336.01441019","0.433378559082"
"SL2.50ch02:13827287-13830147","3133","13827287","13830147","2860","1336.01441019","2.14069547319"
"SL2.50ch02:13830918-13833224","5764","13830918","13833224","2306","1336.01441019","1.72602928712"
"SL2.50ch02:13831037-13833217","5759","13831037","13833217","2180","1336.01441019","1.63171892711"
"SL2.50ch02:13874890-13879485","1432","13874890","13879485","4595","1336.01441019","3.43933416059"
"SL2.50ch02:15331721-15332318","460","15331721","15332318","597","1336.01441019","0.446851467655"
"SL2.50ch02:15331783-15332301","453","15331783","15332301","518","1336.01441019","0.38772036892"
"SL2.50ch02:17880687-17881091","393","17880687","17881091","404","1336.01441019","0.302391947961"
"SL2.50ch02:17880688-17881069","393","17880688","17881069","381","1336.01441019","0.285176564785"
"SL2.50ch02:17882138-17882864","1965","17882138","17882864","726","1336.01441019","0.543407312424"
"SL2.50ch02:17882156-17882923","1967","17882156","17882923","767","1336.01441019","0.574095604173"
"SL2.50ch02:19051081-19051687","303","19051081","19051687","606","1336.01441019","0.453587921941"
"SL2.50ch02:19051097-19051615","298","19051097","19051615","518","1336.01441019","0.38772036892"
"SL2.50ch02:19066183-19066514","48","19066183","19066514","331","1336.01441019","0.24775181875"
"SL2.50ch02:19905211-19906846","346","19905211","19906846","1635","1336.01441019","1.22378919534"
"SL2.50ch02:19909800-19910323","72","19909800","19910323","523","1336.01441019","0.391462843523"
"SL2.50ch02:20737373-20738019","504","20737373","20738019","646","1336.01441019","0.483527718769"
"SL2.50ch02:20737437-20737936","499","20737437","20737936","499","1336.01441019","0.373498965427"
"SL2.50ch02:2190847-2191262","187","2190847","2191262","415","1336.01441019","0.310625392088"
"SL2.50ch02:22601433-22602119","234","22601433","22602119","686","1336.01441019","0.513467515596"
"SL2.50ch02:23287429-23287833","398","23287429","23287833","404","1336.01441019","0.302391947961"
"SL2.50ch02:23287478-23287870","394","23287478","23287870","392","1336.01441019","0.293410008912"
"SL2.50ch02:23767720-23768631","819","23767720","23768631","911","1336.01441019","0.681878872753"
"SL2.50ch02:23768011-23768606","771","23768011","23768606","595","1336.01441019","0.445354477813"
"SL2.50ch02:24414076-24414457","54","24414076","24414457","381","1336.01441019","0.285176564785"
"SL2.50ch02:24490793-24495381","13270","24490793","24495381","4588","1336.01441019","3.43409469615"
"SL2.50ch02:24490875-24495357","13262","24490875","24495357","4482","1336.01441019","3.35475423455"
"SL2.50ch02:24495822-24496616","2385","24495822","24496616","794","1336.01441019","0.594304967031"
"SL2.50ch02:24495838-24496627","2377","24495838","24496627","789","1336.01441019","0.590562492428"
"SL2.50ch02:24497847-24498453","711","24497847","24498453","606","1336.01441019","0.453587921941"
"SL2.50ch02:24497872-24498348","701","24497872","24498348","476","1336.01441019","0.356283582251"
"SL2.50ch02:24507100-24507673","557","24507100","24507673","573","1336.01441019","0.428887589558"
"SL2.50ch02:24507156-24507711","553","24507156","24507711","555","1336.01441019","0.415414680985"
"SL2.50ch02:24512859-24514476","6142","24512859","24514476","1617","1336.01441019","1.21031628676"
"SL2.50ch02:24512867-24514509","6142","24512867","24514509","1642","1336.01441019","1.22902865978"
"SL2.50ch02:24531766-24533080","2971","24531766","24533080","1314","1336.01441019","0.983522325792"
"SL2.50ch02:24531811-24533117","2972","24531811","24533117","1306","1336.01441019","0.977534366427"
"SL2.50ch02:24850228-24850639","91","24850228","24850639","411","1336.01441019","0.307631412405"
"SL2.50ch02:24948053-24951171","641","24948053","24951171","3118","1336.01441019","2.33380716273"
"SL2.50ch02:24978476-24978986","145","24978476","24978986","510","1336.01441019","0.381732409554"
"SL2.50ch02:24987144-24988110","177","24987144","24988110","966","1336.01441019","0.723046093391"
"SL2.50ch02:24999075-24999406","73","24999075","24999406","331","1336.01441019","0.24775181875"
"SL2.50ch02:25003025-25006388","636","25003025","25006388","3363","1336.01441019","2.5171884183"
"SL2.50ch02:25015526-25016734","254","25015526","25016734","1208","1336.01441019","0.904181864199"
"SL2.50ch02:25022033-25022414","110","25022033","25022414","381","1336.01441019","0.285176564785"
"SL2.50ch02:26874689-26875105","256","26874689","26875105","416","1336.01441019","0.311373887009"
"SL2.50ch02:2908928-2909609","1156","2908928","2909609","681","1336.01441019","0.509725040993"
"SL2.50ch02:2908986-2909736","1162","2908986","2909736","750","1336.01441019","0.561371190521"
"SL2.50ch02:30278226-30278703","90","30278226","30278703","477","1336.01441019","0.357032077171"
"SL2.50ch02:30278278-30278682","89","30278278","30278682","404","1336.01441019","0.302391947961"
"SL2.50ch02:30497802-30498183","854","30497802","30498183","381","1336.01441019","0.285176564785"
"SL2.50ch02:31141816-31142341","55","31141816","31142341","525","1336.01441019","0.392959833365"
"SL2.50ch02:31406371-31406949","93","31406371","31406949","578","1336.01441019","0.432630064161"
"SL2.50ch02:32942115-32942594","109","32942115","32942594","479","1336.01441019","0.358529067013"
"SL2.50ch02:32942122-32942503","105","32942122","32942503","381","1336.01441019","0.285176564785"
"SL2.50ch02:32963117-32963498","295","32963117","32963498","381","1336.01441019","0.285176564785"
"SL2.50ch02:32973574-32973905","72","32973574","32973905","331","1336.01441019","0.24775181875"
"SL2.50ch02:32973617-32974123","93","32973617","32974123","506","1336.01441019","0.378738429871"
"SL2.50ch02:32976656-32977061","232","32976656","32977061","405","1336.01441019","0.303140442881"
"SL2.50ch02:32984562-32984978","75","32984562","32984978","416","1336.01441019","0.311373887009"
"SL2.50ch02:33077633-33077947","66","33077633","33077947","314","1336.01441019","0.235027405098"
"SL2.50ch02:36472031-36472412","108","36472031","36472412","381","1336.01441019","0.285176564785"
"SL2.50ch02:36474435-36479246","1933","36474435","36479246","4811","1336.01441019","3.60100906346"
"SL2.50ch02:36474509-36478841","1854","36474509","36478841","4332","1336.01441019","3.24247999645"
"SL2.50ch02:36945306-36945687","41","36945306","36945687","381","1336.01441019","0.285176564785"
"SL2.50ch02:37743077-37743458","752","37743077","37743458","381","1336.01441019","0.285176564785"
"SL2.50ch02:37743115-37743429","751","37743115","37743429","314","1336.01441019","0.235027405098"
"SL2.50ch02:38735776-38736107","61","38735776","38736107","331","1336.01441019","0.24775181875"
"SL2.50ch02:39031505-39031909","45","39031505","39031909","404","1336.01441019","0.302391947961"
"SL2.50ch02:39033808-39034637","203","39033808","39034637","829","1336.01441019","0.620502289256"
"SL2.50ch02:39033861-39034488","170","39033861","39034488","627","1336.01441019","0.469306315275"
"SL2.50ch02:41500703-41501189","291","41500703","41501189","486","1336.01441019","0.363768531457"
"SL2.50ch02:41500770-41501174","286","41500770","41501174","404","1336.01441019","0.302391947961"
"SL2.50ch02:41740526-41746005","1189","41740526","41746005","5479","1336.01441019","4.10100367048"
"SL2.50ch02:41742793-41747605","1217","41742793","41747605","4812","1336.01441019","3.60175755838"
"SL2.50ch02:41747630-41749102","266","41747630","41749102","1472","1336.01441019","1.10178452326"
"SL2.50ch02:41958508-41958839","547","41958508","41958839","331","1336.01441019","0.24775181875"
"SL2.50ch02:44549133-44549754","8380","44549133","44549754","621","1336.01441019","0.464815345751"
"SL2.50ch02:44549141-44549732","8377","44549141","44549732","591","1336.01441019","0.44236049813"
"SL2.50ch02:44818399-44819146","15463","44818399","44819146","747","1336.01441019","0.559125705759"
"SL2.50ch02:44818552-44819123","15456","44818552","44819123","571","1336.01441019","0.427390599717"
"SL2.50ch02:45016484-45016815","188","45016484","45016815","331","1336.01441019","0.24775181875"
"SL2.50ch02:45768024-45768355","39","45768024","45768355","331","1336.01441019","0.24775181875"
"SL2.50ch02:47573514-47573845","54","47573514","47573845","331","1336.01441019","0.24775181875"
"SL2.50ch02:47588308-47588712","63","47588308","47588712","404","1336.01441019","0.302391947961"
"SL2.50ch02:47694739-47695070","252","47694739","47695070","331","1336.01441019","0.24775181875"
"SL2.50ch02:48371660-48372144","336","48371660","48372144","484","1336.01441019","0.362271541616"
"SL2.50ch02:48371716-48372177","337","48371716","48372177","461","1336.01441019","0.34505615844"
"SL2.50ch02:48732997-48733856","167","48732997","48733856","859","1336.01441019","0.642957136876"
"SL2.50ch02:48733190-48733850","151","48733190","48733850","660","1336.01441019","0.494006647658"
"SL2.50ch02:49313147-49313478","49","49313147","49313478","331","1336.01441019","0.24775181875"
"SL2.50ch02:49904154-49904808","220","49904154","49904808","654","1336.01441019","0.489515678134"
"SL2.50ch02:49904278-49904659","176","49904278","49904659","381","1336.01441019","0.285176564785"
"SL2.50ch02:51682010-51682391","344","51682010","51682391","381","1336.01441019","0.285176564785"
"SL2.50ch02:51682021-51682425","344","51682021","51682425","404","1336.01441019","0.302391947961"
"SL2.50ch02:5181503-5181884","49","5181503","5181884","381","1336.01441019","0.285176564785"
"SL2.50ch02:52487696-52488109","120","52487696","52488109","413","1336.01441019","0.309128402247"
"SL2.50ch02:52487726-52488168","116","52487726","52488168","442","1336.01441019","0.330834754947"
"SL2.50ch02:53630270-53630674","318","53630270","53630674","404","1336.01441019","0.302391947961"
"SL2.50ch02:53630278-53630659","317","53630278","53630659","381","1336.01441019","0.285176564785"
"SL2.50ch02:61080-61962","175","61080","61962","882","1336.01441019","0.660172520052"
"SL2.50ch02:6346252-6346737","171","6346252","6346737","485","1336.01441019","0.363020036537"
"SL2.50ch02:6346354-6346685","154","6346354","6346685","331","1336.01441019","0.24775181875"
"SL2.50ch02:6347850-6348384","218","6347850","6348384","534","1336.01441019","0.399696287651"
"SL2.50ch02:8193589-8193920","284","8193589","8193920","331","1336.01441019","0.24775181875"
"SL2.50ch02:8462188-8462569","75","8462188","8462569","381","1336.01441019","0.285176564785"
"SL2.50ch02:8892026-8893262","185","8892026","8893262","1236","1336.01441019","0.925139721978"
"SL2.50ch02:9251199-9251834","1180","9251199","9251834","635","1336.01441019","0.475294274641"
"SL2.50ch02:9324555-9324936","37","9324555","9324936","381","1336.01441019","0.285176564785"
"SL2.50ch02:9407238-9419280","5307","9407238","9419280","12042","1336.01441019","9.013375835"
"SL2.50ch02:9423880-9427239","1484","9423880","9427239","3359","1336.01441019","2.51419443861"
"SL2.50ch02:9522461-9523269","111","9522461","9523269","808","1336.01441019","0.604783895921"
"SL2.50ch03:1058317-1058710","87","1058317","1058710","393","1336.01441019","0.294158503833"
"SL2.50ch03:1058318-1058722","87","1058318","1058722","404","1336.01441019","0.302391947961"
"SL2.50ch03:11745710-11748231","700","11745710","11748231","2521","1336.01441019","1.88695569507"
"SL2.50ch03:12705966-12706508","87","12705966","12706508","542","1336.01441019","0.405684247016"
"SL2.50ch03:13311547-13311928","68","13311547","13311928","381","1336.01441019","0.285176564785"
"SL2.50ch03:13318242-13320196","689","13318242","13320196","1954","1336.01441019","1.46255907504"
"SL2.50ch03:13345110-13345650","239","13345110","13345650","540","1336.01441019","0.404187257175"
"SL2.50ch03:13346186-13346662","109","13346186","13346662","476","1336.01441019","0.356283582251"
"SL2.50ch03:13361771-13363248","708","13361771","13363248","1477","1336.01441019","1.10552699787"
"SL2.50ch03:13361894-13363260","692","13361894","13363260","1366","1336.01441019","1.02244406167"
"SL2.50ch03:13366641-13367356","239","13366641","13367356","715","1336.01441019","0.535173868296"
"SL2.50ch03:13366659-13367442","255","13366659","13367442","783","1336.01441019","0.586071522904"
"SL2.50ch03:13368063-13372304","1544","13368063","13372304","4241","1336.01441019","3.17436695866"
"SL2.50ch03:15952973-15954262","683","15952973","15954262","1289","1336.01441019","0.964809952775"
"SL2.50ch03:15955771-15957606","889","15955771","15957606","1835","1336.01441019","1.37348817947"
"SL2.50ch03:15955780-15957531","889","15955780","15957531","1751","1336.01441019","1.31061460614"
"SL2.50ch03:15958712-15960873","876","15958712","15960873","2161","1336.01441019","1.61749752362"
"SL2.50ch03:15958762-15960717","856","15958762","15960717","1955","1336.01441019","1.46330756996"
"SL2.50ch03:1596313-1596727","140","1596313","1596727","414","1336.01441019","0.309876897167"
"SL2.50ch03:15969035-15969863","1585","15969035","15969863","828","1336.01441019","0.619753794335"
"SL2.50ch03:15969117-15970109","1556","15969117","15970109","992","1336.01441019","0.742506961329"
"SL2.50ch03:15971446-15973065","1109","15971446","15973065","1619","1336.01441019","1.2118132766"
"SL2.50ch03:15971661-15973115","1077","15971661","15973115","1454","1336.01441019","1.08831161469"
"SL2.50ch03:15974113-15977441","3107","15974113","15977441","3328","1336.01441019","2.49099109607"
"SL2.50ch03:15974260-15974674","210","15974260","15974674","414","1336.01441019","0.309876897167"
"SL2.50ch03:15975126-15977534","2834","15975126","15977534","2408","1336.01441019","1.80237576903"
"SL2.50ch03:16158911-16159242","46","16158911","16159242","331","1336.01441019","0.24775181875"
"SL2.50ch03:16290483-16291380","301","16290483","16291380","897","1336.01441019","0.671399943863"
"SL2.50ch03:16781741-16782486","186","16781741","16782486","745","1336.01441019","0.557628715917"
"SL2.50ch03:16813615-16814156","706","16813615","16814156","541","1336.01441019","0.404935752096"
"SL2.50ch03:16813701-16814086","688","16813701","16814086","385","1336.01441019","0.288170544467"
"SL2.50ch03:16988842-16989467","362","16988842","16989467","625","1336.01441019","0.467809325434"
"SL2.50ch03:16988892-16989402","352","16988892","16989402","510","1336.01441019","0.381732409554"
"SL2.50ch03:18337424-18337805","41","18337424","18337805","381","1336.01441019","0.285176564785"
"SL2.50ch03:19264433-19265103","262","19264433","19265103","670","1336.01441019","0.501491596865"
"SL2.50ch03:19264699-19265080","219","19264699","19265080","381","1336.01441019","0.285176564785"
"SL2.50ch03:19394226-19394607","66","19394226","19394607","381","1336.01441019","0.285176564785"
"SL2.50ch03:1949080-1949567","175","1949080","1949567","487","1336.01441019","0.364517026378"
"SL2.50ch03:19647429-19647810","82","19647429","19647810","381","1336.01441019","0.285176564785"
"SL2.50ch03:19922927-19923406","73","19922927","19923406","479","1336.01441019","0.358529067013"
"SL2.50ch03:20510356-20510926","227","20510356","20510926","570","1336.01441019","0.426642104796"
"SL2.50ch03:20510518-20510906","211","20510518","20510906","388","1336.01441019","0.290416029229"
"SL2.50ch03:21396540-21396921","60","21396540","21396921","381","1336.01441019","0.285176564785"
"SL2.50ch03:21452593-21452974","130","21452593","21452974","381","1336.01441019","0.285176564785"
"SL2.50ch03:22923133-22923817","201","22923133","22923817","684","1336.01441019","0.511970525755"
"SL2.50ch03:22923320-22923701","158","22923320","22923701","381","1336.01441019","0.285176564785"
"SL2.50ch03:23694487-23695402","3163","23694487","23695402","915","1336.01441019","0.684872852435"
"SL2.50ch03:23694570-23695391","3159","23694570","23695391","821","1336.01441019","0.61451432989"
"SL2.50ch03:23696853-23697416","1169","23696853","23697416","563","1336.01441019","0.421402640351"
"SL2.50ch03:23696863-23697427","1165","23696863","23697427","564","1336.01441019","0.422151135272"
"SL2.50ch03:24533819-24534239","177","24533819","24534239","420","1336.01441019","0.314367866692"
"SL2.50ch03:25795003-25795664","4040","25795003","25795664","661","1336.01441019","0.494755142579"
"SL2.50ch03:25795086-25795500","4022","25795086","25795500","414","1336.01441019","0.309876897167"
"SL2.50ch03:29000823-29001154","52","29000823","29001154","331","1336.01441019","0.24775181875"
"SL2.50ch03:29749990-29750798","159","29749990","29750798","808","1336.01441019","0.604783895921"
"SL2.50ch03:30365258-30370045","11927","30365258","30370045","4787","1336.01441019","3.58304518536"
"SL2.50ch03:30365362-30369911","11904","30365362","30369911","4549","1336.01441019","3.40490339424"
"SL2.50ch03:30882310-30882641","43","30882310","30882641","331","1336.01441019","0.24775181875"
"SL2.50ch03:31622139-31623807","533","31622139","31623807","1668","1336.01441019","1.24848952772"
"SL2.50ch03:3174764-3175236","400","3174764","3175236","472","1336.01441019","0.353289602568"
"SL2.50ch03:3174801-3175182","395","3174801","3175182","381","1336.01441019","0.285176564785"
"SL2.50ch03:32171053-32172261","5457","32171053","32172261","1208","1336.01441019","0.904181864199"
"SL2.50ch03:32171158-32172318","5461","32171158","32172318","1160","1336.01441019","0.868254108006"
"SL2.50ch03:3264920-3265251","384","3264920","3265251","331","1336.01441019","0.24775181875"
"SL2.50ch03:33136406-33137028","23517","33136406","33137028","622","1336.01441019","0.465563840672"
"SL2.50ch03:33136430-33137011","23515","33136430","33137011","581","1336.01441019","0.434875548923"
"SL2.50ch03:33645135-33645516","60","33645135","33645516","381","1336.01441019","0.285176564785"
"SL2.50ch03:33785250-33785654","90","33785250","33785654","404","1336.01441019","0.302391947961"
"SL2.50ch03:34590888-34592949","2092","34590888","34592949","2061","1336.01441019","1.54264803155"
"SL2.50ch03:34595118-34596134","1889","34595118","34596134","1016","1336.01441019","0.760470839426"
"SL2.50ch03:34595177-34596062","1883","34595177","34596062","885","1336.01441019","0.662418004815"
"SL2.50ch03:34597537-34598912","2364","34597537","34598912","1375","1336.01441019","1.02918051595"
"SL2.50ch03:34597548-34598952","2370","34597548","34598952","1404","1336.01441019","1.05088686865"
"SL2.50ch03:34599575-34601701","8003","34599575","34601701","2126","1336.01441019","1.5913002014"
"SL2.50ch03:34599897-34601556","7929","34599897","34601556","1659","1336.01441019","1.24175307343"
"SL2.50ch03:34605836-34608910","9758","34605836","34608910","3074","1336.01441019","2.30087338621"
"SL2.50ch03:34606158-34608868","9701","34606158","34608868","2710","1336.01441019","2.02842123508"
"SL2.50ch03:36362070-36362451","62","36362070","36362451","381","1336.01441019","0.285176564785"
"SL2.50ch03:37388170-37388998","1932","37388170","37388998","828","1336.01441019","0.619753794335"
"SL2.50ch03:37388317-37389021","1904","37388317","37389021","704","1336.01441019","0.526940424169"
"SL2.50ch03:37793068-37793615","109","37793068","37793615","547","1336.01441019","0.40942672162"
"SL2.50ch03:3963188-3963579","68","3963188","3963579","391","1336.01441019","0.292661513992"
"SL2.50ch03:39746106-39747541","400","39746106","39747541","1435","1336.01441019","1.0740902112"
"SL2.50ch03:39746229-39747518","371","39746229","39747518","1289","1336.01441019","0.964809952775"
"SL2.50ch03:40339033-40339364","44","40339033","40339364","331","1336.01441019","0.24775181875"
"SL2.50ch03:407189-407972","213","407189","407972","783","1336.01441019","0.586071522904"
"SL2.50ch03:407380-407915","174","407380","407915","535","1336.01441019","0.400444782572"
"SL2.50ch03:41347342-41347919","691","41347342","41347919","577","1336.01441019","0.431881569241"
"SL2.50ch03:41347361-41347842","685","41347361","41347842","481","1336.01441019","0.360026056854"
"SL2.50ch03:41525374-41525958","196","41525374","41525958","584","1336.01441019","0.437121033686"
"SL2.50ch03:41526620-41528858","655","41526620","41528858","2238","1336.01441019","1.67513163251"
"SL2.50ch03:44111860-44114474","19142","44111860","44114474","2614","1336.01441019","1.9565657227"
"SL2.50ch03:44112081-44114465","19133","44112081","44114465","2384","1336.01441019","1.78441189094"
"SL2.50ch03:44115847-44117045","21980","44115847","44117045","1198","1336.01441019","0.896696914992"
"SL2.50ch03:44115883-44116989","21777","44115883","44116989","1106","1336.01441019","0.827835382288"
"SL2.50ch03:44391801-44392283","312","44391801","44392283","482","1336.01441019","0.360774551775"
"SL2.50ch03:44452817-44453309","257","44452817","44453309","492","1336.01441019","0.368259500982"
"SL2.50ch03:44457183-44457618","228","44457183","44457618","435","1336.01441019","0.325595290502"
"SL2.50ch03:44459272-44459690","176","44459272","44459690","418","1336.01441019","0.31287087685"
"SL2.50ch03:45183694-45184302","88","45183694","45184302","608","1336.01441019","0.455084911782"
"SL2.50ch03:45379864-45380535","216","45379864","45380535","671","1336.01441019","0.502240091786"
"SL2.50ch03:45802648-45803172","93","45802648","45803172","524","1336.01441019","0.392211338444"
"SL2.50ch03:46424746-46425077","144","46424746","46425077","331","1336.01441019","0.24775181875"
"SL2.50ch03:46578184-46580068","499","46578184","46580068","1884","1336.01441019","1.41016443059"
"SL2.50ch03:48907463-48909035","1566","48907463","48909035","1572","1336.01441019","1.17663401533"
"SL2.50ch03:48907468-48908450","1370","48907468","48908450","982","1336.01441019","0.735022012122"
"SL2.50ch03:50332867-50333433","135","50332867","50333433","566","1336.01441019","0.423648125113"
"SL2.50ch03:51702380-51703024","3043","51702380","51703024","644","1336.01441019","0.482030728927"
"SL2.50ch03:51702397-51702993","3043","51702397","51702993","596","1336.01441019","0.446102972734"
"SL2.50ch03:52270746-52271863","303","52270746","52271863","1117","1336.01441019","0.836068826416"
"SL2.50ch03:52597412-52597793","274","52597412","52597793","381","1336.01441019","0.285176564785"
"SL2.50ch03:52597428-52597871","276","52597428","52597871","443","1336.01441019","0.331583249868"
"SL2.50ch03:53569737-53570118","175","53569737","53570118","381","1336.01441019","0.285176564785"
"SL2.50ch03:53623586-53624166","465","53623586","53624166","580","1336.01441019","0.434127054003"
"SL2.50ch03:53623660-53624115","451","53623660","53624115","455","1336.01441019","0.340565188916"
"SL2.50ch03:53627847-53628538","2805","53627847","53628538","691","1336.01441019","0.5172099902"
"SL2.50ch03:53627897-53628562","2806","53627897","53628562","665","1336.01441019","0.497749122262"
"SL2.50ch03:53931251-53932697","477","53931251","53932697","1446","1336.01441019","1.08232365532"
"SL2.50ch03:53931260-53932687","474","53931260","53932687","1427","1336.01441019","1.06810225183"
"SL2.50ch03:54169521-54172079","788","54169521","54172079","2558","1336.01441019","1.91465000714"
"SL2.50ch03:54169545-54173017","914","54169545","54173017","3472","1336.01441019","2.59877436465"
"SL2.50ch03:54176311-54177270","486","54176311","54177270","959","1336.01441019","0.717806628946"
"SL2.50ch03:54176482-54177200","456","54176482","54177200","718","1336.01441019","0.537419353059"
"SL2.50ch03:54178552-54178933","82","54178552","54178933","381","1336.01441019","0.285176564785"
"SL2.50ch03:54181376-54181794","269","54181376","54181794","418","1336.01441019","0.31287087685"
"SL2.50ch03:54184133-54185223","217","54184133","54185223","1090","1336.01441019","0.815859463557"
"SL2.50ch03:56488712-56490419","7609","56488712","56490419","1707","1336.01441019","1.27768082963"
"SL2.50ch03:56488743-56490393","7604","56488743","56490393","1650","1336.01441019","1.23501661915"
"SL2.50ch03:59443405-59443736","172","59443405","59443736","331","1336.01441019","0.24775181875"
"SL2.50ch03:5997176-5997655","112","5997176","5997655","479","1336.01441019","0.358529067013"
"SL2.50ch03:60238707-60239292","95","60238707","60239292","585","1336.01441019","0.437869528606"
"SL2.50ch03:60259367-60259698","43","60259367","60259698","331","1336.01441019","0.24775181875"
"SL2.50ch03:60833776-60835353","294","60833776","60835353","1577","1336.01441019","1.18037648994"
"SL2.50ch03:60837758-60838548","163","60837758","60838548","790","1336.01441019","0.591310987349"
"SL2.50ch03:60877408-60877838","92","60877408","60877838","430","1336.01441019","0.321852815899"
"SL2.50ch03:60887023-60887890","178","60887023","60887890","867","1336.01441019","0.648945096242"
"SL2.50ch03:62569572-62569953","468","62569572","62569953","381","1336.01441019","0.285176564785"
"SL2.50ch03:6433412-6434088","167","6433412","6434088","676","1336.01441019","0.505982566389"
"SL2.50ch03:6433585-6433966","120","6433585","6433966","381","1336.01441019","0.285176564785"
"SL2.50ch03:6454508-6455101","119","6454508","6455101","593","1336.01441019","0.443857487972"
"SL2.50ch03:64820415-64821556","292","64820415","64821556","1141","1336.01441019","0.854032704512"
"SL2.50ch03:64827514-64828534","177","64827514","64828534","1020","1336.01441019","0.763464819108"
"SL2.50ch03:64829794-64830331","93","64829794","64830331","537","1336.01441019","0.401941772413"
"SL2.50ch03:64835372-64835703","70","64835372","64835703","331","1336.01441019","0.24775181875"
"SL2.50ch03:64925645-64929544","1303","64925645","64929544","3899","1336.01441019","2.91838169579"
"SL2.50ch03:65655543-65655992","283","65655543","65655992","449","1336.01441019","0.336074219392"
"SL2.50ch03:65655611-65656015","281","65655611","65656015","404","1336.01441019","0.302391947961"
"SL2.50ch03:65838805-65839386","634","65838805","65839386","581","1336.01441019","0.434875548923"
"SL2.50ch03:65838875-65839279","629","65838875","65839279","404","1336.01441019","0.302391947961"
"SL2.50ch03:6838333-6838947","141","6838333","6838947","614","1336.01441019","0.459575881306"
"SL2.50ch03:6838427-6839096","152","6838427","6839096","669","1336.01441019","0.500743101945"
"SL2.50ch03:6842160-6843334","216","6842160","6843334","1174","1336.01441019","0.878733036895"
"SL2.50ch03:6846720-6847146","148","6846720","6847146","426","1336.01441019","0.318858836216"
"SL2.50ch03:6857162-6858973","546","6857162","6858973","1811","1336.01441019","1.35552430138"
"SL2.50ch03:6857252-6859124","556","6857252","6859124","1872","1336.01441019","1.40118249154"
"SL2.50ch03:6868406-6870317","519","6868406","6870317","1911","1336.01441019","1.43037379345"
"SL2.50ch03:6871197-6872353","319","6871197","6872353","1156","1336.01441019","0.865260128323"
"SL2.50ch03:6883183-6884180","231","6883183","6884180","997","1336.01441019","0.746249435932"
"SL2.50ch03:6883219-6884161","226","6883219","6884161","942","1336.01441019","0.705082215294"
"SL2.50ch03:6921438-6922525","150","6921438","6922525","1087","1336.01441019","0.813613978795"
"SL2.50ch03:6921908-6922783","126","6921908","6922783","875","1336.01441019","0.654933055608"
"SL2.50ch03:6938417-6939798","272","6938417","6939798","1381","1336.01441019","1.03367148548"
"SL2.50ch03:6947107-6948856","474","6947107","6948856","1749","1336.01441019","1.30911761629"
"SL2.50ch03:6947149-6948532","397","6947149","6948532","1383","1336.01441019","1.03516847532"
"SL2.50ch03:6951415-6952931","322","6951415","6952931","1516","1336.01441019","1.13471829977"
"SL2.50ch03:6951458-6953280","392","6951458","6953280","1822","1336.01441019","1.36375774551"
"SL2.50ch03:6965402-6966234","273","6965402","6966234","832","1336.01441019","0.622747774018"
"SL2.50ch03:70528901-70529381","897","70528901","70529381","480","1336.01441019","0.359277561933"
"SL2.50ch03:70528934-70529411","897","70528934","70529411","477","1336.01441019","0.357032077171"
"SL2.50ch03:7105740-7106154","275","7105740","7106154","414","1336.01441019","0.309876897167"
"SL2.50ch03:7109711-7110042","130","7109711","7110042","331","1336.01441019","0.24775181875"
"SL2.50ch03:9711046-9711377","43","9711046","9711377","331","1336.01441019","0.24775181875"
"SL2.50ch04:11167926-11168307","595","11167926","11168307","381","1336.01441019","0.285176564785"
"SL2.50ch04:11568557-11568938","216","11568557","11568938","381","1336.01441019","0.285176564785"
"SL2.50ch04:11568580-11568984","216","11568580","11568984","404","1336.01441019","0.302391947961"
"SL2.50ch04:12098243-12099159","251","12098243","12099159","916","1336.01441019","0.685621347356"
"SL2.50ch04:12101156-12101792","245","12101156","12101792","636","1336.01441019","0.476042769562"
"SL2.50ch04:12101275-12101773","233","12101275","12101773","498","1336.01441019","0.372750470506"
"SL2.50ch04:13811358-13811739","30","13811358","13811739","381","1336.01441019","0.285176564785"
"SL2.50ch04:14616245-14616921","231","14616245","14616921","676","1336.01441019","0.505982566389"
"SL2.50ch04:14616362-14616870","219","14616362","14616870","508","1336.01441019","0.380235419713"
"SL2.50ch04:14685495-14686456","185","14685495","14686456","961","1336.01441019","0.719303618787"
"SL2.50ch04:14731562-14732266","163","14731562","14732266","704","1336.01441019","0.526940424169"
"SL2.50ch04:14738437-14739052","152","14738437","14739052","615","1336.01441019","0.460324376227"
"SL2.50ch04:14738906-14739287","69","14738906","14739287","381","1336.01441019","0.285176564785"
"SL2.50ch04:14742378-14743652","261","14742378","14743652","1274","1336.01441019","0.953582528965"
"SL2.50ch04:14768522-14769939","358","14768522","14769939","1417","1336.01441019","1.06061730262"
"SL2.50ch04:14768650-14769717","296","14768650","14769717","1067","1336.01441019","0.798644080381"
"SL2.50ch04:14808043-14809946","513","14808043","14809946","1903","1336.01441019","1.42438583408"
"SL2.50ch04:14814113-14814610","141","14814113","14814610","497","1336.01441019","0.372001975585"
"SL2.50ch04:14834318-14836915","634","14834318","14836915","2597","1336.01441019","1.94384130904"
"SL2.50ch04:14841425-14842026","114","14841425","14842026","601","1336.01441019","0.449845447337"
"SL2.50ch04:15038357-15041426","865","15038357","15041426","3069","1336.01441019","2.29713091161"
"SL2.50ch04:15038450-15041435","859","15038450","15041435","2985","1336.01441019","2.23425733827"
"SL2.50ch04:16897815-16898196","41","16897815","16898196","381","1336.01441019","0.285176564785"
"SL2.50ch04:17160905-17161286","146","17160905","17161286","381","1336.01441019","0.285176564785"
"SL2.50ch04:17450904-17451334","200","17450904","17451334","430","1336.01441019","0.321852815899"
"SL2.50ch04:17950940-17951321","42","17950940","17951321","381","1336.01441019","0.285176564785"
"SL2.50ch04:18560486-18561108","1692","18560486","18561108","622","1336.01441019","0.465563840672"
"SL2.50ch04:18560509-18561081","1688","18560509","18561081","572","1336.01441019","0.428139094637"
"SL2.50ch04:19321854-19322395","99","19321854","19322395","541","1336.01441019","0.404935752096"
"SL2.50ch04:19324757-19325964","334","19324757","19325964","1207","1336.01441019","0.903433369278"
"SL2.50ch04:19336793-19337124","93","19336793","19337124","331","1336.01441019","0.24775181875"
"SL2.50ch04:21631398-21631886","97","21631398","21631886","488","1336.01441019","0.365265521299"
"SL2.50ch04:22738936-22739317","52","22738936","22739317","381","1336.01441019","0.285176564785"
"SL2.50ch04:248035-248441","261","248035","248441","406","1336.01441019","0.303888937802"
"SL2.50ch04:248047-248451","261","248047","248451","404","1336.01441019","0.302391947961"
"SL2.50ch04:2506311-2506692","61","2506311","2506692","381","1336.01441019","0.285176564785"
"SL2.50ch04:26603102-26603834","171","26603102","26603834","732","1336.01441019","0.547898281948"
"SL2.50ch04:26611415-26614562","886","26611415","26614562","3147","1336.01441019","2.35551351543"
"SL2.50ch04:26623139-26623792","106","26623139","26623792","653","1336.01441019","0.488767183213"
"SL2.50ch04:26631151-26631482","70","26631151","26631482","331","1336.01441019","0.24775181875"
"SL2.50ch04:26662602-26662933","94","26662602","26662933","331","1336.01441019","0.24775181875"
"SL2.50ch04:26679587-26679968","75","26679587","26679968","381","1336.01441019","0.285176564785"
"SL2.50ch04:26681867-26683221","290","26681867","26683221","1354","1336.01441019","1.01346212262"
"SL2.50ch04:26718296-26720437","578","26718296","26720437","2141","1336.01441019","1.60252762521"
"SL2.50ch04:26721036-26722679","378","26721036","26722679","1643","1336.01441019","1.2297771547"
"SL2.50ch04:26724649-26725030","76","26724649","26725030","381","1336.01441019","0.285176564785"
"SL2.50ch04:26730814-26731195","87","26730814","26731195","381","1336.01441019","0.285176564785"
"SL2.50ch04:26736129-26736533","105","26736129","26736533","404","1336.01441019","0.302391947961"
"SL2.50ch04:26738374-26738948","140","26738374","26738948","574","1336.01441019","0.429636084479"
"SL2.50ch04:26745585-26745916","158","26745585","26745916","331","1336.01441019","0.24775181875"
"SL2.50ch04:26747946-26748260","68","26747946","26748260","314","1336.01441019","0.235027405098"
"SL2.50ch04:26759022-26759516","152","26759022","26759516","494","1336.01441019","0.369756490823"
"SL2.50ch04:26812505-26813601","179","26812505","26813601","1096","1336.01441019","0.820350433081"
"SL2.50ch04:26827281-26827696","105","26827281","26827696","415","1336.01441019","0.310625392088"
"SL2.50ch04:26830969-26831458","136","26830969","26831458","489","1336.01441019","0.36601401622"
"SL2.50ch04:30142735-30143508","387","30142735","30143508","773","1336.01441019","0.578586573697"
"SL2.50ch04:30142793-30143207","293","30142793","30143207","414","1336.01441019","0.309876897167"
"SL2.50ch04:30599050-30599381","60","30599050","30599381","331","1336.01441019","0.24775181875"
"SL2.50ch04:31286884-31287606","3885","31286884","31287606","722","1336.01441019","0.540413332741"
"SL2.50ch04:31286913-31287498","3865","31286913","31287498","585","1336.01441019","0.437869528606"
"SL2.50ch04:32065961-32066292","52","32065961","32066292","331","1336.01441019","0.24775181875"
"SL2.50ch04:3316578-3317091","1352","3316578","3317091","513","1336.01441019","0.383977894316"
"SL2.50ch04:33411833-33412514","883","33411833","33412514","681","1336.01441019","0.509725040993"
"SL2.50ch04:33411924-33412528","874","33411924","33412528","604","1336.01441019","0.452090932099"
"SL2.50ch04:33600222-33600774","837","33600222","33600774","552","1336.01441019","0.413169196223"
"SL2.50ch04:33600272-33600716","826","33600272","33600716","444","1336.01441019","0.332331744788"
"SL2.50ch04:33964686-33965817","1591","33964686","33965817","1131","1336.01441019","0.846547755305"
"SL2.50ch04:33964729-33967848","3526","33964729","33967848","3119","1336.01441019","2.33455565765"
"SL2.50ch04:33966498-33967356","1501","33966498","33967356","858","1336.01441019","0.642208641956"
"SL2.50ch04:35026645-35027706","262","35026645","35027706","1061","1336.01441019","0.794153110857"
"SL2.50ch04:35026684-35027088","123","35026684","35027088","404","1336.01441019","0.302391947961"
"SL2.50ch04:36284887-36285330","83","36284887","36285330","443","1336.01441019","0.331583249868"
"SL2.50ch04:37281328-37281732","56","37281328","37281732","404","1336.01441019","0.302391947961"
"SL2.50ch04:39274784-39275165","59","39274784","39275165","381","1336.01441019","0.285176564785"
"SL2.50ch04:4062282-4062871","588","4062282","4062871","589","1336.01441019","0.440863508289"
"SL2.50ch04:4062370-4062848","584","4062370","4062848","478","1336.01441019","0.357780572092"
"SL2.50ch04:41198481-41199118","432","41198481","41199118","637","1336.01441019","0.476791264482"
"SL2.50ch04:41209999-41210708","404","41209999","41210708","709","1336.01441019","0.530682898772"
"SL2.50ch04:41212066-41213957","1816","41212066","41213957","1891","1336.01441019","1.41540389503"
"SL2.50ch04:42564925-42565329","418","42564925","42565329","404","1336.01441019","0.302391947961"
"SL2.50ch04:42564940-42565321","412","42564940","42565321","381","1336.01441019","0.285176564785"
"SL2.50ch04:42679549-42679880","34","42679549","42679880","331","1336.01441019","0.24775181875"
"SL2.50ch04:42863861-42864250","301","42863861","42864250","389","1336.01441019","0.29116452415"
"SL2.50ch04:43245826-43246241","329","43245826","43246241","415","1336.01441019","0.310625392088"
"SL2.50ch04:43245904-43246329","326","43245904","43246329","425","1336.01441019","0.318110341295"
"SL2.50ch04:4399766-4400170","167","4399766","4400170","404","1336.01441019","0.302391947961"
"SL2.50ch04:4482019-4482333","168","4482019","4482333","314","1336.01441019","0.235027405098"
"SL2.50ch04:4488477-4488858","40","4488477","4488858","381","1336.01441019","0.285176564785"
"SL2.50ch04:48279740-48280213","294","48279740","48280213","473","1336.01441019","0.354038097488"
"SL2.50ch04:48279793-48280124","292","48279793","48280124","331","1336.01441019","0.24775181875"
"SL2.50ch04:49644302-49644683","76","49644302","49644683","381","1336.01441019","0.285176564785"
"SL2.50ch04:50234376-50234780","249","50234376","50234780","404","1336.01441019","0.302391947961"
"SL2.50ch04:51272935-51273524","139","51272935","51273524","589","1336.01441019","0.440863508289"
"SL2.50ch04:51484281-51484595","67","51484281","51484595","314","1336.01441019","0.235027405098"
"SL2.50ch04:51485088-51485419","52","51485088","51485419","331","1336.01441019","0.24775181875"
"SL2.50ch04:51500439-51501036","110","51500439","51501036","597","1336.01441019","0.446851467655"
"SL2.50ch04:51505549-51506054","107","51505549","51506054","505","1336.01441019","0.377989934951"
"SL2.50ch04:52006935-52007508","132","52006935","52007508","573","1336.01441019","0.428887589558"
"SL2.50ch04:52330422-52330973","201","52330422","52330973","551","1336.01441019","0.412420701303"
"SL2.50ch04:52330550-52330881","193","52330550","52330881","331","1336.01441019","0.24775181875"
"SL2.50ch04:53900148-53901223","347","53900148","53901223","1075","1336.01441019","0.804632039746"
"SL2.50ch04:53903218-53903751","110","53903218","53903751","533","1336.01441019","0.39894779273"
"SL2.50ch04:54063060-54063441","332","54063060","54063441","381","1336.01441019","0.285176564785"
"SL2.50ch04:54063066-54063470","333","54063066","54063470","404","1336.01441019","0.302391947961"
"SL2.50ch04:55558117-55558552","69","55558117","55558552","435","1336.01441019","0.325595290502"
"SL2.50ch04:55561929-55563076","301","55561929","55563076","1147","1336.01441019","0.858523674036"
"SL2.50ch04:55565197-55566978","621","55565197","55566978","1781","1336.01441019","1.33306945376"
"SL2.50ch04:55565245-55566562","523","55565245","55566562","1317","1336.01441019","0.985767810555"
"SL2.50ch04:55572877-55573415","81","55572877","55573415","538","1336.01441019","0.402690267334"
"SL2.50ch04:55661207-55661538","28","55661207","55661538","331","1336.01441019","0.24775181875"
"SL2.50ch04:56149343-56149851","411","56149343","56149851","508","1336.01441019","0.380235419713"
"SL2.50ch04:56149445-56149922","380","56149445","56149922","477","1336.01441019","0.357032077171"
"SL2.50ch04:58235770-58236246","1296","58235770","58236246","476","1336.01441019","0.356283582251"
"SL2.50ch04:59105601-59105932","67","59105601","59105932","331","1336.01441019","0.24775181875"
"SL2.50ch04:59156129-59156636","85","59156129","59156636","507","1336.01441019","0.379486924792"
"SL2.50ch04:60977337-60977741","285","60977337","60977741","404","1336.01441019","0.302391947961"
"SL2.50ch04:60977351-60977682","283","60977351","60977682","331","1336.01441019","0.24775181875"
"SL2.50ch04:64832176-64832716","816","64832176","64832716","540","1336.01441019","0.404187257175"
"SL2.50ch04:66134287-66134764","259","66134287","66134764","477","1336.01441019","0.357032077171"
"SL2.50ch04:66134319-66134650","249","66134319","66134650","331","1336.01441019","0.24775181875"
"SL2.50ch04:6910535-6910916","808","6910535","6910916","381","1336.01441019","0.285176564785"
"SL2.50ch04:6910540-6910984","810","6910540","6910984","444","1336.01441019","0.332331744788"
"SL2.50ch04:7355584-7356830","246","7355584","7356830","1246","1336.01441019","0.932624671185"
"SL2.50ch04:7365607-7368298","558","7365607","7368298","2691","1336.01441019","2.01419983159"
"SL2.50ch04:7380510-7381292","114","7380510","7381292","782","1336.01441019","0.585323027983"
"SL2.50ch04:7455432-7455865","82","7455432","7455865","433","1336.01441019","0.324098300661"
"SL2.50ch04:7571576-7571907","129","7571576","7571907","331","1336.01441019","0.24775181875"
"SL2.50ch04:7573563-7574260","138","7573563","7574260","697","1336.01441019","0.521700959724"
"SL2.50ch05:10221772-10222261","166","10221772","10222261","489","1336.01441019","0.36601401622"
"SL2.50ch05:11785106-11785510","1006","11785106","11785510","404","1336.01441019","0.302391947961"
"SL2.50ch05:11785125-11785601","1011","11785125","11785601","476","1336.01441019","0.356283582251"
"SL2.50ch05:124689-125267","623","124689","125267","578","1336.01441019","0.432630064161"
"SL2.50ch05:124706-125207","619","124706","125207","501","1336.01441019","0.374995955268"
"SL2.50ch05:12490821-12491152","49","12490821","12491152","331","1336.01441019","0.24775181875"
"SL2.50ch05:12893036-12893417","90","12893036","12893417","381","1336.01441019","0.285176564785"
"SL2.50ch05:13793519-13794167","205","13793519","13794167","648","1336.01441019","0.48502470861"
"SL2.50ch05:13793604-13794217","194","13793604","13794217","613","1336.01441019","0.458827386386"
"SL2.50ch05:14606008-14607052","13202","14606008","14607052","1044","1336.01441019","0.781428697205"
"SL2.50ch05:14606055-14607014","13198","14606055","14607014","959","1336.01441019","0.717806628946"
"SL2.50ch05:16312811-16313192","59","16312811","16313192","381","1336.01441019","0.285176564785"
"SL2.50ch05:16783662-16784043","58","16783662","16784043","381","1336.01441019","0.285176564785"
"SL2.50ch05:17047934-17048591","170","17047934","17048591","657","1336.01441019","0.491761162896"
"SL2.50ch05:17049662-17050637","214","17049662","17050637","975","1336.01441019","0.729782547677"
"SL2.50ch05:17051721-17052102","93","17051721","17052102","381","1336.01441019","0.285176564785"
"SL2.50ch05:17063457-17063861","72","17063457","17063861","404","1336.01441019","0.302391947961"
"SL2.50ch05:18129069-18129572","378","18129069","18129572","503","1336.01441019","0.376492945109"
"SL2.50ch05:19524275-19525076","165","19524275","19525076","801","1336.01441019","0.599544431476"
"SL2.50ch05:19525770-19526777","247","19525770","19526777","1007","1336.01441019","0.753734385139"
"SL2.50ch05:19598004-19598318","64","19598004","19598318","314","1336.01441019","0.235027405098"
"SL2.50ch05:19599523-19600251","190","19599523","19600251","728","1336.01441019","0.544904302266"
"SL2.50ch05:19600643-19601146","123","19600643","19601146","503","1336.01441019","0.376492945109"
"SL2.50ch05:19601659-19603553","594","19601659","19603553","1894","1336.01441019","1.4176493798"
"SL2.50ch05:19671082-19671918","154","19671082","19671918","836","1336.01441019","0.625741753701"
"SL2.50ch05:19674403-19674734","69","19674403","19674734","331","1336.01441019","0.24775181875"
"SL2.50ch05:19678494-19678825","111","19678494","19678825","331","1336.01441019","0.24775181875"
"SL2.50ch05:19685741-19686330","147","19685741","19686330","589","1336.01441019","0.440863508289"
"SL2.50ch05:19708053-19708384","86","19708053","19708384","331","1336.01441019","0.24775181875"
"SL2.50ch05:19711216-19711706","95","19711216","19711706","490","1336.01441019","0.36676251114"
"SL2.50ch05:19759005-19759336","123","19759005","19759336","331","1336.01441019","0.24775181875"
"SL2.50ch05:19853440-19855026","446","19853440","19855026","1586","1336.01441019","1.18711294422"
"SL2.50ch05:19856632-19857957","186","19856632","19857957","1325","1336.01441019","0.99175576992"
"SL2.50ch05:19861412-19861816","89","19861412","19861816","404","1336.01441019","0.302391947961"
"SL2.50ch05:19862602-19863006","81","19862602","19863006","404","1336.01441019","0.302391947961"
"SL2.50ch05:20083995-20084376","57","20083995","20084376","381","1336.01441019","0.285176564785"
"SL2.50ch05:2203078-2203720","2665","2203078","2203720","642","1336.01441019","0.480533739086"
"SL2.50ch05:2203124-2203700","2663","2203124","2203700","576","1336.01441019","0.43113307432"
"SL2.50ch05:22229509-22229943","129","22229509","22229943","434","1336.01441019","0.324846795581"
"SL2.50ch05:24103037-24103418","59","24103037","24103418","381","1336.01441019","0.285176564785"
"SL2.50ch05:24201496-24201877","63","24201496","24201877","381","1336.01441019","0.285176564785"
"SL2.50ch05:24361731-24362416","1609","24361731","24362416","685","1336.01441019","0.512719020676"
"SL2.50ch05:24361792-24362383","1602","24361792","24362383","591","1336.01441019","0.44236049813"
"SL2.50ch05:25812462-25813223","5172","25812462","25813223","761","1336.01441019","0.569604634648"
"SL2.50ch05:25812555-25813179","5167","25812555","25813179","624","1336.01441019","0.467060830513"
"SL2.50ch05:26626513-26626894","1091","26626513","26626894","381","1336.01441019","0.285176564785"
"SL2.50ch05:26633231-26633719","159","26633231","26633719","488","1336.01441019","0.365265521299"
"SL2.50ch05:27332331-27332808","193","27332331","27332808","477","1336.01441019","0.357032077171"
"SL2.50ch05:27332339-27332743","193","27332339","27332743","404","1336.01441019","0.302391947961"
"SL2.50ch05:28301302-28301954","6004","28301302","28301954","652","1336.01441019","0.488018688293"
"SL2.50ch05:28301333-28301965","6005","28301333","28301965","632","1336.01441019","0.473048789879"
"SL2.50ch05:28401561-28401892","74","28401561","28401892","331","1336.01441019","0.24775181875"
"SL2.50ch05:29349509-29349922","146","29349509","29349922","413","1336.01441019","0.309128402247"
"SL2.50ch05:30096129-30096547","206","30096129","30096547","418","1336.01441019","0.31287087685"
"SL2.50ch05:30114820-30115151","119","30114820","30115151","331","1336.01441019","0.24775181875"
"SL2.50ch05:30138122-30138697","611","30138122","30138697","575","1336.01441019","0.430384579399"
"SL2.50ch05:30147627-30148491","578","30147627","30148491","864","1336.01441019","0.64669961148"
"SL2.50ch05:30147746-30148650","580","30147746","30148650","904","1336.01441019","0.676639408308"
"SL2.50ch05:30152644-30154543","1021","30152644","30154543","1899","1336.01441019","1.4213918544"
"SL2.50ch05:30152985-30154006","827","30152985","30154006","1021","1336.01441019","0.764213314029"
"SL2.50ch05:30156828-30157232","426","30156828","30157232","404","1336.01441019","0.302391947961"
"SL2.50ch05:30156852-30157233","424","30156852","30157233","381","1336.01441019","0.285176564785"
"SL2.50ch05:30363697-30364389","182","30363697","30364389","692","1336.01441019","0.517958485121"
"SL2.50ch05:34059094-34059674","1286","34059094","34059674","580","1336.01441019","0.434127054003"
"SL2.50ch05:34059144-34059617","1278","34059144","34059617","473","1336.01441019","0.354038097488"
"SL2.50ch05:34096226-34097364","22098","34096226","34097364","1138","1336.01441019","0.85178721975"
"SL2.50ch05:34096261-34097447","22102","34096261","34097447","1186","1336.01441019","0.887714975944"
"SL2.50ch05:34099408-34100806","119796","34099408","34100806","1398","1336.01441019","1.04639589913"
"SL2.50ch05:34099451-34100853","119798","34099451","34100853","1402","1336.01441019","1.04938987881"
"SL2.50ch05:34480723-34481104","62","34480723","34481104","381","1336.01441019","0.285176564785"
"SL2.50ch05:35110282-35110857","176","35110282","35110857","575","1336.01441019","0.430384579399"
"SL2.50ch05:35110320-35110651","137","35110320","35110651","331","1336.01441019","0.24775181875"
"SL2.50ch05:35698357-35699539","2114","35698357","35699539","1182","1336.01441019","0.884720996261"
"SL2.50ch05:35698543-35699463","2084","35698543","35699463","920","1336.01441019","0.688615327039"
"SL2.50ch05:36962640-36963113","1413","36962640","36963113","473","1336.01441019","0.354038097488"
"SL2.50ch05:36962682-36963063","1410","36962682","36963063","381","1336.01441019","0.285176564785"
"SL2.50ch05:3700932-3702233","199","3700932","3702233","1301","1336.01441019","0.973791891823"
"SL2.50ch05:3701791-3702230","97","3701791","3702230","439","1336.01441019","0.328589270185"
"SL2.50ch05:39240018-39240584","126","39240018","39240584","566","1336.01441019","0.423648125113"
"SL2.50ch05:39394971-39395579","133","39394971","39395579","608","1336.01441019","0.455084911782"
"SL2.50ch05:39395236-39395617","89","39395236","39395617","381","1336.01441019","0.285176564785"
"SL2.50ch05:39968353-39972493","1169","39968353","39972493","4140","1336.01441019","3.09876897167"
"SL2.50ch05:39973315-39974018","185","39973315","39974018","703","1336.01441019","0.526191929248"
"SL2.50ch05:40067756-40069087","1241","40067756","40069087","1331","1336.01441019","0.996246739444"
"SL2.50ch05:40068143-40069037","1165","40068143","40069037","894","1336.01441019","0.669154459101"
"SL2.50ch05:42981754-42982235","109","42981754","42982235","481","1336.01441019","0.360026056854"
"SL2.50ch05:42985502-42986002","164","42985502","42986002","500","1336.01441019","0.374247460347"
"SL2.50ch05:42985526-42986002","163","42985526","42986002","476","1336.01441019","0.356283582251"
"SL2.50ch05:45135281-45135914","3699","45135281","45135914","633","1336.01441019","0.4737972848"
"SL2.50ch05:45135327-45135881","3693","45135327","45135881","554","1336.01441019","0.414666186065"
"SL2.50ch05:47294856-47295187","119","47294856","47295187","331","1336.01441019","0.24775181875"
"SL2.50ch05:47671717-47672048","118","47671717","47672048","331","1336.01441019","0.24775181875"
"SL2.50ch05:47779945-47780427","73","47779945","47780427","482","1336.01441019","0.360774551775"
"SL2.50ch05:48771151-48771886","154","48771151","48771886","735","1336.01441019","0.55014376671"
"SL2.50ch05:49830528-49830994","113","49830528","49830994","466","1336.01441019","0.348798633044"
"SL2.50ch05:49929892-49930514","967","49929892","49930514","622","1336.01441019","0.465563840672"
"SL2.50ch05:49929931-49930553","965","49929931","49930553","622","1336.01441019","0.465563840672"
"SL2.50ch05:50407719-50408100","62","50407719","50408100","381","1336.01441019","0.285176564785"
"SL2.50ch05:51313841-51315982","18693","51313841","51315982","2141","1336.01441019","1.60252762521"
"SL2.50ch05:51314141-51315271","18514","51314141","51315271","1130","1336.01441019","0.845799260385"
"SL2.50ch05:51317108-51317439","213","51317108","51317439","331","1336.01441019","0.24775181875"
"SL2.50ch05:51467418-51467901","160","51467418","51467901","483","1336.01441019","0.361523046695"
"SL2.50ch05:51486830-51487211","165","51486830","51487211","381","1336.01441019","0.285176564785"
"SL2.50ch05:54806564-54806945","74","54806564","54806945","381","1336.01441019","0.285176564785"
"SL2.50ch05:56642259-56642640","60","56642259","56642640","381","1336.01441019","0.285176564785"
"SL2.50ch05:56674141-56674472","39","56674141","56674472","331","1336.01441019","0.24775181875"
"SL2.50ch05:56705782-56706417","445","56705782","56706417","635","1336.01441019","0.475294274641"
"SL2.50ch05:56705831-56706270","429","56705831","56706270","439","1336.01441019","0.328589270185"
"SL2.50ch05:57568879-57571321","2367","57568879","57571321","2442","1336.01441019","1.82782459634"
"SL2.50ch05:57571883-57572825","5883","57571883","57572825","942","1336.01441019","0.705082215294"
"SL2.50ch05:57574709-57576547","2535","57574709","57576547","1838","1336.01441019","1.37573366424"
"SL2.50ch05:57574805-57576091","2424","57574805","57576091","1286","1336.01441019","0.962564468013"
"SL2.50ch05:57583802-57584494","473","57583802","57584494","692","1336.01441019","0.517958485121"
"SL2.50ch05:57583997-57584401","419","57583997","57584401","404","1336.01441019","0.302391947961"
"SL2.50ch05:58886999-58887587","382","58886999","58887587","588","1336.01441019","0.440115013368"
"SL2.50ch05:58892119-58892799","10416","58892119","58892799","680","1336.01441019","0.508976546072"
"SL2.50ch05:58892194-58892774","10403","58892194","58892774","580","1336.01441019","0.434127054003"
"SL2.50ch05:60997418-60998297","1374","60997418","60998297","879","1336.01441019","0.65792703529"
"SL2.50ch05:60997468-60998204","1371","60997468","60998204","736","1336.01441019","0.550892261631"
"SL2.50ch05:61296040-61296421","146","61296040","61296421","381","1336.01441019","0.285176564785"
"SL2.50ch05:6201149-6201625","108","6201149","6201625","476","1336.01441019","0.356283582251"
"SL2.50ch05:62772319-62772973","2069","62772319","62772973","654","1336.01441019","0.489515678134"
"SL2.50ch05:62772347-62772953","2069","62772347","62772953","606","1336.01441019","0.453587921941"
"SL2.50ch05:62857645-62858218","380","62857645","62858218","573","1336.01441019","0.428887589558"
"SL2.50ch05:62857730-62858111","368","62857730","62858111","381","1336.01441019","0.285176564785"
"SL2.50ch05:64187011-64187408","112","64187011","64187408","397","1336.01441019","0.297152483516"
"SL2.50ch05:64808149-64808463","425","64808149","64808463","314","1336.01441019","0.235027405098"
"SL2.50ch05:64808156-64809141","746","64808156","64809141","985","1336.01441019","0.737267496884"
"SL2.50ch05:6498403-6499131","10221","6498403","6499131","728","1336.01441019","0.544904302266"
"SL2.50ch05:6498423-6499134","10220","6498423","6499134","711","1336.01441019","0.532179888614"
"SL2.50ch05:6728520-6728851","843","6728520","6728851","331","1336.01441019","0.24775181875"
"SL2.50ch05:6773458-6774010","1587","6773458","6774010","552","1336.01441019","0.413169196223"
"SL2.50ch05:6773554-6773995","1585","6773554","6773995","441","1336.01441019","0.330086260026"
"SL2.50ch05:8436040-8436421","167","8436040","8436421","381","1336.01441019","0.285176564785"
"SL2.50ch05:9087800-9088496","198","9087800","9088496","696","1336.01441019","0.520952464803"
"SL2.50ch06:10947409-10948377","275","10947409","10948377","968","1336.01441019","0.724543083232"
"SL2.50ch06:10950513-10951823","536","10950513","10951823","1310","1336.01441019","0.98052834611"
"SL2.50ch06:10957115-10958211","448","10957115","10958211","1096","1336.01441019","0.820350433081"
"SL2.50ch06:10961074-10962307","584","10961074","10962307","1233","1336.01441019","0.922894237216"
"SL2.50ch06:10963169-10964427","491","10963169","10964427","1258","1336.01441019","0.941606610234"
"SL2.50ch06:10965926-10966653","390","10965926","10966653","727","1336.01441019","0.544155807345"
"SL2.50ch06:10966185-10966589","299","10966185","10966589","404","1336.01441019","0.302391947961"
"SL2.50ch06:10968867-10970263","742","10968867","10970263","1396","1336.01441019","1.04489890929"
"SL2.50ch06:10971723-10972891","779","10971723","10972891","1168","1336.01441019","0.874242067371"
"SL2.50ch06:10971728-10972909","779","10971728","10972909","1181","1336.01441019","0.88397250134"
"SL2.50ch06:10979407-10980101","422","10979407","10980101","694","1336.01441019","0.519455474962"
"SL2.50ch06:10979446-10980177","421","10979446","10980177","731","1336.01441019","0.547149787028"
"SL2.50ch06:10982165-10983036","528","10982165","10983036","871","1336.01441019","0.651939075925"
"SL2.50ch06:10982174-10983088","528","10982174","10983088","914","1336.01441019","0.684124357515"
"SL2.50ch06:10986776-10990133","1749","10986776","10990133","3357","1336.01441019","2.51269744877"
"SL2.50ch06:10986793-10990146","1749","10986793","10990146","3353","1336.01441019","2.50970346909"
"SL2.50ch06:10996653-10998982","1396","10996653","10998982","2329","1336.01441019","1.7432446703"
"SL2.50ch06:11000018-11000938","1072","11000018","11000938","920","1336.01441019","0.688615327039"
"SL2.50ch06:11000031-11001002","1072","11000031","11001002","971","1336.01441019","0.726788567994"
"SL2.50ch06:11009017-11014358","2230","11009017","11014358","5341","1336.01441019","3.99771137143"
"SL2.50ch06:11019681-11027346","6020","11019681","11027346","7665","1336.01441019","5.73721356712"
"SL2.50ch06:11019690-11027373","6020","11019690","11027373","7683","1336.01441019","5.7506864757"
"SL2.50ch06:11032844-11037074","2789","11032844","11037074","4230","1336.01441019","3.16613351454"
"SL2.50ch06:11032910-11037102","2776","11032910","11037102","4192","1336.01441019","3.13769070755"
"SL2.50ch06:11037841-11040305","1448","11037841","11040305","2464","1336.01441019","1.84429148459"
"SL2.50ch06:11040940-11044030","1812","11040940","11044030","3090","1336.01441019","2.31284930495"
"SL2.50ch06:11050128-11054360","3355","11050128","11054360","4232","1336.01441019","3.16763050438"
"SL2.50ch06:11050137-11054383","3355","11050137","11054383","4246","1336.01441019","3.17810943327"
"SL2.50ch06:11067918-11068400","249","11067918","11068400","482","1336.01441019","0.360774551775"
"SL2.50ch06:11101554-11102380","324","11101554","11102380","826","1336.01441019","0.618256804494"
"SL2.50ch06:11121999-11124431","1425","11121999","11124431","2432","1336.01441019","1.82033964713"
"SL2.50ch06:11125470-11127116","695","11125470","11127116","1646","1336.01441019","1.23202263946"
"SL2.50ch06:11127577-11128833","523","11127577","11128833","1256","1336.01441019","0.940109620392"
"SL2.50ch06:11137608-11138028","163","11137608","11138028","420","1336.01441019","0.314367866692"
"SL2.50ch06:11142266-11148185","2379","11142266","11148185","5919","1336.01441019","4.43034143559"
"SL2.50ch06:11149965-11152499","1587","11149965","11152499","2534","1336.01441019","1.89668612904"
"SL2.50ch06:11150240-11152056","1228","11150240","11152056","1816","1336.01441019","1.35926677598"
"SL2.50ch06:11154178-11155976","621","11154178","11155976","1798","1336.01441019","1.34579386741"
"SL2.50ch06:11182085-11183486","395","11182085","11183486","1401","1336.01441019","1.04864138389"
"SL2.50ch06:11189145-11189476","148","11189145","11189476","331","1336.01441019","0.24775181875"
"SL2.50ch06:11225806-11226137","105","11225806","11226137","331","1336.01441019","0.24775181875"
"SL2.50ch06:11227199-11227858","183","11227199","11227858","659","1336.01441019","0.493258152738"
"SL2.50ch06:11232258-11232639","175","11232258","11232639","381","1336.01441019","0.285176564785"
"SL2.50ch06:11249962-11250548","147","11249962","11250548","586","1336.01441019","0.438618023527"
"SL2.50ch06:11282449-11282780","77","11282449","11282780","331","1336.01441019","0.24775181875"
"SL2.50ch06:11373336-11373815","109","11373336","11373815","479","1336.01441019","0.358529067013"
"SL2.50ch06:11374132-11374823","187","11374132","11374823","691","1336.01441019","0.5172099902"
"SL2.50ch06:11374397-11374728","136","11374397","11374728","331","1336.01441019","0.24775181875"
"SL2.50ch06:11537565-11538079","230","11537565","11538079","514","1336.01441019","0.384726389237"
"SL2.50ch06:11541452-11541783","112","11541452","11541783","331","1336.01441019","0.24775181875"
"SL2.50ch06:11564987-11566222","456","11564987","11566222","1235","1336.01441019","0.924391227058"
"SL2.50ch06:11565009-11565513","336","11565009","11565513","504","1336.01441019","0.37724144003"
"SL2.50ch06:11578387-11578768","225","11578387","11578768","381","1336.01441019","0.285176564785"
"SL2.50ch06:11581506-11581837","225","11581506","11581837","331","1336.01441019","0.24775181875"
"SL2.50ch06:11592346-11593517","644","11592346","11593517","1171","1336.01441019","0.876487552133"
"SL2.50ch06:11600456-11601309","350","11600456","11601309","853","1336.01441019","0.638466167352"
"SL2.50ch06:11605185-11606283","473","11605185","11606283","1098","1336.01441019","0.821847422922"
"SL2.50ch06:11607730-11609234","1034","11607730","11609234","1504","1336.01441019","1.12573636072"
"SL2.50ch06:11607751-11609192","1025","11607751","11609192","1441","1336.01441019","1.07858118072"
"SL2.50ch06:11610339-11612353","722","11610339","11612353","2014","1336.01441019","1.50746877028"
"SL2.50ch06:11615867-11616398","229","11615867","11616398","531","1336.01441019","0.397450802889"
"SL2.50ch06:11622835-11624534","1160","11622835","11624534","1699","1336.01441019","1.27169287026"
"SL2.50ch06:11622845-11624328","1109","11622845","11624328","1483","1336.01441019","1.11001796739"
"SL2.50ch06:11632052-11632718","686","11632052","11632718","666","1336.01441019","0.498497617182"
"SL2.50ch06:11632082-11632652","686","11632082","11632652","570","1336.01441019","0.426642104796"
"SL2.50ch06:11634548-11636811","1840","11634548","11636811","2263","1336.01441019","1.69384400553"
"SL2.50ch06:11634549-11636814","1840","11634549","11636814","2265","1336.01441019","1.69534099537"
"SL2.50ch06:12253948-12255474","1032","12253948","12255474","1526","1336.01441019","1.14220324898"
"SL2.50ch06:12260916-12261634","339","12260916","12261634","718","1336.01441019","0.537419353059"
"SL2.50ch06:12264007-12268154","3988","12264007","12268154","4147","1336.01441019","3.10400843612"
"SL2.50ch06:12268798-12269790","296","12268798","12269790","992","1336.01441019","0.742506961329"
"SL2.50ch06:12391176-12391618","77","12391176","12391618","442","1336.01441019","0.330834754947"
"SL2.50ch06:12412041-12412372","75","12412041","12412372","331","1336.01441019","0.24775181875"
"SL2.50ch06:12444950-12445993","369","12444950","12445993","1043","1336.01441019","0.780680202284"
"SL2.50ch06:12445028-12445966","361","12445028","12445966","938","1336.01441019","0.702088235611"
"SL2.50ch06:12447390-12448808","434","12447390","12448808","1418","1336.01441019","1.06136579754"
"SL2.50ch06:12513906-12514643","154","12513906","12514643","737","1336.01441019","0.551640756552"
"SL2.50ch06:12647474-12647855","85","12647474","12647855","381","1336.01441019","0.285176564785"
"SL2.50ch06:12661829-12662323","103","12661829","12662323","494","1336.01441019","0.369756490823"
"SL2.50ch06:12747589-12748565","193","12747589","12748565","976","1336.01441019","0.730531042598"
"SL2.50ch06:12761552-12761883","103","12761552","12761883","331","1336.01441019","0.24775181875"
"SL2.50ch06:12785820-12786361","102","12785820","12786361","541","1336.01441019","0.404935752096"
"SL2.50ch06:12849422-12850298","1909","12849422","12850298","876","1336.01441019","0.655681550528"
"SL2.50ch06:12849583-12850366","1910","12849583","12850366","783","1336.01441019","0.586071522904"
"SL2.50ch06:12875194-12875525","70","12875194","12875525","331","1336.01441019","0.24775181875"
"SL2.50ch06:12891357-12891738","93","12891357","12891738","381","1336.01441019","0.285176564785"
"SL2.50ch06:12931056-12931437","95","12931056","12931437","381","1336.01441019","0.285176564785"
"SL2.50ch06:12986616-12986997","75","12986616","12986997","381","1336.01441019","0.285176564785"
"SL2.50ch06:13010303-13011118","202","13010303","13011118","815","1336.01441019","0.610023360366"
"SL2.50ch06:13018711-13019092","76","13018711","13019092","381","1336.01441019","0.285176564785"
"SL2.50ch06:13052196-13052697","91","13052196","13052697","501","1336.01441019","0.374995955268"
"SL2.50ch06:13424117-13425113","1445","13424117","13425113","996","1336.01441019","0.745500941012"
"SL2.50ch06:13424223-13425105","1442","13424223","13425105","882","1336.01441019","0.660172520052"
"SL2.50ch06:16354420-16354824","109","16354420","16354824","404","1336.01441019","0.302391947961"
"SL2.50ch06:19992401-19992782","102","19992401","19992782","381","1336.01441019","0.285176564785"
"SL2.50ch06:20128520-20129249","8507","20128520","20129249","729","1336.01441019","0.545652797186"
"SL2.50ch06:20129767-20130271","15323","20129767","20130271","504","1336.01441019","0.37724144003"
"SL2.50ch06:20515088-20515533","385","20515088","20515533","445","1336.01441019","0.333080239709"
"SL2.50ch06:20515111-20515588","387","20515111","20515588","477","1336.01441019","0.357032077171"
"SL2.50ch06:20964739-20965120","94","20964739","20965120","381","1336.01441019","0.285176564785"
"SL2.50ch06:21340971-21341487","2095","21340971","21341487","516","1336.01441019","0.386223379078"
"SL2.50ch06:21340997-21341474","2093","21340997","21341474","477","1336.01441019","0.357032077171"
"SL2.50ch06:21771206-21772206","399","21771206","21772206","1000","1336.01441019","0.748494920694"
"SL2.50ch06:21771437-21772110","344","21771437","21772110","673","1336.01441019","0.503737081627"
"SL2.50ch06:22980971-22981374","109","22980971","22981374","403","1336.01441019","0.30164345304"
"SL2.50ch06:24095780-24096111","84","24095780","24096111","331","1336.01441019","0.24775181875"
"SL2.50ch06:24168452-24168833","1087","24168452","24168833","381","1336.01441019","0.285176564785"
"SL2.50ch06:24363884-24364282","98","24363884","24364282","398","1336.01441019","0.297900978436"
"SL2.50ch06:24536183-24536661","1052","24536183","24536661","478","1336.01441019","0.357780572092"
"SL2.50ch06:26056901-26057232","57","26056901","26057232","331","1336.01441019","0.24775181875"
"SL2.50ch06:27436698-27437251","337","27436698","27437251","553","1336.01441019","0.413917691144"
"SL2.50ch06:27436707-27437301","340","27436707","27437301","594","1336.01441019","0.444605982892"
"SL2.50ch06:27475434-27477639","461","27475434","27477639","2205","1336.01441019","1.65043130013"
"SL2.50ch06:27691687-27692018","57","27691687","27692018","331","1336.01441019","0.24775181875"
"SL2.50ch06:29957413-29957917","70","29957413","29957917","504","1336.01441019","0.37724144003"
"SL2.50ch06:30643930-30644261","68","30643930","30644261","331","1336.01441019","0.24775181875"
"SL2.50ch06:30951068-30951467","91","30951068","30951467","399","1336.01441019","0.298649473357"
"SL2.50ch06:31135931-31136493","621","31135931","31136493","562","1336.01441019","0.42065414543"
"SL2.50ch06:31135949-31136534","623","31135949","31136534","585","1336.01441019","0.437869528606"
"SL2.50ch06:31144477-31144791","61","31144477","31144791","314","1336.01441019","0.235027405098"
"SL2.50ch06:32472516-32473343","279","32472516","32473343","827","1336.01441019","0.619005299414"
"SL2.50ch06:32472677-32473264","246","32472677","32473264","587","1336.01441019","0.439366518448"
"SL2.50ch06:3332788-3333307","122","3332788","3333307","519","1336.01441019","0.38846886384"
"SL2.50ch06:3332805-3333282","117","3332805","3333282","477","1336.01441019","0.357032077171"
"SL2.50ch06:33858355-33858984","489","33858355","33858984","629","1336.01441019","0.470803305117"
"SL2.50ch06:33858408-33858912","487","33858408","33858912","504","1336.01441019","0.37724144003"
"SL2.50ch06:3414446-3415308","338","3414446","3415308","862","1336.01441019","0.645202621639"
"SL2.50ch06:3424470-3424956","121","3424470","3424956","486","1336.01441019","0.363768531457"
"SL2.50ch06:3450859-3454807","1100","3450859","3454807","3948","1336.01441019","2.9550579469"
"SL2.50ch06:3455247-3456666","314","3455247","3456666","1419","1336.01441019","1.06211429247"
"SL2.50ch06:34686221-34686640","203","34686221","34686640","419","1336.01441019","0.313619371771"
"SL2.50ch06:34686354-34686685","204","34686354","34686685","331","1336.01441019","0.24775181875"
"SL2.50ch06:3473858-3474189","78","3473858","3474189","331","1336.01441019","0.24775181875"
"SL2.50ch06:35232434-35232930","124","35232434","35232930","496","1336.01441019","0.371253480664"
"SL2.50ch06:35232443-35233047","147","35232443","35233047","604","1336.01441019","0.452090932099"
"SL2.50ch06:35841143-35842116","232","35841143","35842116","973","1336.01441019","0.728285557836"
"SL2.50ch06:35849344-35849894","73","35849344","35849894","550","1336.01441019","0.411672206382"
"SL2.50ch06:35855396-35855826","84","35855396","35855826","430","1336.01441019","0.321852815899"
"SL2.50ch06:36203477-36203864","235","36203477","36203864","387","1336.01441019","0.289667534309"
"SL2.50ch06:36593577-36594084","4524","36593577","36594084","507","1336.01441019","0.379486924792"
"SL2.50ch06:36593589-36594065","4524","36593589","36594065","476","1336.01441019","0.356283582251"
"SL2.50ch06:38692663-38693044","342","38692663","38693044","381","1336.01441019","0.285176564785"
"SL2.50ch06:38692679-38693089","342","38692679","38693089","410","1336.01441019","0.306882917485"
"SL2.50ch06:39340497-39340878","938","39340497","39340878","381","1336.01441019","0.285176564785"
"SL2.50ch06:39340502-39340906","937","39340502","39340906","404","1336.01441019","0.302391947961"
"SL2.50ch06:40138794-40139305","931","40138794","40139305","511","1336.01441019","0.382480904475"
"SL2.50ch06:40138835-40139291","929","40138835","40139291","456","1336.01441019","0.341313683837"
"SL2.50ch06:40454554-40455489","110","40454554","40455489","935","1336.01441019","0.699842750849"
"SL2.50ch06:42038148-42038552","251","42038148","42038552","404","1336.01441019","0.302391947961"
"SL2.50ch06:42038173-42038504","251","42038173","42038504","331","1336.01441019","0.24775181875"
"SL2.50ch06:4241451-4242037","422","4241451","4242037","586","1336.01441019","0.438618023527"
"SL2.50ch06:4241551-4241973","413","4241551","4241973","422","1336.01441019","0.315864856533"
"SL2.50ch06:42662943-42663546","5213","42662943","42663546","603","1336.01441019","0.451342437179"
"SL2.50ch06:42662979-42663474","5207","42662979","42663474","495","1336.01441019","0.370504985744"
"SL2.50ch06:4357169-4357799","1773","4357169","4357799","630","1336.01441019","0.471551800037"
"SL2.50ch06:4357287-4357860","1773","4357287","4357860","573","1336.01441019","0.428887589558"
"SL2.50ch06:43986841-43987261","424","43986841","43987261","420","1336.01441019","0.314367866692"
"SL2.50ch06:43986871-43987275","424","43986871","43987275","404","1336.01441019","0.302391947961"
"SL2.50ch06:44551082-44551775","127","44551082","44551775","693","1336.01441019","0.518706980041"
"SL2.50ch06:44654974-44655464","563","44654974","44655464","490","1336.01441019","0.36676251114"
"SL2.50ch06:44655030-44655411","557","44655030","44655411","381","1336.01441019","0.285176564785"
"SL2.50ch06:44744106-44744650","4972","44744106","44744650","544","1336.01441019","0.407181236858"
"SL2.50ch06:44744152-44744589","4971","44744152","44744589","437","1336.01441019","0.327092280343"
"SL2.50ch06:46138834-46139495","314","46138834","46139495","661","1336.01441019","0.494755142579"
"SL2.50ch06:46139046-46139467","298","46139046","46139467","421","1336.01441019","0.315116361612"
"SL2.50ch06:46145254-46148688","18717","46145254","46148688","3434","1336.01441019","2.57033155766"
"SL2.50ch06:46145319-46148663","18707","46145319","46148663","3344","1336.01441019","2.5029670148"
"SL2.50ch06:47239543-47240018","536","47239543","47240018","475","1336.01441019","0.35553508733"
"SL2.50ch06:47239593-47239976","533","47239593","47239976","383","1336.01441019","0.286673554626"
"SL2.50ch06:47293479-47294053","1728","47293479","47294053","574","1336.01441019","0.429636084479"
"SL2.50ch06:47293625-47294071","1724","47293625","47294071","446","1336.01441019","0.33382873463"
"SL2.50ch06:49737650-49738665","264","49737650","49738665","1015","1336.01441019","0.759722344505"
"SL2.50ch06:49737695-49738545","257","49737695","49738545","850","1336.01441019","0.63622068259"
"SL2.50ch06:5004425-5004927","107","5004425","5004927","502","1336.01441019","0.375744450189"
"SL2.50ch06:5008489-5008870","111","5008489","5008870","381","1336.01441019","0.285176564785"
"SL2.50ch06:5066776-5067157","88","5066776","5067157","381","1336.01441019","0.285176564785"
"SL2.50ch06:5075824-5076205","83","5075824","5076205","381","1336.01441019","0.285176564785"
"SL2.50ch06:5224495-5224826","94","5224495","5224826","331","1336.01441019","0.24775181875"
"SL2.50ch06:5261672-5262257","443","5261672","5262257","585","1336.01441019","0.437869528606"
"SL2.50ch06:5261686-5262235","441","5261686","5262235","549","1336.01441019","0.410923711461"
"SL2.50ch06:5300754-5301239","239","5300754","5301239","485","1336.01441019","0.363020036537"
"SL2.50ch06:5539405-5539736","62","5539405","5539736","331","1336.01441019","0.24775181875"
"SL2.50ch06:5771307-5772133","228","5771307","5772133","826","1336.01441019","0.618256804494"
"SL2.50ch06:5771379-5771910","170","5771379","5771910","531","1336.01441019","0.397450802889"
"SL2.50ch06:5967206-5967587","110","5967206","5967587","381","1336.01441019","0.285176564785"
"SL2.50ch06:6389557-6390114","1045","6389557","6390114","557","1336.01441019","0.416911670827"
"SL2.50ch06:6389582-6390202","1047","6389582","6390202","620","1336.01441019","0.464066850831"
"SL2.50ch06:6707638-6707969","38","6707638","6707969","331","1336.01441019","0.24775181875"
"SL2.50ch06:7067797-7068178","107","7067797","7068178","381","1336.01441019","0.285176564785"
"SL2.50ch06:7575695-7576076","96","7575695","7576076","381","1336.01441019","0.285176564785"
"SL2.50ch06:7609806-7610281","447","7609806","7610281","475","1336.01441019","0.35553508733"
"SL2.50ch06:7609870-7610251","443","7609870","7610251","381","1336.01441019","0.285176564785"
"SL2.50ch06:7918580-7919090","120","7918580","7919090","510","1336.01441019","0.381732409554"
"SL2.50ch06:8571905-8572751","198","8571905","8572751","846","1336.01441019","0.633226702907"
"SL2.50ch06:8594302-8596098","370","8594302","8596098","1796","1336.01441019","1.34429687757"
"SL2.50ch07:10484474-10485393","1155","10484474","10485393","919","1336.01441019","0.687866832118"
"SL2.50ch07:10484584-10485404","1134","10484584","10485404","820","1336.01441019","0.613765834969"
"SL2.50ch07:10490137-10490882","2718","10490137","10490882","745","1336.01441019","0.557628715917"
"SL2.50ch07:10490157-10490846","2713","10490157","10490846","689","1336.01441019","0.515713000358"
"SL2.50ch07:11631182-11631753","249","11631182","11631753","571","1336.01441019","0.427390599717"
"SL2.50ch07:11631232-11631655","237","11631232","11631655","423","1336.01441019","0.316613351454"
"SL2.50ch07:11852517-11854058","1412","11852517","11854058","1541","1336.01441019","1.15343067279"
"SL2.50ch07:11852568-11854114","1412","11852568","11854114","1546","1336.01441019","1.15717314739"
"SL2.50ch07:11854828-11856849","3589","11854828","11856849","2021","1336.01441019","1.51270823472"
"SL2.50ch07:11854838-11856909","3605","11854838","11856909","2071","1336.01441019","1.55013298076"
"SL2.50ch07:12792028-12792566","256","12792028","12792566","538","1336.01441019","0.402690267334"
"SL2.50ch07:13061177-13061558","61","13061177","13061558","381","1336.01441019","0.285176564785"
"SL2.50ch07:14185905-14186286","44","14185905","14186286","381","1336.01441019","0.285176564785"
"SL2.50ch07:14895177-14895660","84","14895177","14895660","483","1336.01441019","0.361523046695"
"SL2.50ch07:154-644","257","154","644","490","1336.01441019","0.36676251114"
"SL2.50ch07:16218905-16219478","142","16218905","16219478","573","1336.01441019","0.428887589558"
"SL2.50ch07:16794790-16795121","175","16794790","16795121","331","1336.01441019","0.24775181875"
"SL2.50ch07:19797843-19798311","133","19797843","19798311","468","1336.01441019","0.350295622885"
"SL2.50ch07:19804202-19804706","132","19804202","19804706","504","1336.01441019","0.37724144003"
"SL2.50ch07:19824914-19825318","62","19824914","19825318","404","1336.01441019","0.302391947961"
"SL2.50ch07:19845517-19845848","83","19845517","19845848","331","1336.01441019","0.24775181875"
"SL2.50ch07:19862962-19864091","258","19862962","19864091","1129","1336.01441019","0.845050765464"
"SL2.50ch07:19882116-19882627","272","19882116","19882627","511","1336.01441019","0.382480904475"
"SL2.50ch07:19882263-19882743","272","19882263","19882743","480","1336.01441019","0.359277561933"
"SL2.50ch07:19886335-19887665","396","19886335","19887665","1330","1336.01441019","0.995498244524"
"SL2.50ch07:19950344-19950963","110","19950344","19950963","619","1336.01441019","0.46331835591"
"SL2.50ch07:2038-2579","154","2038","2579","541","1336.01441019","0.404935752096"
"SL2.50ch07:222-2571","602","222","2571","2349","1336.01441019","1.75821456871"
"SL2.50ch07:2361885-2362270","338","2361885","2362270","385","1336.01441019","0.288170544467"
"SL2.50ch07:26467738-26468069","153","26467738","26468069","331","1336.01441019","0.24775181875"
"SL2.50ch07:27291275-27291834","197","27291275","27291834","559","1336.01441019","0.418408660668"
"SL2.50ch07:27969921-27970302","55","27969921","27970302","381","1336.01441019","0.285176564785"
"SL2.50ch07:28302964-28303555","4909","28302964","28303555","591","1336.01441019","0.44236049813"
"SL2.50ch07:28303048-28303619","4914","28303048","28303619","571","1336.01441019","0.427390599717"
"SL2.50ch07:29209556-29210196","563","29209556","29210196","640","1336.01441019","0.479036749244"
"SL2.50ch07:29209644-29210025","545","29209644","29210025","381","1336.01441019","0.285176564785"
"SL2.50ch07:29621993-29622555","102","29621993","29622555","562","1336.01441019","0.42065414543"
"SL2.50ch07:29775314-29775846","241","29775314","29775846","532","1336.01441019","0.398199297809"
"SL2.50ch07:2999380-3000365","469","2999380","3000365","985","1336.01441019","0.737267496884"
"SL2.50ch07:2999657-3000382","430","2999657","3000382","725","1336.01441019","0.542658817503"
"SL2.50ch07:30901950-30903433","849","30901950","30903433","1483","1336.01441019","1.11001796739"
"SL2.50ch07:30901983-30903426","849","30901983","30903426","1443","1336.01441019","1.08007817056"
"SL2.50ch07:30904001-30904867","307","30904001","30904867","866","1336.01441019","0.648196601321"
"SL2.50ch07:30904013-30904344","216","30904013","30904344","331","1336.01441019","0.24775181875"
"SL2.50ch07:30906088-30906620","781","30906088","30906620","532","1336.01441019","0.398199297809"
"SL2.50ch07:30906121-30906581","776","30906121","30906581","460","1336.01441019","0.344307663519"
"SL2.50ch07:32432778-32433597","2785","32432778","32433597","819","1336.01441019","0.613017340049"
"SL2.50ch07:32433027-32433607","2761","32433027","32433607","580","1336.01441019","0.434127054003"
"SL2.50ch07:34439305-34439686","80","34439305","34439686","381","1336.01441019","0.285176564785"
"SL2.50ch07:35067189-35067570","67","35067189","35067570","381","1336.01441019","0.285176564785"
"SL2.50ch07:36068583-36069109","190","36068583","36069109","526","1336.01441019","0.393708328285"
"SL2.50ch07:36068623-36069186","197","36068623","36069186","563","1336.01441019","0.421402640351"
"SL2.50ch07:3774928-3776334","398","3774928","3776334","1406","1336.01441019","1.0523838585"
"SL2.50ch07:38161094-38161653","131","38161094","38161653","559","1336.01441019","0.418408660668"
"SL2.50ch07:39115128-39115459","206","39115128","39115459","331","1336.01441019","0.24775181875"
"SL2.50ch07:39119631-39120035","284","39119631","39120035","404","1336.01441019","0.302391947961"
"SL2.50ch07:39119691-39120022","281","39119691","39120022","331","1336.01441019","0.24775181875"
"SL2.50ch07:4007330-4008116","1363","4007330","4008116","786","1336.01441019","0.588317007666"
"SL2.50ch07:4007359-4008082","1360","4007359","4008082","723","1336.01441019","0.541161827662"
"SL2.50ch07:44373280-44373661","134","44373280","44373661","381","1336.01441019","0.285176564785"
"SL2.50ch07:44383776-44384209","401","44383776","44384209","433","1336.01441019","0.324098300661"
"SL2.50ch07:44383777-44384198","401","44383777","44384198","421","1336.01441019","0.315116361612"
"SL2.50ch07:44576879-44577295","82","44576879","44577295","416","1336.01441019","0.311373887009"
"SL2.50ch07:45281877-45282258","54","45281877","45282258","381","1336.01441019","0.285176564785"
"SL2.50ch07:45560506-45560994","307","45560506","45560994","488","1336.01441019","0.365265521299"
"SL2.50ch07:47753072-47753453","55","47753072","47753453","381","1336.01441019","0.285176564785"
"SL2.50ch07:4797941-4798272","61","4797941","4798272","331","1336.01441019","0.24775181875"
"SL2.50ch07:48041097-48041612","108","48041097","48041612","515","1336.01441019","0.385474884158"
"SL2.50ch07:48381568-48382040","47","48381568","48382040","472","1336.01441019","0.353289602568"
"SL2.50ch07:4895812-4896296","55","4895812","4896296","484","1336.01441019","0.362271541616"
"SL2.50ch07:50218675-50219079","301","50218675","50219079","404","1336.01441019","0.302391947961"
"SL2.50ch07:50218773-50219104","297","50218773","50219104","331","1336.01441019","0.24775181875"
"SL2.50ch07:5061098-5061517","71","5061098","5061517","419","1336.01441019","0.313619371771"
"SL2.50ch07:50623432-50623911","177","50623432","50623911","479","1336.01441019","0.358529067013"
"SL2.50ch07:50623456-50624030","184","50623456","50624030","574","1336.01441019","0.429636084479"
"SL2.50ch07:5066460-5067638","188","5066460","5067638","1178","1336.01441019","0.881727016578"
"SL2.50ch07:52229717-52230208","483","52229717","52230208","491","1336.01441019","0.367511006061"
"SL2.50ch07:52229815-52230196","481","52229815","52230196","381","1336.01441019","0.285176564785"
"SL2.50ch07:52359458-52359772","61","52359458","52359772","314","1336.01441019","0.235027405098"
"SL2.50ch07:52372224-52372538","97","52372224","52372538","314","1336.01441019","0.235027405098"
"SL2.50ch07:5329634-5330048","84","5329634","5330048","414","1336.01441019","0.309876897167"
"SL2.50ch07:5355046-5355716","162","5355046","5355716","670","1336.01441019","0.501491596865"
"SL2.50ch07:5356731-5357135","70","5356731","5357135","404","1336.01441019","0.302391947961"
"SL2.50ch07:5385939-5386418","63","5385939","5386418","479","1336.01441019","0.358529067013"
"SL2.50ch07:5390060-5390391","56","5390060","5390391","331","1336.01441019","0.24775181875"
"SL2.50ch07:53975469-53975850","504","53975469","53975850","381","1336.01441019","0.285176564785"
"SL2.50ch07:5413307-5413638","103","5413307","5413638","331","1336.01441019","0.24775181875"
"SL2.50ch07:5450366-5452125","544","5450366","5452125","1759","1336.01441019","1.3166025655"
"SL2.50ch07:54736727-54737286","838","54736727","54737286","559","1336.01441019","0.418408660668"
"SL2.50ch07:54736814-54737356","834","54736814","54737356","542","1336.01441019","0.405684247016"
"SL2.50ch07:55282872-55283203","642","55282872","55283203","331","1336.01441019","0.24775181875"
"SL2.50ch07:55624036-55624417","89","55624036","55624417","381","1336.01441019","0.285176564785"
"SL2.50ch07:55632636-55633402","203","55632636","55633402","766","1336.01441019","0.573347109252"
"SL2.50ch07:55632892-55633419","163","55632892","55633419","527","1336.01441019","0.394456823206"
"SL2.50ch07:5584381-5585173","186","5584381","5585173","792","1336.01441019","0.59280797719"
"SL2.50ch07:5586876-5587257","117","5586876","5587257","381","1336.01441019","0.285176564785"
"SL2.50ch07:56095617-56096086","85","56095617","56096086","469","1336.01441019","0.351044117806"
"SL2.50ch07:56754920-56755411","122","56754920","56755411","491","1336.01441019","0.367511006061"
"SL2.50ch07:56755026-56755357","104","56755026","56755357","331","1336.01441019","0.24775181875"
"SL2.50ch07:56757178-56757964","173","56757178","56757964","786","1336.01441019","0.588317007666"
"SL2.50ch07:56757244-56757688","118","56757244","56757688","444","1336.01441019","0.332331744788"
"SL2.50ch07:57398904-57399485","111","57398904","57399485","581","1336.01441019","0.434875548923"
"SL2.50ch07:57399017-57399450","104","57399017","57399450","433","1336.01441019","0.324098300661"
"SL2.50ch07:57399966-57400347","81","57399966","57400347","381","1336.01441019","0.285176564785"
"SL2.50ch07:57401731-57402243","89","57401731","57402243","512","1336.01441019","0.383229399396"
"SL2.50ch07:57406415-57407105","155","57406415","57407105","690","1336.01441019","0.516461495279"
"SL2.50ch07:57431514-57431928","88","57431514","57431928","414","1336.01441019","0.309876897167"
"SL2.50ch07:58301158-58301618","441","58301158","58301618","460","1336.01441019","0.344307663519"
"SL2.50ch07:58301216-58301699","441","58301216","58301699","483","1336.01441019","0.361523046695"
"SL2.50ch07:58802339-58805033","555","58802339","58805033","2694","1336.01441019","2.01644531635"
"SL2.50ch07:59388865-59389400","924","59388865","59389400","535","1336.01441019","0.400444782572"
"SL2.50ch07:59388872-59389382","922","59388872","59389382","510","1336.01441019","0.381732409554"
"SL2.50ch07:59507081-59507651","6088","59507081","59507651","570","1336.01441019","0.426642104796"
"SL2.50ch07:59507100-59507681","6092","59507100","59507681","581","1336.01441019","0.434875548923"
"SL2.50ch07:61301593-61302334","971","61301593","61302334","741","1336.01441019","0.554634736235"
"SL2.50ch07:61301628-61302228","963","61301628","61302228","600","1336.01441019","0.449096952417"
"SL2.50ch07:62472101-62472482","138","62472101","62472482","381","1336.01441019","0.285176564785"
"SL2.50ch07:64790110-64790491","219","64790110","64790491","381","1336.01441019","0.285176564785"
"SL2.50ch07:65784674-65785078","575","65784674","65785078","404","1336.01441019","0.302391947961"
"SL2.50ch07:65784723-65785054","570","65784723","65785054","331","1336.01441019","0.24775181875"
"SL2.50ch07:67284176-67284832","147","67284176","67284832","656","1336.01441019","0.491012667976"
"SL2.50ch07:67912732-67913063","86","67912732","67913063","331","1336.01441019","0.24775181875"
"SL2.50ch07:6845941-6846255","72","6845941","6846255","314","1336.01441019","0.235027405098"
"SL2.50ch07:7832010-7832632","874","7832010","7832632","622","1336.01441019","0.465563840672"
"SL2.50ch07:7832066-7832643","869","7832066","7832643","577","1336.01441019","0.431881569241"
"SL2.50ch07:8823263-8824031","217","8823263","8824031","768","1336.01441019","0.574844099093"
"SL2.50ch07:8823669-8824050","131","8823669","8824050","381","1336.01441019","0.285176564785"
"SL2.50ch07:8824548-8825026","162","8824548","8825026","478","1336.01441019","0.357780572092"
"SL2.50ch07:9898065-9898700","144","9898065","9898700","635","1336.01441019","0.475294274641"
"SL2.50ch07:9898163-9898669","135","9898163","9898669","506","1336.01441019","0.378738429871"
"SL2.50ch07:9909935-9910328","101","9909935","9910328","393","1336.01441019","0.294158503833"
"SL2.50ch08:10002647-10004817","1297","10002647","10004817","2170","1336.01441019","1.62423397791"
"SL2.50ch08:10005533-10006891","913","10005533","10006891","1358","1336.01441019","1.0164561023"
"SL2.50ch08:10005568-10006873","897","10005568","10006873","1305","1336.01441019","0.976785871506"
"SL2.50ch08:10011790-10013473","1519","10011790","10013473","1683","1336.01441019","1.25971695153"
"SL2.50ch08:10011801-10013458","1519","10011801","10013458","1657","1336.01441019","1.24025608359"
"SL2.50ch08:10015712-10017858","2069","10015712","10017858","2146","1336.01441019","1.60627009981"
"SL2.50ch08:10015740-10017922","2069","10015740","10017922","2182","1336.01441019","1.63321591696"
"SL2.50ch08:10024208-10028275","3671","10024208","10028275","4067","1336.01441019","3.04412884246"
"SL2.50ch08:10024251-10028292","3669","10024251","10028292","4041","1336.01441019","3.02466797453"
"SL2.50ch08:10030595-10031855","721","10030595","10031855","1260","1336.01441019","0.943103600075"
"SL2.50ch08:10032600-10036508","2308","10032600","10036508","3908","1336.01441019","2.92511815007"
"SL2.50ch08:10118904-10119390","101","10118904","10119390","486","1336.01441019","0.363768531457"
"SL2.50ch08:10118930-10119322","95","10118930","10119322","392","1336.01441019","0.293410008912"
"SL2.50ch08:10428374-10428886","116","10428374","10428886","512","1336.01441019","0.383229399396"
"SL2.50ch08:10428946-10430169","451","10428946","10430169","1223","1336.01441019","0.915409288009"
"SL2.50ch08:10429599-10430003","276","10429599","10430003","404","1336.01441019","0.302391947961"
"SL2.50ch08:10434563-10437241","721","10434563","10437241","2678","1336.01441019","2.00446939762"
"SL2.50ch08:10445638-10446435","149","10445638","10446435","797","1336.01441019","0.596550451793"
"SL2.50ch08:10751620-10752185","120","10751620","10752185","565","1336.01441019","0.422899630192"
"SL2.50ch08:10821079-10821882","211","10821079","10821882","803","1336.01441019","0.601041421318"
"SL2.50ch08:10888296-10889971","403","10888296","10889971","1675","1336.01441019","1.25372899216"
"SL2.50ch08:10943904-10944540","147","10943904","10944540","636","1336.01441019","0.476042769562"
"SL2.50ch08:10943984-10944315","117","10943984","10944315","331","1336.01441019","0.24775181875"
"SL2.50ch08:11082853-11083390","828","11082853","11083390","537","1336.01441019","0.401941772413"
"SL2.50ch08:11082916-11083320","817","11082916","11083320","404","1336.01441019","0.302391947961"
"SL2.50ch08:11130561-11131537","1848","11130561","11131537","976","1336.01441019","0.730531042598"
"SL2.50ch08:11130610-11131455","1844","11130610","11131455","845","1336.01441019","0.632478207987"
"SL2.50ch08:11137944-11141315","27348","11137944","11141315","3371","1336.01441019","2.52317637766"
"SL2.50ch08:11137972-11141241","27340","11137972","11141241","3269","1336.01441019","2.44682989575"
"SL2.50ch08:11147893-11149553","2715","11147893","11149553","1660","1336.01441019","1.24250156835"
"SL2.50ch08:11147992-11149016","2618","11147992","11149016","1024","1336.01441019","0.766458798791"
"SL2.50ch08:11732661-11733614","1357","11732661","11733614","953","1336.01441019","0.713315659422"
"SL2.50ch08:11732707-11733646","1357","11732707","11733646","939","1336.01441019","0.702836730532"
"SL2.50ch08:11881136-11881517","138","11881136","11881517","381","1336.01441019","0.285176564785"
"SL2.50ch08:12167350-12167897","100","12167350","12167897","547","1336.01441019","0.40942672162"
"SL2.50ch08:14782902-14783428","96","14782902","14783428","526","1336.01441019","0.393708328285"
"SL2.50ch08:14814597-14814928","70","14814597","14814928","331","1336.01441019","0.24775181875"
"SL2.50ch08:14999691-15000656","1174","14999691","15000656","965","1336.01441019","0.72229759847"
"SL2.50ch08:14999740-15000606","1161","14999740","15000606","866","1336.01441019","0.648196601321"
"SL2.50ch08:15167804-15168524","799","15167804","15168524","720","1336.01441019","0.5389163429"
"SL2.50ch08:15167815-15168517","797","15167815","15168517","702","1336.01441019","0.525443434327"
"SL2.50ch08:15513806-15514870","353","15513806","15514870","1064","1336.01441019","0.796398595619"
"SL2.50ch08:15515420-15516377","305","15515420","15516377","957","1336.01441019","0.716309639105"
"SL2.50ch08:15515544-15516319","284","15515544","15516319","775","1336.01441019","0.580083563538"
"SL2.50ch08:15517604-15518082","129","15517604","15518082","478","1336.01441019","0.357780572092"
"SL2.50ch08:15542570-15543146","137","15542570","15543146","576","1336.01441019","0.43113307432"
"SL2.50ch08:15547426-15547934","158","15547426","15547934","508","1336.01441019","0.380235419713"
"SL2.50ch08:15554959-15555500","193","15554959","15555500","541","1336.01441019","0.404935752096"
"SL2.50ch08:15554971-15555471","193","15554971","15555471","500","1336.01441019","0.374247460347"
"SL2.50ch08:15556237-15557294","325","15556237","15557294","1057","1336.01441019","0.791159131174"
"SL2.50ch08:15556337-15556952","192","15556337","15556952","615","1336.01441019","0.460324376227"
"SL2.50ch08:15599337-15599668","68","15599337","15599668","331","1336.01441019","0.24775181875"
"SL2.50ch08:15611848-15612373","106","15611848","15612373","525","1336.01441019","0.392959833365"
"SL2.50ch08:15611858-15612262","90","15611858","15612262","404","1336.01441019","0.302391947961"
"SL2.50ch08:15838864-15839355","435","15838864","15839355","491","1336.01441019","0.367511006061"
"SL2.50ch08:15838937-15839341","429","15838937","15839341","404","1336.01441019","0.302391947961"
"SL2.50ch08:15840171-15840654","539","15840171","15840654","483","1336.01441019","0.361523046695"
"SL2.50ch08:15840223-15840700","530","15840223","15840700","477","1336.01441019","0.357032077171"
"SL2.50ch08:15842234-15842741","403","15842234","15842741","507","1336.01441019","0.379486924792"
"SL2.50ch08:15842254-15842829","410","15842254","15842829","575","1336.01441019","0.430384579399"
"SL2.50ch08:15843700-15844081","259","15843700","15844081","381","1336.01441019","0.285176564785"
"SL2.50ch08:15847434-15847878","310","15847434","15847878","444","1336.01441019","0.332331744788"
"SL2.50ch08:15847471-15847852","308","15847471","15847852","381","1336.01441019","0.285176564785"
"SL2.50ch08:16026869-16027904","1176","16026869","16027904","1035","1336.01441019","0.774692242919"
"SL2.50ch08:16026903-16027866","1166","16026903","16027866","963","1336.01441019","0.720800608629"
"SL2.50ch08:16031640-16032073","488","16031640","16032073","433","1336.01441019","0.324098300661"
"SL2.50ch08:16806935-16807249","66","16806935","16807249","314","1336.01441019","0.235027405098"
"SL2.50ch08:17270165-17270546","66","17270165","17270546","381","1336.01441019","0.285176564785"
"SL2.50ch08:17908895-17909226","42","17908895","17909226","331","1336.01441019","0.24775181875"
"SL2.50ch08:18438023-18438427","167","18438023","18438427","404","1336.01441019","0.302391947961"
"SL2.50ch08:20104688-20105019","72","20104688","20105019","331","1336.01441019","0.24775181875"
"SL2.50ch08:22009830-22010344","68","22009830","22010344","514","1336.01441019","0.384726389237"
"SL2.50ch08:22076676-22077080","57","22076676","22077080","404","1336.01441019","0.302391947961"
"SL2.50ch08:22534316-22534721","267","22534316","22534721","405","1336.01441019","0.303140442881"
"SL2.50ch08:24010344-24010725","80","24010344","24010725","381","1336.01441019","0.285176564785"
"SL2.50ch08:25335964-25336450","267","25335964","25336450","486","1336.01441019","0.363768531457"
"SL2.50ch08:25669393-25670020","278","25669393","25670020","627","1336.01441019","0.469306315275"
"SL2.50ch08:25669541-25669872","253","25669541","25669872","331","1336.01441019","0.24775181875"
"SL2.50ch08:2620359-2620865","479","2620359","2620865","506","1336.01441019","0.378738429871"
"SL2.50ch08:2620388-2620769","477","2620388","2620769","381","1336.01441019","0.285176564785"
"SL2.50ch08:26692777-26693800","383","26692777","26693800","1023","1336.01441019","0.76571030387"
"SL2.50ch08:27633104-27633749","9198","27633104","27633749","645","1336.01441019","0.482779223848"
"SL2.50ch08:27633182-27633720","9194","27633182","27633720","538","1336.01441019","0.402690267334"
"SL2.50ch08:28156057-28156388","184","28156057","28156388","331","1336.01441019","0.24775181875"
"SL2.50ch08:28974492-28975079","193","28974492","28975079","587","1336.01441019","0.439366518448"
"SL2.50ch08:29077358-29077772","61","29077358","29077772","414","1336.01441019","0.309876897167"
"SL2.50ch08:30786206-30786950","211","30786206","30786950","744","1336.01441019","0.556880220997"
"SL2.50ch08:30793548-30793929","98","30793548","30793929","381","1336.01441019","0.285176564785"
"SL2.50ch08:31765704-31766610","4749","31765704","31766610","906","1336.01441019","0.678136398149"
"SL2.50ch08:31765782-31766550","4735","31765782","31766550","768","1336.01441019","0.574844099093"
"SL2.50ch08:32821682-32822263","890","32821682","32822263","581","1336.01441019","0.434875548923"
"SL2.50ch08:32821774-32822279","886","32821774","32822279","505","1336.01441019","0.377989934951"
"SL2.50ch08:33047344-33047675","51","33047344","33047675","331","1336.01441019","0.24775181875"
"SL2.50ch08:34430564-34431484","234","34430564","34431484","920","1336.01441019","0.688615327039"
"SL2.50ch08:36327433-36327764","78","36327433","36327764","331","1336.01441019","0.24775181875"
"SL2.50ch08:36793005-36793386","79","36793005","36793386","381","1336.01441019","0.285176564785"
"SL2.50ch08:37202422-37203959","857","37202422","37203959","1537","1336.01441019","1.15043669311"
"SL2.50ch08:37202647-37203707","799","37202647","37203707","1060","1336.01441019","0.793404615936"
"SL2.50ch08:37401957-37402433","1110","37401957","37402433","476","1336.01441019","0.356283582251"
"SL2.50ch08:39144874-39154075","36071","39144874","39154075","9201","1336.01441019","6.88690176531"
"SL2.50ch08:39144954-39146361","3669","39144954","39146361","1407","1336.01441019","1.05313235342"
"SL2.50ch08:39148354-39154081","27994","39148354","39154081","5727","1336.01441019","4.28663041082"
"SL2.50ch08:39368577-39368908","163","39368577","39368908","331","1336.01441019","0.24775181875"
"SL2.50ch08:39823771-39824152","58","39823771","39824152","381","1336.01441019","0.285176564785"
"SL2.50ch08:40203197-40203674","87","40203197","40203674","477","1336.01441019","0.357032077171"
"SL2.50ch08:40547974-40548655","164","40547974","40548655","681","1336.01441019","0.509725040993"
"SL2.50ch08:41015930-41016311","73","41015930","41016311","381","1336.01441019","0.285176564785"
"SL2.50ch08:41075542-41076191","158","41075542","41076191","649","1336.01441019","0.485773203531"
"SL2.50ch08:41469338-41470035","120","41469338","41470035","697","1336.01441019","0.521700959724"
"SL2.50ch08:42177168-42177549","220","42177168","42177549","381","1336.01441019","0.285176564785"
"SL2.50ch08:42861626-42862141","162","42861626","42862141","515","1336.01441019","0.385474884158"
"SL2.50ch08:43103112-43103493","142","43103112","43103493","381","1336.01441019","0.285176564785"
"SL2.50ch08:4393994-4394436","451","4393994","4394436","442","1336.01441019","0.330834754947"
"SL2.50ch08:4393998-4394439","450","4393998","4394439","441","1336.01441019","0.330086260026"
"SL2.50ch08:44452684-44453110","124","44452684","44453110","426","1336.01441019","0.318858836216"
"SL2.50ch08:44453900-44454707","200","44453900","44454707","807","1336.01441019","0.604035401"
"SL2.50ch08:44453955-44454807","193","44453955","44454807","852","1336.01441019","0.637717672432"
"SL2.50ch08:44703510-44703921","165","44703510","44703921","411","1336.01441019","0.307631412405"
"SL2.50ch08:45328710-45329041","60","45328710","45329041","331","1336.01441019","0.24775181875"
"SL2.50ch08:46709361-46710441","1588","46709361","46710441","1080","1336.01441019","0.80837451435"
"SL2.50ch08:46709638-46710359","1538","46709638","46710359","721","1336.01441019","0.539664837821"
"SL2.50ch08:46711088-46711419","119","46711088","46711419","331","1336.01441019","0.24775181875"
"SL2.50ch08:46953388-46956864","43854","46953388","46956864","3476","1336.01441019","2.60176834433"
"SL2.50ch08:46953415-46956255","43771","46953415","46956255","2840","1336.01441019","2.12572557477"
"SL2.50ch08:48239831-48240908","1228","48239831","48240908","1077","1336.01441019","0.806129029588"
"SL2.50ch08:48239875-48240887","1223","48239875","48240887","1012","1336.01441019","0.757476859743"
"SL2.50ch08:49240268-49240824","81","49240268","49240824","556","1336.01441019","0.416163175906"
"SL2.50ch08:50477308-50478101","228","50477308","50478101","793","1336.01441019","0.593556472111"
"SL2.50ch08:50497942-50498323","83","50497942","50498323","381","1336.01441019","0.285176564785"
"SL2.50ch08:50544007-50544528","104","50544007","50544528","521","1336.01441019","0.389965853682"
"SL2.50ch08:5160554-5160885","20","5160554","5160885","331","1336.01441019","0.24775181875"
"SL2.50ch08:51743953-51744426","1757","51743953","51744426","473","1336.01441019","0.354038097488"
"SL2.50ch08:51879524-51880278","129","51879524","51880278","754","1336.01441019","0.564365170204"
"SL2.50ch08:52271090-52271421","34","52271090","52271421","331","1336.01441019","0.24775181875"
"SL2.50ch08:5420200-5420795","133","5420200","5420795","595","1336.01441019","0.445354477813"
"SL2.50ch08:54478649-54479041","1663","54478649","54479041","392","1336.01441019","0.293410008912"
"SL2.50ch08:54823862-54824451","211","54823862","54824451","589","1336.01441019","0.440863508289"
"SL2.50ch08:54901586-54901917","71","54901586","54901917","331","1336.01441019","0.24775181875"
"SL2.50ch08:54992822-54994428","329","54992822","54994428","1606","1336.01441019","1.20208284264"
"SL2.50ch08:54992918-54994412","318","54992918","54994412","1494","1336.01441019","1.11825141152"
"SL2.50ch08:57456480-57456922","987","57456480","57456922","442","1336.01441019","0.330834754947"
"SL2.50ch08:57456497-57456878","986","57456497","57456878","381","1336.01441019","0.285176564785"
"SL2.50ch08:57485275-57486166","4569","57485275","57486166","891","1336.01441019","0.666908974339"
"SL2.50ch08:57485318-57486127","4564","57485318","57486127","809","1336.01441019","0.605532390842"
"SL2.50ch08:57859970-57863383","967","57859970","57863383","3413","1336.01441019","2.55461316433"
"SL2.50ch08:60628938-60630113","413","60628938","60630113","1175","1336.01441019","0.879481531816"
"SL2.50ch08:60629025-60629899","366","60629025","60629899","874","1336.01441019","0.654184560687"
"SL2.50ch08:61394563-61394946","241","61394563","61394946","383","1336.01441019","0.286673554626"
"SL2.50ch08:63628678-63629726","250","63628678","63629726","1048","1336.01441019","0.784422676888"
"SL2.50ch08:65065998-65066664","164","65065998","65066664","666","1336.01441019","0.498497617182"
"SL2.50ch08:65133233-65133737","166","65133233","65133737","504","1336.01441019","0.37724144003"
"SL2.50ch08:65133290-65133715","157","65133290","65133715","425","1336.01441019","0.318110341295"
"SL2.50ch08:65307754-65308248","259","65307754","65308248","494","1336.01441019","0.369756490823"
"SL2.50ch08:65307832-65308213","255","65307832","65308213","381","1336.01441019","0.285176564785"
"SL2.50ch08:6538025-6538356","94","6538025","6538356","331","1336.01441019","0.24775181875"
"SL2.50ch08:6548254-6548871","2237","6548254","6548871","617","1336.01441019","0.461821366068"
"SL2.50ch08:7035515-7035997","332","7035515","7035997","482","1336.01441019","0.360774551775"
"SL2.50ch08:7035551-7035934","328","7035551","7035934","383","1336.01441019","0.286673554626"
"SL2.50ch08:7188815-7190115","192","7188815","7190115","1300","1336.01441019","0.973043396903"
"SL2.50ch08:7751707-7752126","215","7751707","7752126","419","1336.01441019","0.313619371771"
"SL2.50ch08:9428445-9429609","384","9428445","9429609","1164","1336.01441019","0.871248087688"
"SL2.50ch08:9453312-9453643","118","9453312","9453643","331","1336.01441019","0.24775181875"
"SL2.50ch08:9465674-9467113","586","9465674","9467113","1439","1336.01441019","1.07708419088"
"SL2.50ch08:9985700-9986431","704","9985700","9986431","731","1336.01441019","0.547149787028"
"SL2.50ch08:9985738-9986349","704","9985738","9986349","611","1336.01441019","0.457330396544"
"SL2.50ch08:9987917-9990374","3276","9987917","9990374","2457","1336.01441019","1.83905202015"
"SL2.50ch08:9987980-9990352","3245","9987980","9990352","2372","1336.01441019","1.77542995189"
"SL2.50ch08:9993060-9995894","3513","9993060","9995894","2834","1336.01441019","2.12123460525"
"SL2.50ch08:9993110-9995845","3476","9993110","9995845","2735","1336.01441019","2.0471336081"
"SL2.50ch09:10572288-10572752","214","10572288","10572752","464","1336.01441019","0.347301643202"
"SL2.50ch09:11297372-11304280","27926","11297372","11304280","6908","1336.01441019","5.17060291216"
"SL2.50ch09:11297455-11301487","18663","11297455","11301487","4032","1336.01441019","3.01793152024"
"SL2.50ch09:11302205-11304217","9156","11302205","11304217","2012","1336.01441019","1.50597178044"
"SL2.50ch09:11306416-11308324","6316","11306416","11308324","1908","1336.01441019","1.42812830868"
"SL2.50ch09:11306567-11308222","6293","11306567","11308222","1655","1336.01441019","1.23875909375"
"SL2.50ch09:11310024-11314093","9012","11310024","11314093","4069","1336.01441019","3.04562583231"
"SL2.50ch09:11310074-11312436","8439","11310074","11312436","2362","1336.01441019","1.76794500268"
"SL2.50ch09:11312983-11313898","489","11312983","11313898","915","1336.01441019","0.684872852435"
"SL2.50ch09:11838269-11838600","134","11838269","11838600","331","1336.01441019","0.24775181875"
"SL2.50ch09:13565000-13565471","57","13565000","13565471","471","1336.01441019","0.352541107647"
"SL2.50ch09:13687955-13688340","625","13687955","13688340","385","1336.01441019","0.288170544467"
"SL2.50ch09:13697408-13698632","244","13697408","13698632","1224","1336.01441019","0.91615778293"
"SL2.50ch09:15004929-15005310","396","15004929","15005310","381","1336.01441019","0.285176564785"
"SL2.50ch09:1555948-1556329","339","1555948","1556329","381","1336.01441019","0.285176564785"
"SL2.50ch09:1555956-1556389","339","1555956","1556389","433","1336.01441019","0.324098300661"
"SL2.50ch09:16106991-16107322","68","16106991","16107322","331","1336.01441019","0.24775181875"
"SL2.50ch09:17060794-17061198","292","17060794","17061198","404","1336.01441019","0.302391947961"
"SL2.50ch09:17060804-17061135","288","17060804","17061135","331","1336.01441019","0.24775181875"
"SL2.50ch09:17597972-17598353","57","17597972","17598353","381","1336.01441019","0.285176564785"
"SL2.50ch09:17852973-17853411","129","17852973","17853411","438","1336.01441019","0.327840775264"
"SL2.50ch09:17853002-17853383","129","17853002","17853383","381","1336.01441019","0.285176564785"
"SL2.50ch09:18467903-18468328","119","18467903","18468328","425","1336.01441019","0.318110341295"
"SL2.50ch09:18938957-18939338","527","18938957","18939338","381","1336.01441019","0.285176564785"
"SL2.50ch09:21762754-21763135","83","21762754","21763135","381","1336.01441019","0.285176564785"
"SL2.50ch09:21821098-21821429","94","21821098","21821429","331","1336.01441019","0.24775181875"
"SL2.50ch09:21941177-21941508","32","21941177","21941508","331","1336.01441019","0.24775181875"
"SL2.50ch09:22135943-22136274","100","22135943","22136274","331","1336.01441019","0.24775181875"
"SL2.50ch09:22431248-22431629","74","22431248","22431629","381","1336.01441019","0.285176564785"
"SL2.50ch09:22437801-22438132","71","22437801","22438132","331","1336.01441019","0.24775181875"
"SL2.50ch09:22897093-22897424","67","22897093","22897424","331","1336.01441019","0.24775181875"
"SL2.50ch09:2437108-2437694","1716","2437108","2437694","586","1336.01441019","0.438618023527"
"SL2.50ch09:2437132-2437672","1716","2437132","2437672","540","1336.01441019","0.404187257175"
"SL2.50ch09:24474565-24475346","2996","24474565","24475346","781","1336.01441019","0.584574533062"
"SL2.50ch09:24474571-24475431","3006","24474571","24475431","860","1336.01441019","0.643705631797"
"SL2.50ch09:25663452-25663766","63","25663452","25663766","314","1336.01441019","0.235027405098"
"SL2.50ch09:25887279-25887683","495","25887279","25887683","404","1336.01441019","0.302391947961"
"SL2.50ch09:25887332-25887713","492","25887332","25887713","381","1336.01441019","0.285176564785"
"SL2.50ch09:26984447-26984828","47","26984447","26984828","381","1336.01441019","0.285176564785"
"SL2.50ch09:27413762-27414450","204","27413762","27414450","688","1336.01441019","0.514964505438"
"SL2.50ch09:27651027-27651544","67","27651027","27651544","517","1336.01441019","0.386971873999"
"SL2.50ch09:29279607-29280010","79","29279607","29280010","403","1336.01441019","0.30164345304"
"SL2.50ch09:29381878-29382209","73","29381878","29382209","331","1336.01441019","0.24775181875"
"SL2.50ch09:35300706-35302558","8604","35300706","35302558","1852","1336.01441019","1.38621259313"
"SL2.50ch09:35300711-35302502","8604","35300711","35302502","1791","1336.01441019","1.34055440296"
"SL2.50ch09:35303361-35309113","19148","35303361","35309113","5752","1336.01441019","4.30534278383"
"SL2.50ch09:37523012-37523659","630","37523012","37523659","647","1336.01441019","0.484276213689"
"SL2.50ch09:37523144-37523629","621","37523144","37523629","485","1336.01441019","0.363020036537"
"SL2.50ch09:37543881-37544373","95","37543881","37544373","492","1336.01441019","0.368259500982"
"SL2.50ch09:37849789-37850170","50","37849789","37850170","381","1336.01441019","0.285176564785"
"SL2.50ch09:3963936-3964267","140","3963936","3964267","331","1336.01441019","0.24775181875"
"SL2.50ch09:39657490-39657821","64","39657490","39657821","331","1336.01441019","0.24775181875"
"SL2.50ch09:40280143-40281553","49604","40280143","40281553","1410","1336.01441019","1.05537783818"
"SL2.50ch09:40280172-40281545","49602","40280172","40281545","1373","1336.01441019","1.02768352611"
"SL2.50ch09:40947194-40947781","159","40947194","40947781","587","1336.01441019","0.439366518448"
"SL2.50ch09:40947203-40947715","155","40947203","40947715","512","1336.01441019","0.383229399396"
"SL2.50ch09:41017563-41017894","68","41017563","41017894","331","1336.01441019","0.24775181875"
"SL2.50ch09:41491452-41491783","40","41491452","41491783","331","1336.01441019","0.24775181875"
"SL2.50ch09:41909205-41909648","134","41909205","41909648","443","1336.01441019","0.331583249868"
"SL2.50ch09:41911466-41912964","399","41911466","41912964","1498","1336.01441019","1.1212453912"
"SL2.50ch09:42412888-42413390","79","42412888","42413390","502","1336.01441019","0.375744450189"
"SL2.50ch09:42668675-42669276","85","42668675","42669276","601","1336.01441019","0.449845447337"
"SL2.50ch09:43219510-43219841","71","43219510","43219841","331","1336.01441019","0.24775181875"
"SL2.50ch09:44296701-44297082","67","44296701","44297082","381","1336.01441019","0.285176564785"
"SL2.50ch09:45297510-45298512","268","45297510","45298512","1002","1336.01441019","0.749991910536"
"SL2.50ch09:45297710-45298261","191","45297710","45298261","551","1336.01441019","0.412420701303"
"SL2.50ch09:45397104-45398205","1791","45397104","45398205","1101","1336.01441019","0.824092907685"
"SL2.50ch09:45397113-45398181","1786","45397113","45398181","1068","1336.01441019","0.799392575302"
"SL2.50ch09:45750930-45751311","52","45750930","45751311","381","1336.01441019","0.285176564785"
"SL2.50ch09:46223872-46224276","61","46223872","46224276","404","1336.01441019","0.302391947961"
"SL2.50ch09:46262512-46263393","22679","46262512","46263393","881","1336.01441019","0.659424025132"
"SL2.50ch09:46262519-46263341","22678","46262519","46263341","822","1336.01441019","0.615262824811"
"SL2.50ch09:46687672-46688188","106","46687672","46688188","516","1336.01441019","0.386223379078"
"SL2.50ch09:46687826-46688157","84","46687826","46688157","331","1336.01441019","0.24775181875"
"SL2.50ch09:48658671-48659075","62","48658671","48659075","404","1336.01441019","0.302391947961"
"SL2.50ch09:48889000-48889623","199","48889000","48889623","623","1336.01441019","0.466312335593"
"SL2.50ch09:48889173-48889607","184","48889173","48889607","434","1336.01441019","0.324846795581"
"SL2.50ch09:49473050-49473529","177","49473050","49473529","479","1336.01441019","0.358529067013"
"SL2.50ch09:49777729-49778110","80","49777729","49778110","381","1336.01441019","0.285176564785"
"SL2.50ch09:50745655-50746138","601","50745655","50746138","483","1336.01441019","0.361523046695"
"SL2.50ch09:50745734-50746148","596","50745734","50746148","414","1336.01441019","0.309876897167"
"SL2.50ch09:51276055-51276436","1149","51276055","51276436","381","1336.01441019","0.285176564785"
"SL2.50ch09:51473938-51474319","31","51473938","51474319","381","1336.01441019","0.285176564785"
"SL2.50ch09:52104855-52105186","209","52104855","52105186","331","1336.01441019","0.24775181875"
"SL2.50ch09:53088477-53090485","10331","53088477","53090485","2008","1336.01441019","1.50297780075"
"SL2.50ch09:53088577-53090450","10322","53088577","53090450","1873","1336.01441019","1.40193098646"
"SL2.50ch09:53498611-53499037","112","53498611","53499037","426","1336.01441019","0.318858836216"
"SL2.50ch09:56322360-56322811","403","56322360","56322811","451","1336.01441019","0.337571209233"
"SL2.50ch09:56413626-56414046","216","56413626","56414046","420","1336.01441019","0.314367866692"
"SL2.50ch09:56413745-56414076","216","56413745","56414076","331","1336.01441019","0.24775181875"
"SL2.50ch09:57813604-57814516","217","57813604","57814516","912","1336.01441019","0.682627367673"
"SL2.50ch09:58995843-58996883","7446","58995843","58996883","1040","1336.01441019","0.778434717522"
"SL2.50ch09:58995972-58996780","7425","58995972","58996780","808","1336.01441019","0.604783895921"
"SL2.50ch09:60656738-60657422","1059","60656738","60657422","684","1336.01441019","0.511970525755"
"SL2.50ch09:60656793-60657396","1050","60656793","60657396","603","1336.01441019","0.451342437179"
"SL2.50ch09:61857443-61858157","9959","61857443","61858157","714","1336.01441019","0.534425373376"
"SL2.50ch09:61857460-61858188","9959","61857460","61858188","728","1336.01441019","0.544904302266"
"SL2.50ch09:62110648-62111029","1085","62110648","62111029","381","1336.01441019","0.285176564785"
"SL2.50ch09:63828888-63829269","272","63828888","63829269","381","1336.01441019","0.285176564785"
"SL2.50ch09:63970902-63971418","6798","63970902","63971418","516","1336.01441019","0.386223379078"
"SL2.50ch09:63970917-63971489","6800","63970917","63971489","572","1336.01441019","0.428139094637"
"SL2.50ch09:63993860-63994241","661","63993860","63994241","381","1336.01441019","0.285176564785"
"SL2.50ch09:64377909-64378414","234","64377909","64378414","505","1336.01441019","0.377989934951"
"SL2.50ch09:6479807-6480138","42","6479807","6480138","331","1336.01441019","0.24775181875"
"SL2.50ch09:64935394-64937239","503","64935394","64937239","1845","1336.01441019","1.38097312868"
"SL2.50ch09:64935641-64936588","331","64935641","64936588","947","1336.01441019","0.708824689898"
"SL2.50ch09:67002243-67003144","209","67002243","67003144","901","1336.01441019","0.674393923546"
"SL2.50ch09:67002297-67003131","196","67002297","67003131","834","1336.01441019","0.624244763859"
"SL2.50ch09:6789966-6791370","1337","6789966","6791370","1404","1336.01441019","1.05088686865"
"SL2.50ch09:6789982-6791313","1334","6789982","6791313","1331","1336.01441019","0.996246739444"
"SL2.50ch09:68836714-68838170","369","68836714","68838170","1456","1336.01441019","1.08980860453"
"SL2.50ch09:68836781-68838147","351","68836781","68838147","1366","1336.01441019","1.02244406167"
"SL2.50ch09:70696428-70697064","1686","70696428","70697064","636","1336.01441019","0.476042769562"
"SL2.50ch09:70696558-70697034","1671","70696558","70697034","476","1336.01441019","0.356283582251"
"SL2.50ch09:71690438-71690842","65","71690438","71690842","404","1336.01441019","0.302391947961"
"SL2.50ch09:7384113-7384507","171","7384113","7384507","394","1336.01441019","0.294906998754"
"SL2.50ch09:7384153-7384467","170","7384153","7384467","314","1336.01441019","0.235027405098"
"SL2.50ch09:8551095-8551787","999","8551095","8551787","692","1336.01441019","0.517958485121"
"SL2.50ch09:8786499-8786830","221","8786499","8786830","331","1336.01441019","0.24775181875"
"SL2.50ch10:10731620-10732316","1087","10731620","10732316","696","1336.01441019","0.520952464803"
"SL2.50ch10:10731672-10732352","1078","10731672","10732352","680","1336.01441019","0.508976546072"
"SL2.50ch10:10733685-10734225","650","10733685","10734225","540","1336.01441019","0.404187257175"
"SL2.50ch10:10733693-10734261","651","10733693","10734261","568","1336.01441019","0.425145114954"
"SL2.50ch10:10734837-10735485","864","10734837","10735485","648","1336.01441019","0.48502470861"
"SL2.50ch10:10734970-10735446","839","10734970","10735446","476","1336.01441019","0.356283582251"
"SL2.50ch10:11251487-11251966","348","11251487","11251966","479","1336.01441019","0.358529067013"
"SL2.50ch10:11251503-11251927","344","11251503","11251927","424","1336.01441019","0.317361846374"
"SL2.50ch10:11687715-11688411","134","11687715","11688411","696","1336.01441019","0.520952464803"
"SL2.50ch10:11928798-11929179","61","11928798","11929179","381","1336.01441019","0.285176564785"
"SL2.50ch10:13079170-13079551","122","13079170","13079551","381","1336.01441019","0.285176564785"
"SL2.50ch10:13112776-13113266","143","13112776","13113266","490","1336.01441019","0.36676251114"
"SL2.50ch10:13192538-13193260","127","13192538","13193260","722","1336.01441019","0.540413332741"
"SL2.50ch10:14905372-14905761","119","14905372","14905761","389","1336.01441019","0.29116452415"
"SL2.50ch10:15241490-15242831","37524","15241490","15242831","1341","1336.01441019","1.00373168865"
"SL2.50ch10:15241521-15242839","37524","15241521","15242839","1318","1336.01441019","0.986516305475"
"SL2.50ch10:15272457-15273031","186","15272457","15273031","574","1336.01441019","0.429636084479"
"SL2.50ch10:15654082-15654413","84","15654082","15654413","331","1336.01441019","0.24775181875"
"SL2.50ch10:15739002-15739471","117","15739002","15739471","469","1336.01441019","0.351044117806"
"SL2.50ch10:15756893-15757307","112","15756893","15757307","414","1336.01441019","0.309876897167"
"SL2.50ch10:15785019-15785706","206","15785019","15785706","687","1336.01441019","0.514216010517"
"SL2.50ch10:15809046-15809427","86","15809046","15809427","381","1336.01441019","0.285176564785"
"SL2.50ch10:15828403-15828933","142","15828403","15828933","530","1336.01441019","0.396702307968"
"SL2.50ch10:15836524-15837418","171","15836524","15837418","894","1336.01441019","0.669154459101"
"SL2.50ch10:16038644-16038958","63","16038644","16038958","314","1336.01441019","0.235027405098"
"SL2.50ch10:16338841-16339222","135","16338841","16339222","381","1336.01441019","0.285176564785"
"SL2.50ch10:16959772-16960153","60","16959772","16960153","381","1336.01441019","0.285176564785"
"SL2.50ch10:17152475-17152806","66","17152475","17152806","331","1336.01441019","0.24775181875"
"SL2.50ch10:17488601-17488932","33","17488601","17488932","331","1336.01441019","0.24775181875"
"SL2.50ch10:17728555-17728936","70","17728555","17728936","381","1336.01441019","0.285176564785"
"SL2.50ch10:18055037-18055568","92","18055037","18055568","531","1336.01441019","0.397450802889"
"SL2.50ch10:18417889-18421988","1501","18417889","18421988","4099","1336.01441019","3.06808067993"
"SL2.50ch10:18419554-18421837","1106","18419554","18421837","2283","1336.01441019","1.70881390395"
"SL2.50ch10:19554684-19555161","113","19554684","19555161","477","1336.01441019","0.357032077171"
"SL2.50ch10:21219810-21221049","282","21219810","21221049","1239","1336.01441019","0.92738520674"
"SL2.50ch10:21220717-21221098","93","21220717","21221098","381","1336.01441019","0.285176564785"
"SL2.50ch10:21226044-21227861","418","21226044","21227861","1817","1336.01441019","1.3600152709"
"SL2.50ch10:21231503-21232793","381","21231503","21232793","1290","1336.01441019","0.965558447696"
"SL2.50ch10:21236697-21237727","223","21236697","21237727","1030","1336.01441019","0.770949768315"
"SL2.50ch10:21247095-21247945","243","21247095","21247945","850","1336.01441019","0.63622068259"
"SL2.50ch10:21909257-21909638","83","21909257","21909638","381","1336.01441019","0.285176564785"
"SL2.50ch10:21912336-21912895","160","21912336","21912895","559","1336.01441019","0.418408660668"
"SL2.50ch10:21912523-21912854","125","21912523","21912854","331","1336.01441019","0.24775181875"
"SL2.50ch10:22463263-22463644","748","22463263","22463644","381","1336.01441019","0.285176564785"
"SL2.50ch10:22665357-22665920","451","22665357","22665920","563","1336.01441019","0.421402640351"
"SL2.50ch10:22665366-22665842","445","22665366","22665842","476","1336.01441019","0.356283582251"
"SL2.50ch10:23944414-23944745","294","23944414","23944745","331","1336.01441019","0.24775181875"
"SL2.50ch10:23945481-23946086","642","23945481","23946086","605","1336.01441019","0.45283942702"
"SL2.50ch10:23945593-23945997","599","23945593","23945997","404","1336.01441019","0.302391947961"
"SL2.50ch10:23948670-23949189","291","23948670","23949189","519","1336.01441019","0.38846886384"
"SL2.50ch10:23948721-23949209","291","23948721","23949209","488","1336.01441019","0.365265521299"
"SL2.50ch10:23987423-23987829","298","23987423","23987829","406","1336.01441019","0.303888937802"
"SL2.50ch10:23987430-23987921","304","23987430","23987921","491","1336.01441019","0.367511006061"
"SL2.50ch10:24143875-24144206","203","24143875","24144206","331","1336.01441019","0.24775181875"
"SL2.50ch10:24144714-24145133","275","24144714","24145133","419","1336.01441019","0.313619371771"
"SL2.50ch10:25777284-25778078","3374","25777284","25778078","794","1336.01441019","0.594304967031"
"SL2.50ch10:26351606-26353632","564","26351606","26353632","2026","1336.01441019","1.51645070933"
"SL2.50ch10:26364063-26364988","276","26364063","26364988","925","1336.01441019","0.692357801642"
"SL2.50ch10:26372427-26374567","625","26372427","26374567","2140","1336.01441019","1.60177913029"
"SL2.50ch10:26801345-26803921","19226","26801345","26803921","2576","1336.01441019","1.92812291571"
"SL2.50ch10:26801376-26803810","19212","26801376","26803810","2434","1336.01441019","1.82183663697"
"SL2.50ch10:26805624-26806588","4803","26805624","26806588","964","1336.01441019","0.721549103549"
"SL2.50ch10:26805673-26806571","4795","26805673","26806571","898","1336.01441019","0.672148438784"
"SL2.50ch10:27361328-27361709","29","27361328","27361709","381","1336.01441019","0.285176564785"
"SL2.50ch10:27367963-27368518","3732","27367963","27368518","555","1336.01441019","0.415414680985"
"SL2.50ch10:2743197-2744195","229","2743197","2744195","998","1336.01441019","0.746997930853"
"SL2.50ch10:27729001-27729332","52","27729001","27729332","331","1336.01441019","0.24775181875"
"SL2.50ch10:27831882-27832263","66","27831882","27832263","381","1336.01441019","0.285176564785"
"SL2.50ch10:28297984-28299299","766","28297984","28299299","1315","1336.01441019","0.984270820713"
"SL2.50ch10:28300057-28300751","209","28300057","28300751","694","1336.01441019","0.519455474962"
"SL2.50ch10:28302218-28303445","353","28302218","28303445","1227","1336.01441019","0.918403267692"
"SL2.50ch10:28333904-28334285","110","28333904","28334285","381","1336.01441019","0.285176564785"
"SL2.50ch10:3100881-3101351","922","3100881","3101351","470","1336.01441019","0.351792612726"
"SL2.50ch10:3100943-3101358","917","3100943","3101358","415","1336.01441019","0.310625392088"
"SL2.50ch10:33008469-33009405","267","33008469","33009405","936","1336.01441019","0.70059124577"
"SL2.50ch10:33012053-33012679","126","33012053","33012679","626","1336.01441019","0.468557820355"
"SL2.50ch10:33013242-33015279","417","33013242","33015279","2037","1336.01441019","1.52468415345"
"SL2.50ch10:33025491-33026363","183","33025491","33026363","872","1336.01441019","0.652687570846"
"SL2.50ch10:33027836-33028167","93","33027836","33028167","331","1336.01441019","0.24775181875"
"SL2.50ch10:33367682-33368161","343","33367682","33368161","479","1336.01441019","0.358529067013"
"SL2.50ch10:34942527-34942858","73","34942527","34942858","331","1336.01441019","0.24775181875"
"SL2.50ch10:3515258-3517489","434","3515258","3517489","2231","1336.01441019","1.66989216807"
"SL2.50ch10:36684473-36685261","527","36684473","36685261","788","1336.01441019","0.589813997507"
"SL2.50ch10:36684506-36685324","540","36684506","36685324","818","1336.01441019","0.612268845128"
"SL2.50ch10:36692920-36693393","292","36692920","36693393","473","1336.01441019","0.354038097488"
"SL2.50ch10:36692976-36693357","286","36692976","36693357","381","1336.01441019","0.285176564785"
"SL2.50ch10:37167936-37168372","113","37167936","37168372","436","1336.01441019","0.326343785423"
"SL2.50ch10:37171205-37171832","2834","37171205","37171832","627","1336.01441019","0.469306315275"
"SL2.50ch10:37433232-37433563","62","37433232","37433563","331","1336.01441019","0.24775181875"
"SL2.50ch10:3749220-3749731","111","3749220","3749731","511","1336.01441019","0.382480904475"
"SL2.50ch10:3771256-3771649","88","3771256","3771649","393","1336.01441019","0.294158503833"
"SL2.50ch10:3774237-3775333","262","3774237","3775333","1096","1336.01441019","0.820350433081"
"SL2.50ch10:37795371-37795911","227","37795371","37795911","540","1336.01441019","0.404187257175"
"SL2.50ch10:37795420-37795834","219","37795420","37795834","414","1336.01441019","0.309876897167"
"SL2.50ch10:38097440-38098119","219","38097440","38098119","679","1336.01441019","0.508228051152"
"SL2.50ch10:38103513-38105024","376","38103513","38105024","1511","1336.01441019","1.13097582517"
"SL2.50ch10:38148179-38148560","74","38148179","38148560","381","1336.01441019","0.285176564785"
"SL2.50ch10:3825346-3826282","218","3825346","3826282","936","1336.01441019","0.70059124577"
"SL2.50ch10:38518278-38518682","90","38518278","38518682","404","1336.01441019","0.302391947961"
"SL2.50ch10:38788572-38788903","33","38788572","38788903","331","1336.01441019","0.24775181875"
"SL2.50ch10:39018173-39019106","1352","39018173","39019106","933","1336.01441019","0.698345761008"
"SL2.50ch10:39018177-39019168","1358","39018177","39019168","991","1336.01441019","0.741758466408"
"SL2.50ch10:39505430-39506024","3051","39505430","39506024","594","1336.01441019","0.444605982892"
"SL2.50ch10:39505488-39505961","3045","39505488","39505961","473","1336.01441019","0.354038097488"
"SL2.50ch10:40514730-40515367","80","40514730","40515367","637","1336.01441019","0.476791264482"
"SL2.50ch10:40794625-40797335","8333","40794625","40797335","2710","1336.01441019","2.02842123508"
"SL2.50ch10:40798540-40800270","13878","40798540","40800270","1730","1336.01441019","1.2948962128"
"SL2.50ch10:40803618-40804361","2186","40803618","40804361","743","1336.01441019","0.556131726076"
"SL2.50ch10:40803668-40804243","2171","40803668","40804243","575","1336.01441019","0.430384579399"
"SL2.50ch10:41052210-41052591","145","41052210","41052591","381","1336.01441019","0.285176564785"
"SL2.50ch10:41646838-41647325","626","41646838","41647325","487","1336.01441019","0.364517026378"
"SL2.50ch10:4216994-4217610","126","4216994","4217610","616","1336.01441019","0.461072871148"
"SL2.50ch10:4223331-4223712","44","4223331","4223712","381","1336.01441019","0.285176564785"
"SL2.50ch10:42461282-42461695","150","42461282","42461695","413","1336.01441019","0.309128402247"
"SL2.50ch10:43054947-43058129","1876","43054947","43058129","3182","1336.01441019","2.38171083765"
"SL2.50ch10:43054961-43058440","1937","43054961","43058440","3479","1336.01441019","2.6040138291"
"SL2.50ch10:43331276-43331607","76","43331276","43331607","331","1336.01441019","0.24775181875"
"SL2.50ch10:43880868-43882563","18402","43880868","43882563","1695","1336.01441019","1.26869889058"
"SL2.50ch10:43880893-43882499","18339","43880893","43882499","1606","1336.01441019","1.20208284264"
"SL2.50ch10:43884406-43885636","8914","43884406","43885636","1230","1336.01441019","0.920648752454"
"SL2.50ch10:43884432-43885580","8892","43884432","43885580","1148","1336.01441019","0.859272168957"
"SL2.50ch10:43886611-43888316","17923","43886611","43888316","1705","1336.01441019","1.27618383978"
"SL2.50ch10:43886619-43888345","17923","43886619","43888345","1726","1336.01441019","1.29190223312"
"SL2.50ch10:43892734-43893347","2723","43892734","43893347","613","1336.01441019","0.458827386386"
"SL2.50ch10:43892739-43893413","2729","43892739","43893413","674","1336.01441019","0.504485576548"
"SL2.50ch10:45905566-45906318","3176","45905566","45906318","752","1336.01441019","0.562868180362"
"SL2.50ch10:45905589-45906284","3174","45905589","45906284","695","1336.01441019","0.520203969883"
"SL2.50ch10:46079402-46079935","124","46079402","46079935","533","1336.01441019","0.39894779273"
"SL2.50ch10:46186212-46186627","157","46186212","46186627","415","1336.01441019","0.310625392088"
"SL2.50ch10:47-562","290","47","562","515","1336.01441019","0.385474884158"
"SL2.50ch10:4700026-4700922","11108","4700026","4700922","896","1336.01441019","0.670651448942"
"SL2.50ch10:4700081-4700864","11106","4700081","4700864","783","1336.01441019","0.586071522904"
"SL2.50ch10:47369452-47369936","167","47369452","47369936","484","1336.01441019","0.362271541616"
"SL2.50ch10:47369559-47369942","163","47369559","47369942","383","1336.01441019","0.286673554626"
"SL2.50ch10:47595913-47598242","696","47595913","47598242","2329","1336.01441019","1.7432446703"
"SL2.50ch10:47607064-47607863","181","47607064","47607863","799","1336.01441019","0.598047441635"
"SL2.50ch10:48524361-48524742","475","48524361","48524742","381","1336.01441019","0.285176564785"
"SL2.50ch10:50260688-50261069","54","50260688","50261069","381","1336.01441019","0.285176564785"
"SL2.50ch10:52429802-52430183","95","52429802","52430183","381","1336.01441019","0.285176564785"
"SL2.50ch10:53322801-53323370","3479","53322801","53323370","569","1336.01441019","0.425893609875"
"SL2.50ch10:53322881-53323357","3472","53322881","53323357","476","1336.01441019","0.356283582251"
"SL2.50ch10:53466316-53466803","271","53466316","53466803","487","1336.01441019","0.364517026378"
"SL2.50ch10:53525560-53526223","858","53525560","53526223","663","1336.01441019","0.49625213242"
"SL2.50ch10:53525600-53526245","858","53525600","53526245","645","1336.01441019","0.482779223848"
"SL2.50ch10:54023122-54024529","358","54023122","54024529","1407","1336.01441019","1.05313235342"
"SL2.50ch10:54026985-54027366","123","54026985","54027366","381","1336.01441019","0.285176564785"
"SL2.50ch10:54033977-54034308","104","54033977","54034308","331","1336.01441019","0.24775181875"
"SL2.50ch10:57-646","292","57","646","589","1336.01441019","0.440863508289"
"SL2.50ch10:57564317-57565777","443","57564317","57565777","1460","1336.01441019","1.09280258421"
"SL2.50ch10:57574723-57575319","176","57574723","57575319","596","1336.01441019","0.446102972734"
"SL2.50ch10:57576102-57578546","810","57576102","57578546","2444","1336.01441019","1.82932158618"
"SL2.50ch10:57584248-57584871","231","57584248","57584871","623","1336.01441019","0.466312335593"
"SL2.50ch10:57584364-57584790","206","57584364","57584790","426","1336.01441019","0.318858836216"
"SL2.50ch10:57587455-57588500","476","57587455","57588500","1045","1336.01441019","0.782177192126"
"SL2.50ch10:57594384-57595207","356","57594384","57595207","823","1336.01441019","0.616011319731"
"SL2.50ch10:57594506-57595182","339","57594506","57595182","676","1336.01441019","0.505982566389"
"SL2.50ch10:57633781-57634112","78","57633781","57634112","331","1336.01441019","0.24775181875"
"SL2.50ch10:57635553-57635884","72","57635553","57635884","331","1336.01441019","0.24775181875"
"SL2.50ch10:57640306-57641896","504","57640306","57641896","1590","1336.01441019","1.1901069239"
"SL2.50ch10:57640331-57642120","541","57640331","57642120","1789","1336.01441019","1.33905741312"
"SL2.50ch10:57648449-57648853","74","57648449","57648853","404","1336.01441019","0.302391947961"
"SL2.50ch10:57659220-57660471","598","57659220","57660471","1251","1336.01441019","0.936367145789"
"SL2.50ch10:57659290-57660280","562","57659290","57660280","990","1336.01441019","0.741009971487"
"SL2.50ch10:57663451-57664326","184","57663451","57664326","875","1336.01441019","0.654933055608"
"SL2.50ch10:57664883-57665515","237","57664883","57665515","632","1336.01441019","0.473048789879"
"SL2.50ch10:57686786-57687387","139","57686786","57687387","601","1336.01441019","0.449845447337"
"SL2.50ch10:57697919-57699039","326","57697919","57699039","1120","1336.01441019","0.838314311178"
"SL2.50ch10:57698011-57699110","319","57698011","57699110","1099","1336.01441019","0.822595917843"
"SL2.50ch10:57700938-57702308","529","57700938","57702308","1370","1336.01441019","1.02543804135"
"SL2.50ch10:57701011-57702306","522","57701011","57702306","1295","1336.01441019","0.969300922299"
"SL2.50ch10:60633557-60633961","100","60633557","60633961","404","1336.01441019","0.302391947961"
"SL2.50ch10:6175256-6186574","110489","6175256","6186574","11318","1336.01441019","8.47146551242"
"SL2.50ch10:6175273-6186606","110488","6175273","6186606","11333","1336.01441019","8.48269293623"
"SL2.50ch10:6187256-6187865","2210","6187256","6187865","609","1336.01441019","0.455833406703"
"SL2.50ch10:6187267-6187841","2209","6187267","6187841","574","1336.01441019","0.429636084479"
"SL2.50ch10:62954773-62955154","54","62954773","62955154","381","1336.01441019","0.285176564785"
"SL2.50ch10:62960379-62960792","80","62960379","62960792","413","1336.01441019","0.309128402247"
"SL2.50ch10:63001181-63001750","143","63001181","63001750","569","1336.01441019","0.425893609875"
"SL2.50ch10:63001270-63001774","132","63001270","63001774","504","1336.01441019","0.37724144003"
"SL2.50ch10:65521147-65522487","412","65521147","65522487","1340","1336.01441019","1.00298319373"
"SL2.50ch10:65523634-65525509","607","65523634","65525509","1875","1336.01441019","1.4034279763"
"SL2.50ch10:65523654-65525477","607","65523654","65525477","1823","1336.01441019","1.36450624043"
"SL2.50ch10:7372366-7372794","548","7372366","7372794","428","1336.01441019","0.320355826057"
"SL2.50ch10:7372371-7372752","547","7372371","7372752","381","1336.01441019","0.285176564785"
"SL2.50ch10:7893911-7894584","118","7893911","7894584","673","1336.01441019","0.503737081627"
"SL2.50ch10:8660010-8660414","74","8660010","8660414","404","1336.01441019","0.302391947961"
"SL2.50ch10:9020980-9021472","643","9020980","9021472","492","1336.01441019","0.368259500982"
"SL2.50ch10:9021051-9021481","636","9021051","9021481","430","1336.01441019","0.321852815899"
"SL2.50ch11:10491901-10492282","61","10491901","10492282","381","1336.01441019","0.285176564785"
"SL2.50ch11:10763052-10763578","98","10763052","10763578","526","1336.01441019","0.393708328285"
"SL2.50ch11:10861838-10862311","536","10861838","10862311","473","1336.01441019","0.354038097488"
"SL2.50ch11:10861882-10862263","535","10861882","10862263","381","1336.01441019","0.285176564785"
"SL2.50ch11:11073228-11074951","503","11073228","11074951","1723","1336.01441019","1.28965674836"
"SL2.50ch11:11073297-11074938","492","11073297","11074938","1641","1336.01441019","1.22828016486"
"SL2.50ch11:11075926-11076497","143","11075926","11076497","571","1336.01441019","0.427390599717"
"SL2.50ch11:11078484-11081752","598","11078484","11081752","3268","1336.01441019","2.44608140083"
"SL2.50ch11:11078491-11080974","467","11078491","11080974","2483","1336.01441019","1.85851288808"
"SL2.50ch11:11090778-11091159","50","11090778","11091159","381","1336.01441019","0.285176564785"
"SL2.50ch11:11287975-11288821","283","11287975","11288821","846","1336.01441019","0.633226702907"
"SL2.50ch11:11288233-11288822","272","11288233","11288822","589","1336.01441019","0.440863508289"
"SL2.50ch11:12015871-12016420","1670","12015871","12016420","549","1336.01441019","0.410923711461"
"SL2.50ch11:12015943-12016356","1667","12015943","12016356","413","1336.01441019","0.309128402247"
"SL2.50ch11:12656102-12656433","53","12656102","12656433","331","1336.01441019","0.24775181875"
"SL2.50ch11:12908974-12909779","53","12908974","12909779","805","1336.01441019","0.602538411159"
"SL2.50ch11:13246427-13247114","89","13246427","13247114","687","1336.01441019","0.514216010517"
"SL2.50ch11:13365977-13367097","604","13365977","13367097","1120","1336.01441019","0.838314311178"
"SL2.50ch11:13377601-13380916","44899","13377601","13380916","3315","1336.01441019","2.4812606621"
"SL2.50ch11:13378088-13380856","44788","13378088","13380856","2768","1336.01441019","2.07183394048"
"SL2.50ch11:13383738-13384910","8152","13383738","13384910","1172","1336.01441019","0.877236047054"
"SL2.50ch11:13383747-13385922","8754","13383747","13385922","2175","1336.01441019","1.62797645251"
"SL2.50ch11:13386594-13388325","20200","13386594","13388325","1731","1336.01441019","1.29564470772"
"SL2.50ch11:13386665-13388384","20200","13386665","13388384","1719","1336.01441019","1.28666276867"
"SL2.50ch11:13390197-13392203","31640","13390197","13392203","2006","1336.01441019","1.50148081091"
"SL2.50ch11:13390252-13392190","31344","13390252","13392190","1938","1336.01441019","1.45058315631"
"SL2.50ch11:13394721-13400012","56794","13394721","13400012","5291","1336.01441019","3.96028662539"
"SL2.50ch11:13394732-13399929","56788","13394732","13399929","5197","1336.01441019","3.88992810285"
"SL2.50ch11:13401106-13402132","2310","13401106","13402132","1026","1336.01441019","0.767955788632"
"SL2.50ch11:13401324-13402133","2277","13401324","13402133","809","1336.01441019","0.605532390842"
"SL2.50ch11:13495308-13495639","230","13495308","13495639","331","1336.01441019","0.24775181875"
"SL2.50ch11:13967680-13968061","49","13967680","13968061","381","1336.01441019","0.285176564785"
"SL2.50ch11:14383538-14383942","679","14383538","14383942","404","1336.01441019","0.302391947961"
"SL2.50ch11:14383567-14383948","679","14383567","14383948","381","1336.01441019","0.285176564785"
"SL2.50ch11:16103009-16104472","2663","16103009","16104472","1463","1336.01441019","1.09504806898"
"SL2.50ch11:16103077-16104555","2673","16103077","16104555","1478","1336.01441019","1.10627549279"
"SL2.50ch11:16828350-16828836","153","16828350","16828836","486","1336.01441019","0.363768531457"
"SL2.50ch11:17210281-17210848","2753","17210281","17210848","567","1336.01441019","0.424396620034"
"SL2.50ch11:17210342-17210853","2751","17210342","17210853","511","1336.01441019","0.382480904475"
"SL2.50ch11:17769163-17769784","7419","17769163","17769784","621","1336.01441019","0.464815345751"
"SL2.50ch11:17769250-17769808","7414","17769250","17769808","558","1336.01441019","0.417660165747"
"SL2.50ch11:17840381-17840899","105","17840381","17840899","518","1336.01441019","0.38772036892"
"SL2.50ch11:17851102-17851547","648","17851102","17851547","445","1336.01441019","0.333080239709"
"SL2.50ch11:17872804-17873937","3753","17872804","17873937","1133","1336.01441019","0.848044745147"
"SL2.50ch11:17887367-17887748","136","17887367","17887748","381","1336.01441019","0.285176564785"
"SL2.50ch11:17912310-17912804","153","17912310","17912804","494","1336.01441019","0.369756490823"
"SL2.50ch11:17948294-17948718","252","17948294","17948718","424","1336.01441019","0.317361846374"
"SL2.50ch11:17952839-17953362","193","17952839","17953362","523","1336.01441019","0.391462843523"
"SL2.50ch11:17953562-17954874","570","17953562","17954874","1312","1336.01441019","0.982025335951"
"SL2.50ch11:17956504-17957248","238","17956504","17957248","744","1336.01441019","0.556880220997"
"SL2.50ch11:17984426-17985006","186","17984426","17985006","580","1336.01441019","0.434127054003"
"SL2.50ch11:17987923-17989566","550","17987923","17989566","1643","1336.01441019","1.2297771547"
"SL2.50ch11:17990667-17991355","254","17990667","17991355","688","1336.01441019","0.514964505438"
"SL2.50ch11:17991856-17992755","295","17991856","17992755","899","1336.01441019","0.672896933704"
"SL2.50ch11:17998476-18002583","1675","17998476","18002583","4107","1336.01441019","3.07406863929"
"SL2.50ch11:18006145-18006622","240","18006145","18006622","477","1336.01441019","0.357032077171"
"SL2.50ch11:18015335-18019259","1342","18015335","18019259","3924","1336.01441019","2.9370940688"
"SL2.50ch11:18020893-18026619","2315","18020893","18026619","5726","1336.01441019","4.2858819159"
"SL2.50ch11:18031880-18033730","775","18031880","18033730","1850","1336.01441019","1.38471560328"
"SL2.50ch11:18034215-18034546","120","18034215","18034546","331","1336.01441019","0.24775181875"
"SL2.50ch11:18035075-18037182","1000","18035075","18037182","2107","1336.01441019","1.5770787979"
"SL2.50ch11:18573852-18574332","170","18573852","18574332","480","1336.01441019","0.359277561933"
"SL2.50ch11:18614111-18614770","115","18614111","18614770","659","1336.01441019","0.493258152738"
"SL2.50ch11:18618766-18619147","87","18618766","18619147","381","1336.01441019","0.285176564785"
"SL2.50ch11:18627266-18627879","343","18627266","18627879","613","1336.01441019","0.458827386386"
"SL2.50ch11:18645294-18645625","425","18645294","18645625","331","1336.01441019","0.24775181875"
"SL2.50ch11:18669146-18669564","248","18669146","18669564","418","1336.01441019","0.31287087685"
"SL2.50ch11:18669153-18669534","241","18669153","18669534","381","1336.01441019","0.285176564785"
"SL2.50ch11:18682069-18682473","210","18682069","18682473","404","1336.01441019","0.302391947961"
"SL2.50ch11:18682100-18682482","210","18682100","18682482","382","1336.01441019","0.285925059705"
"SL2.50ch11:18737518-18738246","880","18737518","18738246","728","1336.01441019","0.544904302266"
"SL2.50ch11:19130493-19130874","95","19130493","19130874","381","1336.01441019","0.285176564785"
"SL2.50ch11:19331016-19331347","60","19331016","19331347","331","1336.01441019","0.24775181875"
"SL2.50ch11:2007375-2007851","1315","2007375","2007851","476","1336.01441019","0.356283582251"
"SL2.50ch11:2007377-2007881","1316","2007377","2007881","504","1336.01441019","0.37724144003"
"SL2.50ch11:20225376-20225757","133","20225376","20225757","381","1336.01441019","0.285176564785"
"SL2.50ch11:20415610-20416661","993","20415610","20416661","1051","1336.01441019","0.78666816165"
"SL2.50ch11:20415801-20416652","959","20415801","20416652","851","1336.01441019","0.636969177511"
"SL2.50ch11:20419008-20420298","1716","20419008","20420298","1290","1336.01441019","0.965558447696"
"SL2.50ch11:20419096-20420352","1701","20419096","20420352","1256","1336.01441019","0.940109620392"
"SL2.50ch11:20421066-20423091","6229","20421066","20423091","2025","1336.01441019","1.51570221441"
"SL2.50ch11:20421606-20423006","6039","20421606","20423006","1400","1336.01441019","1.04789288897"
"SL2.50ch11:20424390-20425175","948","20424390","20425175","785","1336.01441019","0.587568512745"
"SL2.50ch11:20424401-20425118","945","20424401","20425118","717","1336.01441019","0.536670858138"
"SL2.50ch11:20800179-20801675","302","20800179","20801675","1496","1336.01441019","1.11974840136"
"SL2.50ch11:20846608-20846939","63","20846608","20846939","331","1336.01441019","0.24775181875"
"SL2.50ch11:20849550-20849864","68","20849550","20849864","314","1336.01441019","0.235027405098"
"SL2.50ch11:21922467-21923181","890","21922467","21923181","714","1336.01441019","0.534425373376"
"SL2.50ch11:21922576-21923209","878","21922576","21923209","633","1336.01441019","0.4737972848"
"SL2.50ch11:22290552-22290933","34","22290552","22290933","381","1336.01441019","0.285176564785"
"SL2.50ch11:23447790-23448368","304","23447790","23448368","578","1336.01441019","0.432630064161"
"SL2.50ch11:23447797-23448375","303","23447797","23448375","578","1336.01441019","0.432630064161"
"SL2.50ch11:23452090-23452660","294","23452090","23452660","570","1336.01441019","0.426642104796"
"SL2.50ch11:23452184-23452620","278","23452184","23452620","436","1336.01441019","0.326343785423"
"SL2.50ch11:23453096-23454251","468","23453096","23454251","1155","1336.01441019","0.864511633402"
"SL2.50ch11:23453138-23454118","444","23453138","23454118","980","1336.01441019","0.733525022281"
"SL2.50ch11:23915533-23916385","162","23915533","23916385","852","1336.01441019","0.637717672432"
"SL2.50ch11:24012808-24014097","345","24012808","24014097","1289","1336.01441019","0.964809952775"
"SL2.50ch11:25050931-25051882","224","25050931","25051882","951","1336.01441019","0.71181866958"
"SL2.50ch11:25053151-25053482","86","25053151","25053482","331","1336.01441019","0.24775181875"
"SL2.50ch11:26225813-26226217","70","26225813","26226217","404","1336.01441019","0.302391947961"
"SL2.50ch11:27896404-27896867","91","27896404","27896867","463","1336.01441019","0.346553148282"
"SL2.50ch11:28356052-28357167","175","28356052","28357167","1115","1336.01441019","0.834571836574"
"SL2.50ch11:28357833-28360601","596","28357833","28360601","2768","1336.01441019","2.07183394048"
"SL2.50ch11:28756969-28757350","65","28756969","28757350","381","1336.01441019","0.285176564785"
"SL2.50ch11:29290879-29291260","112","29290879","29291260","381","1336.01441019","0.285176564785"
"SL2.50ch11:30180460-30180882","186","30180460","30180882","422","1336.01441019","0.315864856533"
"SL2.50ch11:30597977-30599970","2306","30597977","30599970","1993","1336.01441019","1.49175037694"
"SL2.50ch11:30608750-30609194","283","30608750","30609194","444","1336.01441019","0.332331744788"
"SL2.50ch11:30608770-30609174","276","30608770","30609174","404","1336.01441019","0.302391947961"
"SL2.50ch11:30742579-30743572","289","30742579","30743572","993","1336.01441019","0.74325545625"
"SL2.50ch11:30742605-30743633","295","30742605","30743633","1028","1336.01441019","0.769452778474"
"SL2.50ch11:31298306-31298848","3091","31298306","31298848","542","1336.01441019","0.405684247016"
"SL2.50ch11:31585982-31587719","7903","31585982","31587719","1737","1336.01441019","1.30013567725"
"SL2.50ch11:31586061-31587703","7898","31586061","31587703","1642","1336.01441019","1.22902865978"
"SL2.50ch11:32406653-32407261","402","32406653","32407261","608","1336.01441019","0.455084911782"
"SL2.50ch11:32409690-32410071","541","32409690","32410071","381","1336.01441019","0.285176564785"
"SL2.50ch11:32422768-32423161","206","32422768","32423161","393","1336.01441019","0.294158503833"
"SL2.50ch11:32424044-32426753","16630","32424044","32426753","2709","1336.01441019","2.02767274016"
"SL2.50ch11:32424052-32426791","16632","32424052","32426791","2739","1336.01441019","2.05012758778"
"SL2.50ch11:33038646-33039127","257","33038646","33039127","481","1336.01441019","0.360026056854"
"SL2.50ch11:33038691-33039168","253","33038691","33039168","477","1336.01441019","0.357032077171"
"SL2.50ch11:33838579-33838960","47","33838579","33838960","381","1336.01441019","0.285176564785"
"SL2.50ch11:35150940-35151378","74","35150940","35151378","438","1336.01441019","0.327840775264"
"SL2.50ch11:35906758-35907139","60","35906758","35907139","381","1336.01441019","0.285176564785"
"SL2.50ch11:37407268-37407599","43","37407268","37407599","331","1336.01441019","0.24775181875"
"SL2.50ch11:38194546-38196205","787","38194546","38196205","1659","1336.01441019","1.24175307343"
"SL2.50ch11:38194617-38196159","776","38194617","38196159","1542","1336.01441019","1.15417916771"
"SL2.50ch11:38960956-38961687","169","38960956","38961687","731","1336.01441019","0.547149787028"
"SL2.50ch11:38976843-38977174","60","38976843","38977174","331","1336.01441019","0.24775181875"
"SL2.50ch11:39377269-39377690","335","39377269","39377690","421","1336.01441019","0.315116361612"
"SL2.50ch11:40159204-40159535","36","40159204","40159535","331","1336.01441019","0.24775181875"
"SL2.50ch11:40317208-40320411","17402","40317208","40320411","3203","1336.01441019","2.39742923098"
"SL2.50ch11:40317209-40320529","17411","40317209","40320529","3320","1336.01441019","2.48500313671"
"SL2.50ch11:41197754-41198085","51","41197754","41198085","331","1336.01441019","0.24775181875"
"SL2.50ch11:41847128-41847661","108","41847128","41847661","533","1336.01441019","0.39894779273"
"SL2.50ch11:42918211-42918845","850","42918211","42918845","634","1336.01441019","0.47454577972"
"SL2.50ch11:42918269-42918859","852","42918269","42918859","590","1336.01441019","0.44161200321"
"SL2.50ch11:43122285-43122616","168","43122285","43122616","331","1336.01441019","0.24775181875"
"SL2.50ch11:43436495-43436876","141","43436495","43436876","381","1336.01441019","0.285176564785"
"SL2.50ch11:45233504-45239706","39630","45233504","45239706","6202","1336.01441019","4.64216549815"
"SL2.50ch11:45233663-45239720","39510","45233663","45239720","6057","1336.01441019","4.53363373465"
"SL2.50ch11:45246294-45248276","10946","45246294","45248276","1982","1336.01441019","1.48351693282"
"SL2.50ch11:45246295-45248318","10946","45246295","45248318","2023","1336.01441019","1.51420522456"
"SL2.50ch11:45250517-45251257","6960","45250517","45251257","740","1336.01441019","0.553886241314"
"SL2.50ch11:45250523-45251236","6956","45250523","45251236","713","1336.01441019","0.533676878455"
"SL2.50ch11:45252815-45254411","8783","45252815","45254411","1596","1336.01441019","1.19459789343"
"SL2.50ch11:45252840-45254378","8673","45252840","45254378","1538","1336.01441019","1.15118518803"
"SL2.50ch11:45255655-45260484","27834","45255655","45260484","4829","1336.01441019","3.61448197203"
"SL2.50ch11:45255683-45260439","27834","45255683","45260439","4756","1336.01441019","3.55984184282"
"SL2.50ch11:45336960-45338883","11708","45336960","45338883","1923","1336.01441019","1.4393557325"
"SL2.50ch11:45337036-45338896","11632","45337036","45338896","1860","1336.01441019","1.39220055249"
"SL2.50ch11:45339571-45342127","13522","45339571","45342127","2556","1336.01441019","1.91315301729"
"SL2.50ch11:45339892-45342146","13407","45339892","45342146","2254","1336.01441019","1.68710755125"
"SL2.50ch11:45343888-45345757","11849","45343888","45345757","1869","1336.01441019","1.39893700678"
"SL2.50ch11:45343932-45345750","11683","45343932","45345750","1818","1336.01441019","1.36076376582"
"SL2.50ch11:45350101-45351451","7370","45350101","45351451","1350","1336.01441019","1.01046814294"
"SL2.50ch11:45350111-45351438","7370","45350111","45351438","1327","1336.01441019","0.993252759761"
"SL2.50ch11:45354471-45355948","8743","45354471","45355948","1477","1336.01441019","1.10552699787"
"SL2.50ch11:45354492-45356028","8743","45354492","45356028","1536","1336.01441019","1.14968819819"
"SL2.50ch11:45357921-45358671","2993","45357921","45358671","750","1336.01441019","0.561371190521"
"SL2.50ch11:45357991-45358650","2979","45357991","45358650","659","1336.01441019","0.493258152738"
"SL2.50ch11:45363873-45368149","34059","45363873","45368149","4276","1336.01441019","3.20056428089"
"SL2.50ch11:45363883-45368069","34056","45363883","45368069","4186","1336.01441019","3.13319973803"
"SL2.50ch11:45371016-45372698","5039","45371016","45372698","1682","1336.01441019","1.25896845661"
"SL2.50ch11:45371030-45372657","5039","45371030","45372657","1627","1336.01441019","1.21780123597"
"SL2.50ch11:45374308-45377789","17252","45374308","45377789","3481","1336.01441019","2.60551081894"
"SL2.50ch11:45374348-45377768","17239","45374348","45377768","3420","1336.01441019","2.55985262877"
"SL2.50ch11:45386705-45388208","12093","45386705","45388208","1503","1336.01441019","1.1249878658"
"SL2.50ch11:45386734-45388276","11991","45386734","45388276","1542","1336.01441019","1.15417916771"
"SL2.50ch11:45390084-45391167","6672","45390084","45391167","1083","1336.01441019","0.810619999112"
"SL2.50ch11:45390126-45391165","6635","45390126","45391165","1039","1336.01441019","0.777686222601"
"SL2.50ch11:45392558-45394301","7468","45392558","45394301","1743","1336.01441019","1.30462664677"
"SL2.50ch11:45392787-45394263","7250","45392787","45394263","1476","1336.01441019","1.10477850294"
"SL2.50ch11:45396272-45396781","524","45396272","45396781","509","1336.01441019","0.380983914633"
"SL2.50ch11:45397264-45397956","3488","45397264","45397956","692","1336.01441019","0.517958485121"
"SL2.50ch11:45400822-45401203","425","45400822","45401203","381","1336.01441019","0.285176564785"
"SL2.50ch11:45403852-45404567","909","45403852","45404567","715","1336.01441019","0.535173868296"
"SL2.50ch11:45403892-45404869","950","45403892","45404869","977","1336.01441019","0.731279537518"
"SL2.50ch11:45405893-45406671","497","45405893","45406671","778","1336.01441019","0.5823290483"
"SL2.50ch11:45406140-45406635","439","45406140","45406635","495","1336.01441019","0.370504985744"
"SL2.50ch11:45411459-45413075","7705","45411459","45413075","1616","1336.01441019","1.20956779184"
"SL2.50ch11:45411475-45413034","7705","45411475","45413034","1559","1336.01441019","1.16690358136"
"SL2.50ch11:45417282-45418372","3221","45417282","45418372","1090","1336.01441019","0.815859463557"
"SL2.50ch11:45417295-45418458","3213","45417295","45418458","1163","1336.01441019","0.870499592768"
"SL2.50ch11:45422630-45423708","7008","45422630","45423708","1078","1336.01441019","0.806877524509"
"SL2.50ch11:45422641-45423626","6951","45422641","45423626","985","1336.01441019","0.737267496884"
"SL2.50ch11:45440153-45441044","2541","45440153","45441044","891","1336.01441019","0.666908974339"
"SL2.50ch11:45440170-45440838","2508","45440170","45440838","668","1336.01441019","0.499994607024"
"SL2.50ch11:45444371-45444962","1746","45444371","45444962","591","1336.01441019","0.44236049813"
"SL2.50ch11:45444392-45444894","1746","45444392","45444894","502","1336.01441019","0.375744450189"
"SL2.50ch11:45446480-45449019","12063","45446480","45449019","2539","1336.01441019","1.90042860364"
"SL2.50ch11:45446502-45448937","12054","45446502","45448937","2435","1336.01441019","1.82258513189"
"SL2.50ch11:45450066-45451953","5987","45450066","45451953","1887","1336.01441019","1.41240991535"
"SL2.50ch11:45450198-45451955","5970","45450198","45451955","1757","1336.01441019","1.31510557566"
"SL2.50ch11:45459831-45460436","4877","45459831","45460436","605","1336.01441019","0.45283942702"
"SL2.50ch11:45459847-45460418","4877","45459847","45460418","571","1336.01441019","0.427390599717"
"SL2.50ch11:45461232-45462107","2896","45461232","45462107","875","1336.01441019","0.654933055608"
"SL2.50ch11:45461254-45462039","2896","45461254","45462039","785","1336.01441019","0.587568512745"
"SL2.50ch11:45463523-45465560","8072","45463523","45465560","2037","1336.01441019","1.52468415345"
"SL2.50ch11:45463545-45465535","8069","45463545","45465535","1990","1336.01441019","1.48950489218"
"SL2.50ch11:45475487-45476009","1123","45475487","45476009","522","1336.01441019","0.390714348602"
"SL2.50ch11:45475498-45475974","1121","45475498","45475974","476","1336.01441019","0.356283582251"
"SL2.50ch11:45992516-45992847","50","45992516","45992847","331","1336.01441019","0.24775181875"
"SL2.50ch11:4671798-4672206","80","4671798","4672206","408","1336.01441019","0.305385927643"
"SL2.50ch11:4671846-4672227","83","4671846","4672227","381","1336.01441019","0.285176564785"
"SL2.50ch11:47166014-47166395","79","47166014","47166395","381","1336.01441019","0.285176564785"
"SL2.50ch11:48691879-48692369","288","48691879","48692369","490","1336.01441019","0.36676251114"
"SL2.50ch11:48691975-48692306","277","48691975","48692306","331","1336.01441019","0.24775181875"
"SL2.50ch11:48717907-48719584","9689","48717907","48719584","1677","1336.01441019","1.255225982"
"SL2.50ch11:48717921-48719673","9695","48717921","48719673","1752","1336.01441019","1.31136310106"
"SL2.50ch11:48869744-48870859","14259","48869744","48870859","1115","1336.01441019","0.834571836574"
"SL2.50ch11:48869746-48871201","14319","48869746","48871201","1455","1336.01441019","1.08906010961"
"SL2.50ch11:49617738-49625597","36536","49617738","49625597","7859","1336.01441019","5.88242158174"
"SL2.50ch11:49617752-49620791","13149","49617752","49620791","3039","1336.01441019","2.27467606399"
"SL2.50ch11:49621163-49625553","23356","49621163","49625553","4390","1336.01441019","3.28589270185"
"SL2.50ch11:49629289-49636156","24244","49629289","49636156","6867","1336.01441019","5.13991462041"
"SL2.50ch11:49629359-49636101","24160","49629359","49636101","6742","1336.01441019","5.04635275532"
"SL2.50ch11:49638631-49640729","5014","49638631","49640729","2098","1336.01441019","1.57034234362"
"SL2.50ch11:49638814-49640579","4986","49638814","49640579","1765","1336.01441019","1.32109353503"
"SL2.50ch11:49641085-49644012","4062","49641085","49644012","2927","1336.01441019","2.19084463287"
"SL2.50ch11:49641219-49643986","4048","49641219","49643986","2767","1336.01441019","2.07108544556"
"SL2.50ch11:49648062-49649559","7258","49648062","49649559","1497","1336.01441019","1.12049689628"
"SL2.50ch11:49648129-49649470","7240","49648129","49649470","1341","1336.01441019","1.00373168865"
"SL2.50ch11:49740346-49741494","258","49740346","49741494","1148","1336.01441019","0.859272168957"
"SL2.50ch11:49740464-49741355","219","49740464","49741355","891","1336.01441019","0.666908974339"
"SL2.50ch11:49779907-49780311","52","49779907","49780311","404","1336.01441019","0.302391947961"
"SL2.50ch11:50255274-50255781","191","50255274","50255781","507","1336.01441019","0.379486924792"
"SL2.50ch11:50269947-50270376","269","50269947","50270376","429","1336.01441019","0.321104320978"
"SL2.50ch11:50794411-50795090","785","50794411","50795090","679","1336.01441019","0.508228051152"
"SL2.50ch11:50794589-50795065","772","50794589","50795065","476","1336.01441019","0.356283582251"
"SL2.50ch11:51012856-51013341","98","51012856","51013341","485","1336.01441019","0.363020036537"
"SL2.50ch11:51640933-51641462","163","51640933","51641462","529","1336.01441019","0.395953813047"
"SL2.50ch11:53074895-53075361","151","53074895","53075361","466","1336.01441019","0.348798633044"
"SL2.50ch11:53074921-53075337","150","53074921","53075337","416","1336.01441019","0.311373887009"
"SL2.50ch11:53587385-53587841","168","53587385","53587841","456","1336.01441019","0.341313683837"
"SL2.50ch11:53587433-53587916","169","53587433","53587916","483","1336.01441019","0.361523046695"
"SL2.50ch11:55434542-55435796","500","55434542","55435796","1254","1336.01441019","0.938612630551"
"SL2.50ch11:55434573-55435648","476","55434573","55435648","1075","1336.01441019","0.804632039746"
"SL2.50ch11:55436855-55437258","76","55436855","55437258","403","1336.01441019","0.30164345304"
"SL2.50ch11:5768913-5769332","530","5768913","5769332","419","1336.01441019","0.313619371771"
"SL2.50ch11:5768962-5769343","528","5768962","5769343","381","1336.01441019","0.285176564785"
"SL2.50ch11:7156237-7156814","308","7156237","7156814","577","1336.01441019","0.431881569241"
"SL2.50ch11:7156314-7156732","298","7156314","7156732","418","1336.01441019","0.31287087685"
"SL2.50ch11:7159640-7160120","405","7159640","7160120","480","1336.01441019","0.359277561933"
"SL2.50ch11:7159705-7160160","403","7159705","7160160","455","1336.01441019","0.340565188916"
"SL2.50ch11:7471982-7472313","69","7471982","7472313","331","1336.01441019","0.24775181875"
"SL2.50ch11:8470402-8472553","1010","8470402","8472553","2151","1336.01441019","1.61001257441"
"SL2.50ch11:8470520-8472326","975","8470520","8472326","1806","1336.01441019","1.35178182677"
"SL2.50ch11:8485860-8486264","73","8485860","8486264","404","1336.01441019","0.302391947961"
"SL2.50ch11:8510015-8510759","251","8510015","8510759","744","1336.01441019","0.556880220997"
"SL2.50ch11:8510017-8510718","248","8510017","8510718","701","1336.01441019","0.524694939407"
"SL2.50ch11:8517017-8517422","110","8517017","8517422","405","1336.01441019","0.303140442881"
"SL2.50ch11:9479271-9479955","131","9479271","9479955","684","1336.01441019","0.511970525755"
"SL2.50ch11:9484236-9484982","208","9484236","9484982","746","1336.01441019","0.558377210838"
"SL2.50ch11:9484287-9485000","202","9484287","9485000","713","1336.01441019","0.533676878455"
"SL2.50ch12:11125605-11126177","822","11125605","11126177","572","1336.01441019","0.428139094637"
"SL2.50ch12:12332998-12333329","46","12332998","12333329","331","1336.01441019","0.24775181875"
"SL2.50ch12:1281270-1281935","7636","1281270","1281935","665","1336.01441019","0.497749122262"
"SL2.50ch12:1281330-1282010","7635","1281330","1282010","680","1336.01441019","0.508976546072"
"SL2.50ch12:13250700-13251294","764","13250700","13251294","594","1336.01441019","0.444605982892"
"SL2.50ch12:13250748-13251224","753","13250748","13251224","476","1336.01441019","0.356283582251"
"SL2.50ch12:14018476-14018807","60","14018476","14018807","331","1336.01441019","0.24775181875"
"SL2.50ch12:14493392-14493899","70","14493392","14493899","507","1336.01441019","0.379486924792"
"SL2.50ch12:14493555-14493936","60","14493555","14493936","381","1336.01441019","0.285176564785"
"SL2.50ch12:15148901-15149232","108","15148901","15149232","331","1336.01441019","0.24775181875"
"SL2.50ch12:15634492-15634969","274","15634492","15634969","477","1336.01441019","0.357032077171"
"SL2.50ch12:17330809-17331703","261","17330809","17331703","894","1336.01441019","0.669154459101"
"SL2.50ch12:17338044-17338589","204","17338044","17338589","545","1336.01441019","0.407929731778"
"SL2.50ch12:17343076-17343923","286","17343076","17343923","847","1336.01441019","0.633975197828"
"SL2.50ch12:17369783-17372098","743","17369783","17372098","2315","1336.01441019","1.73276574141"
"SL2.50ch12:17374178-17375468","345","17374178","17375468","1290","1336.01441019","0.965558447696"
"SL2.50ch12:17452322-17452808","114","17452322","17452808","486","1336.01441019","0.363768531457"
"SL2.50ch12:17453646-17454510","236","17453646","17454510","864","1336.01441019","0.64669961148"
"SL2.50ch12:17458286-17458617","139","17458286","17458617","331","1336.01441019","0.24775181875"
"SL2.50ch12:17462767-17463586","556","17462767","17463586","819","1336.01441019","0.613017340049"
"SL2.50ch12:17462792-17463626","553","17462792","17463626","834","1336.01441019","0.624244763859"
"SL2.50ch12:17468752-17470197","1581","17468752","17470197","1445","1336.01441019","1.0815751604"
"SL2.50ch12:17468971-17470210","1552","17468971","17470210","1239","1336.01441019","0.92738520674"
"SL2.50ch12:17570238-17572190","595","17570238","17572190","1952","1336.01441019","1.4610620852"
"SL2.50ch12:17582576-17583864","706","17582576","17583864","1288","1336.01441019","0.964061457854"
"SL2.50ch12:17582629-17583877","706","17582629","17583877","1248","1336.01441019","0.934121661027"
"SL2.50ch12:17584517-17586675","1370","17584517","17586675","2158","1336.01441019","1.61525203886"
"SL2.50ch12:17584536-17586614","1367","17584536","17586614","2078","1336.01441019","1.5553724452"
"SL2.50ch12:19350921-19351325","77","19350921","19351325","404","1336.01441019","0.302391947961"
"SL2.50ch12:19389610-19389991","145","19389610","19389991","381","1336.01441019","0.285176564785"
"SL2.50ch12:21139202-21139659","144","21139202","21139659","457","1336.01441019","0.342062178757"
"SL2.50ch12:21403404-21403840","69","21403404","21403840","436","1336.01441019","0.326343785423"
"SL2.50ch12:22366142-22366649","260","22366142","22366649","507","1336.01441019","0.379486924792"
"SL2.50ch12:22366240-22366645","255","22366240","22366645","405","1336.01441019","0.303140442881"
"SL2.50ch12:22466090-22469538","1911","22466090","22469538","3448","1336.01441019","2.58081048655"
"SL2.50ch12:22467023-22469458","1742","22467023","22469458","2435","1336.01441019","1.82258513189"
"SL2.50ch12:22471379-22472200","470","22471379","22472200","821","1336.01441019","0.61451432989"
"SL2.50ch12:22471407-22472087","457","22471407","22472087","680","1336.01441019","0.508976546072"
"SL2.50ch12:22476825-22478142","1007","22476825","22478142","1317","1336.01441019","0.985767810555"
"SL2.50ch12:22476935-22478041","984","22476935","22478041","1106","1336.01441019","0.827835382288"
"SL2.50ch12:22571612-22572821","870","22571612","22572821","1209","1336.01441019","0.90493035912"
"SL2.50ch12:22571717-22572799","858","22571717","22572799","1082","1336.01441019","0.809871504191"
"SL2.50ch12:22575813-22577176","578","22575813","22577176","1363","1336.01441019","1.02019857691"
"SL2.50ch12:22587749-22588457","421","22587749","22588457","708","1336.01441019","0.529934403852"
"SL2.50ch12:22590590-22591176","150","22590590","22591176","586","1336.01441019","0.438618023527"
"SL2.50ch12:22599374-22600385","505","22599374","22600385","1011","1336.01441019","0.756728364822"
"SL2.50ch12:22610566-22610979","147","22610566","22610979","413","1336.01441019","0.309128402247"
"SL2.50ch12:22619644-22621023","1037","22619644","22621023","1379","1336.01441019","1.03217449564"
"SL2.50ch12:22619701-22621095","1037","22619701","22621095","1394","1336.01441019","1.04340191945"
"SL2.50ch12:22622908-22624182","931","22622908","22624182","1274","1336.01441019","0.953582528965"
"SL2.50ch12:22622918-22624219","931","22622918","22624219","1301","1336.01441019","0.973791891823"
"SL2.50ch12:22626855-22628226","511","22626855","22628226","1371","1336.01441019","1.02618653627"
"SL2.50ch12:22636260-22637117","468","22636260","22637117","857","1336.01441019","0.641460147035"
"SL2.50ch12:22636265-22637122","468","22636265","22637122","857","1336.01441019","0.641460147035"
"SL2.50ch12:22638809-22641705","1774","22638809","22641705","2896","1336.01441019","2.16764129033"
"SL2.50ch12:22642990-22644299","797","22642990","22644299","1309","1336.01441019","0.979779851189"
"SL2.50ch12:22643043-22644316","792","22643043","22644316","1273","1336.01441019","0.952834034044"
"SL2.50ch12:22647684-22649182","768","22647684","22649182","1498","1336.01441019","1.1212453912"
"SL2.50ch12:22647724-22649179","760","22647724","22649179","1455","1336.01441019","1.08906010961"
"SL2.50ch12:22661770-22664397","950","22661770","22664397","2627","1336.01441019","1.96629615666"
"SL2.50ch12:22689890-22690369","147","22689890","22690369","479","1336.01441019","0.358529067013"
"SL2.50ch12:22698690-22699413","284","22698690","22699413","723","1336.01441019","0.541161827662"
"SL2.50ch12:22703614-22704318","162","22703614","22704318","704","1336.01441019","0.526940424169"
"SL2.50ch12:22765154-22770114","1775","22765154","22770114","4960","1336.01441019","3.71253480664"
"SL2.50ch12:22770869-22773743","838","22770869","22773743","2874","1336.01441019","2.15117440208"
"SL2.50ch12:26321661-26322042","124","26321661","26322042","381","1336.01441019","0.285176564785"
"SL2.50ch12:26989483-26989864","69","26989483","26989864","381","1336.01441019","0.285176564785"
"SL2.50ch12:27481101-27481482","76","27481101","27481482","381","1336.01441019","0.285176564785"
"SL2.50ch12:29080778-29087823","2112","29080778","29087823","7045","1336.01441019","5.27314671629"
"SL2.50ch12:29094883-29096025","305","29094883","29096025","1142","1336.01441019","0.854781199433"
"SL2.50ch12:29096668-29097262","246","29096668","29097262","594","1336.01441019","0.444605982892"
"SL2.50ch12:29097977-29099133","343","29097977","29099133","1156","1336.01441019","0.865260128323"
"SL2.50ch12:29986594-29986976","186","29986594","29986976","382","1336.01441019","0.285925059705"
"SL2.50ch12:30017686-30018067","1509","30017686","30018067","381","1336.01441019","0.285176564785"
"SL2.50ch12:3209934-3210390","336","3209934","3210390","456","1336.01441019","0.341313683837"
"SL2.50ch12:3209999-3210380","329","3209999","3210380","381","1336.01441019","0.285176564785"
"SL2.50ch12:33269561-33270105","81","33269561","33270105","544","1336.01441019","0.407181236858"
"SL2.50ch12:33815397-33815892","305","33815397","33815892","495","1336.01441019","0.370504985744"
"SL2.50ch12:33815427-33815831","300","33815427","33815831","404","1336.01441019","0.302391947961"
"SL2.50ch12:33827505-33828188","323","33827505","33828188","683","1336.01441019","0.511222030834"
"SL2.50ch12:33829156-33829748","271","33829156","33829748","592","1336.01441019","0.443108993051"
"SL2.50ch12:33829226-33829607","231","33829226","33829607","381","1336.01441019","0.285176564785"
"SL2.50ch12:34295106-34305960","4515","34295106","34305960","10854","1336.01441019","8.12416386922"
"SL2.50ch12:34295125-34305784","4489","34295125","34305784","10659","1336.01441019","7.97820735968"
"SL2.50ch12:34306321-34317329","4166","34306321","34317329","11008","1336.01441019","8.239432087"
"SL2.50ch12:34307944-34317175","3680","34307944","34317175","9231","1336.01441019","6.90935661293"
"SL2.50ch12:34329060-34333200","1238","34329060","34333200","4140","1336.01441019","3.09876897167"
"SL2.50ch12:34329861-34331697","711","34329861","34331697","1836","1336.01441019","1.37423667439"
"SL2.50ch12:34333645-34333959","72","34333645","34333959","314","1336.01441019","0.235027405098"
"SL2.50ch12:34808288-34808669","365","34808288","34808669","381","1336.01441019","0.285176564785"
"SL2.50ch12:36108054-36136218","8150","36108054","36136218","28164","1336.01441019","21.0806109464"
"SL2.50ch12:36159277-36160089","193","36159277","36160089","812","1336.01441019","0.607777875604"
"SL2.50ch12:36180044-36180928","192","36180044","36180928","884","1336.01441019","0.661669509894"
"SL2.50ch12:36183812-36184673","108","36183812","36184673","861","1336.01441019","0.644454126718"
"SL2.50ch12:36228443-36228925","59","36228443","36228925","482","1336.01441019","0.360774551775"
"SL2.50ch12:36230006-36230387","70","36230006","36230387","381","1336.01441019","0.285176564785"
"SL2.50ch12:36243987-36244318","102","36243987","36244318","331","1336.01441019","0.24775181875"
"SL2.50ch12:36245646-36246132","107","36245646","36246132","486","1336.01441019","0.363768531457"
"SL2.50ch12:36251793-36252444","148","36251793","36252444","651","1336.01441019","0.487270193372"
"SL2.50ch12:37679933-37680505","925","37679933","37680505","572","1336.01441019","0.428139094637"
"SL2.50ch12:37679973-37680475","923","37679973","37680475","502","1336.01441019","0.375744450189"
"SL2.50ch12:38096630-38097066","94","38096630","38097066","436","1336.01441019","0.326343785423"
"SL2.50ch12:38096955-38098209","200","38096955","38098209","1254","1336.01441019","0.938612630551"
"SL2.50ch12:39449937-39450547","159","39449937","39450547","610","1336.01441019","0.456581901624"
"SL2.50ch12:39482866-39483197","121","39482866","39483197","331","1336.01441019","0.24775181875"
"SL2.50ch12:39785085-39785416","45","39785085","39785416","331","1336.01441019","0.24775181875"
"SL2.50ch12:41429927-41430258","84","41429927","41430258","331","1336.01441019","0.24775181875"
"SL2.50ch12:42325893-42326385","125","42325893","42326385","492","1336.01441019","0.368259500982"
"SL2.50ch12:42325980-42326361","107","42325980","42326361","381","1336.01441019","0.285176564785"
"SL2.50ch12:4279791-4283658","7430","4279791","4283658","3867","1336.01441019","2.89442985833"
"SL2.50ch12:4279793-4283758","7435","4279793","4283758","3965","1336.01441019","2.96778236055"
"SL2.50ch12:4296390-4297207","204","4296390","4297207","817","1336.01441019","0.611520350207"
"SL2.50ch12:4297763-4298673","270","4297763","4298673","910","1336.01441019","0.681130377832"
"SL2.50ch12:4297827-4298566","253","4297827","4298566","739","1336.01441019","0.553137746393"
"SL2.50ch12:4299696-4301289","393","4299696","4301289","1593","1336.01441019","1.19235240867"
"SL2.50ch12:4300238-4301278","323","4300238","4301278","1040","1336.01441019","0.778434717522"
"SL2.50ch12:4302878-4303292","108","4302878","4303292","414","1336.01441019","0.309876897167"
"SL2.50ch12:4308651-4310061","357","4308651","4310061","1410","1336.01441019","1.05537783818"
"SL2.50ch12:4311839-4312170","95","4311839","4312170","331","1336.01441019","0.24775181875"
"SL2.50ch12:4313018-4313834","248","4313018","4313834","816","1336.01441019","0.610771855287"
"SL2.50ch12:4313124-4313854","232","4313124","4313854","730","1336.01441019","0.546401292107"
"SL2.50ch12:4328830-4329758","392","4328830","4329758","928","1336.01441019","0.694603286404"
"SL2.50ch12:4328911-4329804","387","4328911","4329804","893","1336.01441019","0.66840596418"
"SL2.50ch12:4332757-4333958","309","4332757","4333958","1201","1336.01441019","0.898942399754"
"SL2.50ch12:4332795-4334013","305","4332795","4334013","1218","1336.01441019","0.911666813406"
"SL2.50ch12:4335203-4337241","597","4335203","4337241","2038","1336.01441019","1.52543264838"
"SL2.50ch12:4350353-4351259","288","4350353","4351259","906","1336.01441019","0.678136398149"
"SL2.50ch12:4350370-4351149","260","4350370","4351149","779","1336.01441019","0.583077543221"
"SL2.50ch12:44659011-44659469","204","44659011","44659469","458","1336.01441019","0.342810673678"
"SL2.50ch12:4498945-4499947","173","4498945","4499947","1002","1336.01441019","0.749991910536"
"SL2.50ch12:45738173-45738504","364","45738173","45738504","331","1336.01441019","0.24775181875"
"SL2.50ch12:47013502-47013833","34","47013502","47013833","331","1336.01441019","0.24775181875"
"SL2.50ch12:47850906-47851287","72","47850906","47851287","381","1336.01441019","0.285176564785"
"SL2.50ch12:49282766-49283277","1877","49282766","49283277","511","1336.01441019","0.382480904475"
"SL2.50ch12:49282814-49283195","1865","49282814","49283195","381","1336.01441019","0.285176564785"
"SL2.50ch12:49661976-49662526","3994","49661976","49662526","550","1336.01441019","0.411672206382"
"SL2.50ch12:49662034-49662510","3990","49662034","49662510","476","1336.01441019","0.356283582251"
"SL2.50ch12:49894199-49894848","174","49894199","49894848","649","1336.01441019","0.485773203531"
"SL2.50ch12:49894315-49894836","161","49894315","49894836","521","1336.01441019","0.389965853682"
"SL2.50ch12:49897234-49897821","59","49897234","49897821","587","1336.01441019","0.439366518448"
"SL2.50ch12:50172509-50173789","627","50172509","50173789","1280","1336.01441019","0.958073498489"
"SL2.50ch12:50172600-50173673","604","50172600","50173673","1073","1336.01441019","0.803135049905"
"SL2.50ch12:5093985-5094492","404","5093985","5094492","507","1336.01441019","0.379486924792"
"SL2.50ch12:5094025-5094411","387","5094025","5094411","386","1336.01441019","0.288919039388"
"SL2.50ch12:51038493-51039010","463","51038493","51039010","517","1336.01441019","0.386971873999"
"SL2.50ch12:51040353-51041261","1740","51040353","51041261","908","1336.01441019","0.679633387991"
"SL2.50ch12:51040474-51042152","2526","51040474","51042152","1678","1336.01441019","1.25597447693"
"SL2.50ch12:51041614-51042084","758","51041614","51042084","470","1336.01441019","0.351792612726"
"SL2.50ch12:51073484-51073975","523","51073484","51073975","491","1336.01441019","0.367511006061"
"SL2.50ch12:51073513-51073990","517","51073513","51073990","477","1336.01441019","0.357032077171"
"SL2.50ch12:51538100-51538911","969","51538100","51538911","811","1336.01441019","0.607029380683"
"SL2.50ch12:51538163-51538838","946","51538163","51538838","675","1336.01441019","0.505234071469"
"SL2.50ch12:51544192-51544877","938","51544192","51544877","685","1336.01441019","0.512719020676"
"SL2.50ch12:51544211-51545010","963","51544211","51545010","799","1336.01441019","0.598047441635"
"SL2.50ch12:51597182-51597823","2888","51597182","51597823","641","1336.01441019","0.479785244165"
"SL2.50ch12:51597324-51597800","2877","51597324","51597800","476","1336.01441019","0.356283582251"
"SL2.50ch12:5192271-5192750","138","5192271","5192750","479","1336.01441019","0.358529067013"
"SL2.50ch12:54256722-54257322","348","54256722","54257322","600","1336.01441019","0.449096952417"
"SL2.50ch12:54273682-54274338","3409","54273682","54274338","656","1336.01441019","0.491012667976"
"SL2.50ch12:54273741-54274217","3381","54273741","54274217","476","1336.01441019","0.356283582251"
"SL2.50ch12:54308714-54309197","233","54308714","54309197","483","1336.01441019","0.361523046695"
"SL2.50ch12:54318649-54319616","370","54318649","54319616","967","1336.01441019","0.723794588311"
"SL2.50ch12:54319025-54319406","256","54319025","54319406","381","1336.01441019","0.285176564785"
"SL2.50ch12:54590584-54591655","150","54590584","54591655","1071","1336.01441019","0.801638060064"
"SL2.50ch12:5488467-5488892","93","5488467","5488892","425","1336.01441019","0.318110341295"
"SL2.50ch12:55097793-55098124","71","55097793","55098124","331","1336.01441019","0.24775181875"
"SL2.50ch12:55224586-55225072","280","55224586","55225072","486","1336.01441019","0.363768531457"
"SL2.50ch12:55224654-55225051","275","55224654","55225051","397","1336.01441019","0.297152483516"
"SL2.50ch12:56077983-56078387","244","56077983","56078387","404","1336.01441019","0.302391947961"
"SL2.50ch12:56078034-56078365","237","56078034","56078365","331","1336.01441019","0.24775181875"
"SL2.50ch12:56908933-56910083","8834","56908933","56910083","1150","1336.01441019","0.860769158799"
"SL2.50ch12:56909006-56910116","8833","56909006","56910116","1110","1336.01441019","0.830829361971"
"SL2.50ch12:57552013-57553141","340","57552013","57553141","1128","1336.01441019","0.844302270543"
"SL2.50ch12:57552044-57553763","480","57552044","57553763","1719","1336.01441019","1.28666276867"
"SL2.50ch12:57621736-57622289","1272","57621736","57622289","553","1336.01441019","0.413917691144"
"SL2.50ch12:57621782-57622238","1264","57621782","57622238","456","1336.01441019","0.341313683837"
"SL2.50ch12:58130508-58130889","56","58130508","58130889","381","1336.01441019","0.285176564785"
"SL2.50ch12:59006940-59008045","232","59006940","59008045","1105","1336.01441019","0.827086887367"
"SL2.50ch12:60467750-60469546","340","60467750","60469546","1796","1336.01441019","1.34429687757"
"SL2.50ch12:60502840-60503511","139","60502840","60503511","671","1336.01441019","0.502240091786"
"SL2.50ch12:60503445-60503776","110","60503445","60503776","331","1336.01441019","0.24775181875"
"SL2.50ch12:60526848-60527334","87","60526848","60527334","486","1336.01441019","0.363768531457"
"SL2.50ch12:60534671-60537576","794","60534671","60537576","2905","1336.01441019","2.17437774462"
"SL2.50ch12:60546159-60552268","1560","60546159","60552268","6109","1336.01441019","4.57255547052"
"SL2.50ch12:60556961-60564301","2739","60556961","60564301","7340","1336.01441019","5.4939527179"
"SL2.50ch12:60565795-60567385","412","60565795","60567385","1590","1336.01441019","1.1901069239"
"SL2.50ch12:60569886-60573385","1646","60569886","60573385","3499","1336.01441019","2.61898372751"
"SL2.50ch12:60586267-60590941","1289","60586267","60590941","4674","1336.01441019","3.49846525933"
"SL2.50ch12:60593366-60593801","106","60593366","60593801","435","1336.01441019","0.325595290502"
"SL2.50ch12:60595078-60596221","313","60595078","60596221","1143","1336.01441019","0.855529694354"
"SL2.50ch12:60598684-60599309","183","60598684","60599309","625","1336.01441019","0.467809325434"
"SL2.50ch12:60610231-60618151","2323","60610231","60618151","7920","1336.01441019","5.9280797719"
"SL2.50ch12:60624354-60631196","1791","60624354","60631196","6842","1336.01441019","5.12120224739"
"SL2.50ch12:60637700-60641689","819","60637700","60641689","3989","1336.01441019","2.98574623865"
"SL2.50ch12:60643055-60643768","173","60643055","60643768","713","1336.01441019","0.533676878455"
"SL2.50ch12:60649865-60650474","205","60649865","60650474","609","1336.01441019","0.455833406703"
"SL2.50ch12:60651370-60651832","113","60651370","60651832","462","1336.01441019","0.345804653361"
"SL2.50ch12:60663344-60664212","196","60663344","60664212","868","1336.01441019","0.649693591163"
"SL2.50ch12:60669966-60670728","243","60669966","60670728","762","1336.01441019","0.570353129569"
"SL2.50ch12:60692608-60693779","278","60692608","60693779","1171","1336.01441019","0.876487552133"
"SL2.50ch12:60696892-60709033","3773","60696892","60709033","12141","1336.01441019","9.08747683215"
"SL2.50ch12:60697520-60709363","3694","60697520","60709363","11843","1336.01441019","8.86442534578"
"SL2.50ch12:60709890-60717733","2928","60709890","60717733","7843","1336.01441019","5.87044566301"
"SL2.50ch12:60711458-60717601","2368","60711458","60717601","6143","1336.01441019","4.59800429783"
"SL2.50ch12:60718836-60737124","6828","60718836","60737124","18288","1336.01441019","13.6884751097"
"SL2.50ch12:60718857-60737164","6826","60718857","60737164","18307","1336.01441019","13.7026965132"
"SL2.50ch12:60921858-60922437","199","60921858","60922437","579","1336.01441019","0.433378559082"
"SL2.50ch12:60947806-60951643","7150","60947806","60951643","3837","1336.01441019","2.8719750107"
"SL2.50ch12:60947867-60949804","6621","60947867","60949804","1937","1336.01441019","1.44983466139"
"SL2.50ch12:60951150-60951596","243","60951150","60951596","446","1336.01441019","0.33382873463"
"SL2.50ch12:61002859-61005844","3190","61002859","61005844","2985","1336.01441019","2.23425733827"
"SL2.50ch12:61002927-61004820","2697","61002927","61004820","1893","1336.01441019","1.41690088487"
"SL2.50ch12:61005201-61005615","437","61005201","61005615","414","1336.01441019","0.309876897167"
"SL2.50ch12:6159373-6159853","144","6159373","6159853","480","1336.01441019","0.359277561933"
"SL2.50ch12:61617164-61618595","316","61617164","61618595","1431","1336.01441019","1.07109623151"
"SL2.50ch12:61617339-61618525","283","61617339","61618525","1186","1336.01441019","0.887714975944"
"SL2.50ch12:61625683-61626124","168","61625683","61626124","441","1336.01441019","0.330086260026"
"SL2.50ch12:61627518-61630158","698","61627518","61630158","2640","1336.01441019","1.97602659063"
"SL2.50ch12:61638041-61642381","1602","61638041","61642381","4340","1336.01441019","3.24846795581"
"SL2.50ch12:61647075-61649066","743","61647075","61649066","1991","1336.01441019","1.4902533871"
"SL2.50ch12:61649839-61653854","1701","61649839","61653854","4015","1336.01441019","3.00520710659"
"SL2.50ch12:61656910-61658152","493","61656910","61658152","1242","1336.01441019","0.929630691502"
"SL2.50ch12:6203932-6204684","215","6203932","6204684","752","1336.01441019","0.562868180362"
"SL2.50ch12:6204092-6204496","147","6204092","6204496","404","1336.01441019","0.302391947961"
"SL2.50ch12:6208307-6208825","141","6208307","6208825","518","1336.01441019","0.38772036892"
"SL2.50ch12:62260264-62260645","825","62260264","62260645","381","1336.01441019","0.285176564785"
"SL2.50ch12:62260268-62260702","825","62260268","62260702","434","1336.01441019","0.324846795581"
"SL2.50ch12:62672044-62673379","315","62672044","62673379","1335","1336.01441019","0.999240719127"
"SL2.50ch12:62677611-62678101","122","62677611","62678101","490","1336.01441019","0.36676251114"
"SL2.50ch12:62680291-62680622","70","62680291","62680622","331","1336.01441019","0.24775181875"
"SL2.50ch12:62685389-62686456","196","62685389","62686456","1067","1336.01441019","0.798644080381"
"SL2.50ch12:63804529-63805112","1100","63804529","63805112","583","1336.01441019","0.436372538765"
"SL2.50ch12:63804551-63805133","1100","63804551","63805133","582","1336.01441019","0.435624043844"
"SL2.50ch12:63885229-63885802","1177","63885229","63885802","573","1336.01441019","0.428887589558"
"SL2.50ch12:63885259-63885825","1176","63885259","63885825","566","1336.01441019","0.423648125113"
"SL2.50ch12:64875640-64876159","110","64875640","64876159","519","1336.01441019","0.38846886384"
"SL2.50ch12:65405444-65406020","2820","65405444","65406020","576","1336.01441019","0.43113307432"
"SL2.50ch12:65405532-65406036","2818","65405532","65406036","504","1336.01441019","0.37724144003"
"SL2.50ch12:65635988-65636918","11186","65635988","65636918","930","1336.01441019","0.696100276246"
"SL2.50ch12:65636138-65636835","11167","65636138","65636835","697","1336.01441019","0.521700959724"
"SL2.50ch12:65737636-65739323","522","65737636","65739323","1687","1336.01441019","1.26271093121"
"SL2.50ch12:65744964-65745563","894","65744964","65745563","599","1336.01441019","0.448348457496"
"SL2.50ch12:65745156-65745569","887","65745156","65745569","413","1336.01441019","0.309128402247"
"SL2.50ch12:7358534-7359257","7015","7358534","7359257","723","1336.01441019","0.541161827662"
"SL2.50ch12:7358610-7359322","7003","7358610","7359322","712","1336.01441019","0.532928383534"
"SL2.50ch12:7715540-7716044","95","7715540","7716044","504","1336.01441019","0.37724144003"
"SL2.50ch12:870451-871091","1491","870451","871091","640","1336.01441019","0.479036749244"
"SL2.50ch12:870467-871043","1490","870467","871043","576","1336.01441019","0.43113307432"
"SL2.50ch12:9622357-9622865","119","9622357","9622865","508","1336.01441019","0.380235419713"
"SL2.50ch12:9622529-9623515","242","9622529","9623515","986","1336.01441019","0.738015991805"
